Date,Hour,NUCLEAR,GAS,HYDRO,WIND,SOLAR,BIOFUEL,Total Output
1/1/2022,1,10474,163,3872,458,0,5,14972
1/1/2022,2,10480,202,4076,300,0,0,15058
1/1/2022,3,10481,183,3570,320,0,0,14554
1/1/2022,4,10483,123,3332,348,0,1,14287
1/1/2022,5,10485,123,3067,267,0,1,13943
1/1/2022,6,10484,126,3158,687,0,4,14459
1/1/2022,7,10482,127,3124,965,0,8,14706
1/1/2022,8,10478,124,3234,1412,0,10,15258
1/1/2022,9,10479,123,3427,1073,4,9,15115
1/1/2022,10,10477,123,3593,1506,12,2,15713
1/1/2022,11,10475,134,4119,1822,14,5,16569
1/1/2022,12,10479,186,4261,2165,18,6,17115
1/1/2022,13,10478,246,4363,2344,17,4,17452
1/1/2022,14,10476,347,4183,2510,15,0,17531
1/1/2022,15,10473,420,4033,2797,11,0,17734
1/1/2022,16,10470,532,4114,2570,5,0,17691
1/1/2022,17,10478,540,4487,2599,0,0,18104
1/1/2022,18,10477,589,4721,2585,0,0,18372
1/1/2022,19,10473,574,4667,2653,0,0,18367
1/1/2022,20,10477,584,4650,2738,0,0,18449
1/1/2022,21,10467,568,4318,2817,0,0,18170
1/1/2022,22,10469,216,4124,2956,0,0,17765
1/1/2022,23,10472,125,3548,2953,0,0,17098
1/1/2022,24,10470,123,3481,2809,0,0,16883
1/2/2022,1,10474,123,3066,2889,0,0,16552
1/2/2022,2,10474,123,3078,2821,0,0,16496
1/2/2022,3,10475,124,2904,2746,0,0,16249
1/2/2022,4,10473,129,3031,2702,0,0,16335
1/2/2022,5,10476,182,2939,2690,0,0,16287
1/2/2022,6,10478,328,2986,2764,0,0,16556
1/2/2022,7,10475,591,2982,2532,0,0,16580
1/2/2022,8,10473,1025,3038,2348,0,0,16884
1/2/2022,9,10468,1186,3208,2199,2,0,17063
1/2/2022,10,10462,1227,3592,2238,4,0,17523
1/2/2022,11,10465,1286,3815,2193,10,2,17771
1/2/2022,12,10461,1405,3720,2274,19,3,17882
1/2/2022,13,10460,1689,3849,2226,22,0,18246
1/2/2022,14,10428,1614,3781,2137,25,0,17985
1/2/2022,15,10420,1623,4048,1922,21,0,18034
1/2/2022,16,10423,1837,4050,1706,10,0,18026
1/2/2022,17,10428,2009,4788,1397,1,0,18623
1/2/2022,18,10435,2875,5256,1252,0,0,19818
1/2/2022,19,10445,2825,5094,1349,0,0,19713
1/2/2022,20,10445,2663,4708,1296,0,0,19112
1/2/2022,21,10442,2498,4708,1097,0,0,18745
1/2/2022,22,10445,2398,4519,987,0,1,18350
1/2/2022,23,10441,2170,3932,898,0,11,17452
1/2/2022,24,10444,1931,3769,796,0,39,16979
1/3/2022,1,10442,1730,3403,664,0,53,16292
1/3/2022,2,10447,1682,3182,567,0,51,15929
1/3/2022,3,10447,1955,3215,383,0,51,16051
1/3/2022,4,10449,2394,3178,373,0,51,16445
1/3/2022,5,10444,2396,3226,526,0,51,16643
1/3/2022,6,10444,2297,3152,757,0,51,16701
1/3/2022,7,10441,2583,3901,814,0,53,17792
1/3/2022,8,10442,3575,4458,624,0,53,19152
1/3/2022,9,10441,3552,4626,595,3,53,19270
1/3/2022,10,10444,3815,4735,426,13,53,19486
1/3/2022,11,10444,4438,4472,425,27,53,19859
1/3/2022,12,10443,4529,4190,408,41,54,19665
1/3/2022,13,10382,4105,4112,507,54,53,19213
1/3/2022,14,10319,3862,4103,596,60,53,18993
1/3/2022,15,10338,3524,4123,732,54,53,18824
1/3/2022,16,10337,3721,4624,832,28,53,19595
1/3/2022,17,10326,4260,5154,1026,9,54,20829
1/3/2022,18,10322,5197,5289,1288,0,54,22150
1/3/2022,19,10332,4640,5247,1517,0,54,21790
1/3/2022,20,10334,3498,4911,2039,0,54,20836
1/3/2022,21,10337,3102,4574,2390,0,54,20457
1/3/2022,22,10338,2158,3817,2733,0,54,19100
1/3/2022,23,10336,1227,3086,3096,0,54,17799
1/3/2022,24,10333,598,2979,3135,0,53,17098
1/4/2022,1,10332,508,3036,3264,0,54,17194
1/4/2022,2,10326,517,2866,3267,0,66,17042
1/4/2022,3,10154,703,2840,3155,0,69,16921
1/4/2022,4,9998,1067,3138,3060,0,70,17333
1/4/2022,5,10000,1711,3136,2861,0,70,17778
1/4/2022,6,9997,2601,3430,2369,0,73,18470
1/4/2022,7,9998,3715,3589,1875,0,80,19257
1/4/2022,8,9999,3976,4298,2042,1,85,20401
1/4/2022,9,10005,4089,4332,2268,4,85,20783
1/4/2022,10,10002,3681,4444,2471,20,85,20703
1/4/2022,11,10003,2739,4287,2714,44,84,19871
1/4/2022,12,10018,2502,4013,2592,67,85,19277
1/4/2022,13,9999,2705,3897,2448,84,88,19221
1/4/2022,14,9998,2165,3827,2753,128,84,18955
1/4/2022,15,9994,1957,4141,2837,108,55,19092
1/4/2022,16,9992,1991,4674,2764,47,32,19500
1/4/2022,17,9994,2154,5226,2910,8,32,20324
1/4/2022,18,9995,2808,5371,3071,0,35,21280
1/4/2022,19,9998,2356,5201,3153,0,36,20744
1/4/2022,20,9995,2342,4984,3357,0,40,20718
1/4/2022,21,9999,2116,4514,3559,0,42,20230
1/4/2022,22,10012,1151,3783,3706,0,34,18686
1/4/2022,23,10022,942,3289,3793,0,25,18071
1/4/2022,24,10020,602,3043,3819,0,28,17512
1/5/2022,1,10023,213,2694,3615,0,21,16566
1/5/2022,2,10020,128,2658,3474,0,17,16297
1/5/2022,3,10020,126,2643,2922,0,17,15728
1/5/2022,4,10023,126,2755,2329,0,18,15251
1/5/2022,5,10020,126,2839,2476,0,18,15479
1/5/2022,6,10016,137,2912,2834,0,20,15919
1/5/2022,7,10020,240,2993,3061,0,26,16340
1/5/2022,8,10022,468,3448,3578,0,33,17549
1/5/2022,9,10023,642,3639,3350,4,33,17691
1/5/2022,10,10021,727,3704,3937,15,32,18436
1/5/2022,11,10017,821,4308,4014,18,31,19209
1/5/2022,12,10019,1475,4266,4061,29,31,19881
1/5/2022,13,10018,1731,4205,4041,28,31,20054
1/5/2022,14,10016,1654,3664,3938,20,31,19323
1/5/2022,15,10013,1375,4151,4119,12,32,19702
1/5/2022,16,10018,1244,3911,4212,7,31,19423
1/5/2022,17,10012,1375,4205,4264,3,32,19891
1/5/2022,18,10010,1578,4569,4235,0,33,20425
1/5/2022,19,10019,1555,4177,4338,0,33,20122
1/5/2022,20,10010,1086,3776,4372,0,32,19276
1/5/2022,21,10013,797,4106,4384,0,27,19327
1/5/2022,22,10012,614,3523,4357,0,22,18528
1/5/2022,23,10010,542,3372,4142,0,46,18112
1/5/2022,24,10009,245,3238,4093,0,65,17650
1/6/2022,1,10006,129,3389,3804,0,65,17393
1/6/2022,2,10000,131,3401,3880,0,64,17476
1/6/2022,3,10005,138,3396,3974,0,64,17577
1/6/2022,4,10013,282,3415,3807,0,65,17582
1/6/2022,5,10020,646,3326,3676,0,65,17733
1/6/2022,6,10021,1246,3302,3383,0,67,18019
1/6/2022,7,10018,1547,3573,3095,1,72,18306
1/6/2022,8,10006,1977,4072,2976,2,79,19112
1/6/2022,9,9995,1995,4796,2806,9,79,19680
1/6/2022,10,9986,2179,4829,2595,58,80,19727
1/6/2022,11,9978,2318,4578,2515,91,81,19561
1/6/2022,12,9972,2419,4875,2313,109,82,19770
1/6/2022,13,9969,2563,5013,1991,139,84,19759
1/6/2022,14,9971,2736,5022,1611,132,84,19556
1/6/2022,15,9956,2889,4948,1411,65,82,19351
1/6/2022,16,9956,3093,5337,1315,28,82,19811
1/6/2022,17,9968,3687,5962,1141,5,80,20843
1/6/2022,18,9965,4565,5961,987,1,81,21560
1/6/2022,19,9979,4115,5916,1003,0,82,21095
1/6/2022,20,9978,4133,5467,1018,0,83,20679
1/6/2022,21,9978,4357,5263,1052,0,83,20733
1/6/2022,22,9971,3868,4772,1054,0,81,19746
1/6/2022,23,9982,2830,4367,1151,0,83,18413
1/6/2022,24,9988,2337,3998,1222,0,75,17620
1/7/2022,1,9981,2068,3614,1162,0,67,16892
1/7/2022,2,9992,1850,3454,1280,0,66,16642
1/7/2022,3,9990,1779,3469,1446,0,66,16750
1/7/2022,4,9991,1668,3310,1636,0,66,16671
1/7/2022,5,9995,1606,3178,1708,0,66,16553
1/7/2022,6,9992,1899,3535,1879,0,28,17333
1/7/2022,7,9992,2694,3985,1902,0,25,18598
1/7/2022,8,9990,3514,4420,1988,1,31,19944
1/7/2022,9,9986,3622,4901,1894,11,31,20445
1/7/2022,10,9990,3920,4688,1823,64,32,20517
1/7/2022,11,9996,3118,4642,1980,171,32,19939
1/7/2022,12,10000,2761,4626,1996,229,32,19644
1/7/2022,13,9996,2575,4676,2018,228,32,19525
1/7/2022,14,9995,2386,4709,2139,157,31,19417
1/7/2022,15,10008,2489,4373,2301,132,31,19334
1/7/2022,16,10023,2706,4339,2417,102,31,19618
1/7/2022,17,10022,3002,5225,2328,20,31,20628
1/7/2022,18,10026,4335,5775,1763,1,32,21932
1/7/2022,19,10028,4414,5692,1457,0,32,21623
1/7/2022,20,10029,4400,5378,1303,0,32,21142
1/7/2022,21,10030,4639,4977,1108,0,32,20786
1/7/2022,22,10030,4441,4511,949,0,32,19963
1/7/2022,23,10035,4423,4138,750,0,32,19378
1/7/2022,24,10034,3915,3998,706,0,21,18674
1/8/2022,1,10032,3425,3795,683,0,0,17935
1/8/2022,2,10034,3362,3598,623,0,0,17617
1/8/2022,3,10033,3088,3568,701,0,0,17390
1/8/2022,4,10033,3017,3580,741,0,0,17371
1/8/2022,5,10030,3205,3469,842,0,0,17546
1/8/2022,6,10028,3320,3591,974,0,0,17913
1/8/2022,7,10026,2421,3613,1411,0,0,17471
1/8/2022,8,10021,2475,3851,2169,3,0,18519
1/8/2022,9,10024,2481,3714,1805,23,0,18047
1/8/2022,10,10025,2562,3605,1955,58,0,18205
1/8/2022,11,10025,2271,3480,2152,125,0,18053
1/8/2022,12,10029,2150,3210,2584,164,0,18137
1/8/2022,13,10026,2139,3180,2825,199,0,18369
1/8/2022,14,10033,2120,3077,3128,228,0,18586
1/8/2022,15,10032,1904,3441,3331,193,0,18901
1/8/2022,16,10032,1916,3995,3313,82,0,19338
1/8/2022,17,10029,2078,4656,3235,18,0,20016
1/8/2022,18,10029,2982,5067,3325,1,0,21404
1/8/2022,19,10033,2810,4568,3659,0,0,21070
1/8/2022,20,10034,2112,4062,4017,0,0,20225
1/8/2022,21,10033,1714,3601,4099,0,0,19447
1/8/2022,22,10028,974,3317,4135,0,0,18454
1/8/2022,23,10031,410,3400,4031,0,17,17889
1/8/2022,24,10032,151,3339,3919,0,50,17491
1/9/2022,1,10039,126,2936,3621,0,53,16775
1/9/2022,2,10038,126,3200,3487,0,52,16903
1/9/2022,3,10032,125,2794,3267,0,52,16270
1/9/2022,4,10031,126,2791,3037,0,52,16037
1/9/2022,5,10036,125,2784,3384,0,53,16382
1/9/2022,6,10032,125,2803,3243,0,53,16256
1/9/2022,7,10038,125,2920,3351,0,52,16486
1/9/2022,8,10038,129,3247,3680,0,52,17146
1/9/2022,9,10033,131,3582,3677,0,52,17475
1/9/2022,10,10031,210,3602,3823,4,52,17722
1/9/2022,11,10036,227,3687,3822,18,52,17842
1/9/2022,12,10032,507,3527,3909,27,54,18056
1/9/2022,13,10037,879,3514,3703,51,54,18238
1/9/2022,14,10032,1100,3482,3339,56,54,18063
1/9/2022,15,10034,1196,3516,2984,51,54,17835
1/9/2022,16,9992,1356,3614,2633,30,54,17679
1/9/2022,17,10032,1502,3756,2642,13,54,17999
1/9/2022,18,10035,1507,3747,3438,0,54,18781
1/9/2022,19,10032,1492,3855,3253,0,54,18686
1/9/2022,20,10034,1258,3658,3366,0,55,18371
1/9/2022,21,10029,1164,3649,3641,0,54,18537
1/9/2022,22,10026,697,3858,3868,0,53,18502
1/9/2022,23,10022,216,3796,3997,0,11,18042
1/9/2022,24,10017,141,3257,3921,0,0,17336
1/10/2022,1,10035,148,3457,3722,0,0,17362
1/10/2022,2,10039,190,3692,3581,0,7,17509
1/10/2022,3,10038,205,3492,3702,0,15,17452
1/10/2022,4,10040,265,3560,3551,0,14,17430
1/10/2022,5,10035,653,3682,3285,0,15,17670
1/10/2022,6,10035,896,3664,3096,0,18,17709
1/10/2022,7,10036,1578,3501,2984,0,27,18126
1/10/2022,8,10028,1932,4453,2914,2,32,19361
1/10/2022,9,10031,2086,4741,2960,12,32,19862
1/10/2022,10,10033,2097,4369,3265,44,33,19841
1/10/2022,11,10035,2082,3995,3224,103,32,19471
1/10/2022,12,10020,2098,4181,3552,134,31,20016
1/10/2022,13,10035,2184,4215,3542,162,31,20169
1/10/2022,14,10036,2329,4320,3596,132,31,20444
1/10/2022,15,10030,2504,4250,3819,98,32,20733
1/10/2022,16,10022,2670,4406,3805,50,33,20986
1/10/2022,17,10016,2748,4537,3872,18,31,21222
1/10/2022,18,10019,2850,5361,3983,1,31,22245
1/10/2022,19,10020,2923,5089,4024,0,32,22088
1/10/2022,20,10026,2855,4769,4002,0,31,21683
1/10/2022,21,10017,2609,4951,3913,0,36,21526
1/10/2022,22,10021,2432,4260,3045,0,31,19789
1/10/2022,23,10021,2284,3839,2615,0,31,18790
1/10/2022,24,10023,2261,3664,2458,0,22,18428
1/11/2022,1,10029,2240,3549,2349,0,17,18184
1/11/2022,2,10035,2126,3201,1504,0,17,16883
1/11/2022,3,10033,2167,3188,1081,0,17,16486
1/11/2022,4,10037,2256,3693,1055,0,17,17058
1/11/2022,5,10029,3016,3974,859,0,16,17894
1/11/2022,6,10030,3261,4646,704,0,18,18659
1/11/2022,7,10028,4452,5211,655,0,24,20370
1/11/2022,8,10028,4903,5420,830,1,27,21209
1/11/2022,9,10024,5297,5665,831,9,27,21853
1/11/2022,10,10022,5976,5641,861,32,28,22560
1/11/2022,11,10023,5883,5435,983,61,29,22414
1/11/2022,12,10024,5278,4914,1366,60,30,21672
1/11/2022,13,10014,5002,4509,1788,73,29,21415
1/11/2022,14,9651,4511,4502,2128,101,30,20923
1/11/2022,15,10033,4348,4537,2600,71,32,21621
1/11/2022,16,10034,4273,4761,3127,33,30,22258
1/11/2022,17,10027,4354,4969,3539,10,31,22930
1/11/2022,18,10026,4687,4899,4024,1,34,23671
1/11/2022,19,10033,4383,4787,4208,0,30,23441
1/11/2022,20,10033,4594,4472,4346,0,31,23476
1/11/2022,21,10028,4669,3987,4387,0,32,23103
1/11/2022,22,10032,3380,3639,4336,0,32,21419
1/11/2022,23,10027,2768,3062,3939,0,33,19829
1/11/2022,24,10026,1390,3467,4208,0,22,19113
1/12/2022,1,10030,1337,3177,4149,0,19,18712
1/12/2022,2,10022,1012,2929,3772,0,18,17753
1/12/2022,3,10035,954,2925,3061,0,18,16993
1/12/2022,4,10036,638,2890,2862,0,19,16445
1/12/2022,5,10036,570,2881,3364,0,18,16869
1/12/2022,6,10036,758,2980,3047,0,19,16840
1/12/2022,7,10039,1188,3060,3479,0,24,17790
1/12/2022,8,10036,1791,3423,3791,1,32,19074
1/12/2022,9,10031,2502,3457,3435,4,32,19461
1/12/2022,10,10036,2811,3805,3265,20,34,19971
1/12/2022,11,9875,3627,4118,2742,39,35,20436
1/12/2022,12,9852,4395,4233,2325,32,38,20875
1/12/2022,13,9924,4711,4188,1924,31,39,20817
1/12/2022,14,10038,4321,4243,1416,31,33,20082
1/12/2022,15,10037,4812,4470,1043,24,34,20420
1/12/2022,16,10040,5047,4706,848,14,46,20701
1/12/2022,17,10034,4568,5322,686,3,49,20662
1/12/2022,18,10033,4967,5533,575,1,33,21142
1/12/2022,19,10037,5164,5492,407,0,33,21133
1/12/2022,20,10032,5293,5398,305,0,31,21059
1/12/2022,21,10028,5619,5099,175,0,31,20952
1/12/2022,22,10029,5628,4636,175,0,31,20499
1/12/2022,23,10028,4589,4133,219,0,31,19000
1/12/2022,24,10030,3741,4040,219,0,21,18051
1/13/2022,1,10029,2931,3918,204,0,16,17098
1/13/2022,2,10025,2583,3819,175,0,15,16617
1/13/2022,3,10032,2291,3787,145,0,16,16271
1/13/2022,4,10026,2377,3876,74,0,15,16368
1/13/2022,5,10022,2758,3971,41,0,17,16809
1/13/2022,6,10030,3296,4087,68,0,20,17501
1/13/2022,7,10033,3587,4414,76,0,28,18138
1/13/2022,8,10028,3823,4757,93,1,31,18733
1/13/2022,9,10027,4075,4820,142,3,32,19099
1/13/2022,10,10012,4686,4566,184,14,32,19494
1/13/2022,11,10026,5026,4636,197,24,32,19941
1/13/2022,12,10022,5408,4647,219,39,33,20368
1/13/2022,13,10028,5428,4518,244,45,33,20296
1/13/2022,14,10038,4714,4305,201,41,32,19331
1/13/2022,15,10032,4637,4456,506,34,32,19697
1/13/2022,16,10033,4268,4798,524,12,32,19667
1/13/2022,17,10032,4151,5366,477,5,32,20063
1/13/2022,18,10028,4565,5408,596,0,19,20616
1/13/2022,19,10027,4538,5452,490,0,29,20536
1/13/2022,20,10027,4647,5096,430,0,30,20230
1/13/2022,21,10029,4549,4621,628,0,30,19857
1/13/2022,22,10031,3814,4404,645,0,30,18924
1/13/2022,23,10015,2808,4220,827,0,31,17901
1/13/2022,24,10031,2200,4208,918,0,21,17378
1/14/2022,1,10033,2292,4056,793,0,15,17189
1/14/2022,2,10028,2279,3902,734,0,15,16958
1/14/2022,3,10027,2002,3852,732,0,15,16628
1/14/2022,4,10029,2380,3772,911,0,15,17107
1/14/2022,5,10023,2379,3773,1256,0,17,17448
1/14/2022,6,10021,2249,3954,1506,0,21,17751
1/14/2022,7,10021,2386,4357,1669,1,26,18460
1/14/2022,8,10021,2823,4704,1976,1,31,19556
1/14/2022,9,10008,2872,4923,2423,14,32,20272
1/14/2022,10,9991,2566,4649,2754,50,32,20042
1/14/2022,11,10019,2746,4279,2780,98,33,19955
1/14/2022,12,10024,2930,4025,2686,149,32,19846
1/14/2022,13,10021,2942,4189,2604,178,31,19965
1/14/2022,14,10028,2967,4048,2582,185,32,19842
1/14/2022,15,10029,3058,3874,2677,204,30,19872
1/14/2022,16,10031,3069,3993,2649,150,32,19924
1/14/2022,17,10026,3247,4647,2755,34,32,20741
1/14/2022,18,10022,4288,5074,2864,1,32,22281
1/14/2022,19,10025,4298,4982,3023,0,32,22360
1/14/2022,20,10024,3920,4820,3069,0,31,21864
1/14/2022,21,10025,3938,4668,2902,0,31,21564
1/14/2022,22,10023,4253,4291,2802,0,31,21400
1/14/2022,23,10018,3167,3860,2621,0,31,19697
1/14/2022,24,10024,3014,3740,2346,0,17,19141
1/15/2022,1,10020,2559,3988,2274,0,9,18850
1/15/2022,2,10024,2941,3860,2222,0,0,19047
1/15/2022,3,10025,3190,3903,2204,0,0,19322
1/15/2022,4,10024,3546,3845,2098,0,0,19513
1/15/2022,5,10028,3780,3838,1918,0,0,19564
1/15/2022,6,10032,4141,4103,1945,0,0,20221
1/15/2022,7,10032,4415,4240,1800,1,0,20488
1/15/2022,8,10033,4587,4669,1581,2,0,20872
1/15/2022,9,10028,4986,4985,1397,19,0,21415
1/15/2022,10,10030,4776,4964,1113,77,1,20961
1/15/2022,11,10028,5014,4635,858,162,0,20697
1/15/2022,12,10033,5046,4552,608,209,0,20448
1/15/2022,13,10027,4895,4418,475,218,0,20033
1/15/2022,14,10028,4551,4267,398,213,0,19457
1/15/2022,15,10029,4236,4282,451,173,0,19171
1/15/2022,16,10029,4541,4653,475,111,0,19809
1/15/2022,17,10021,5732,5252,398,31,0,21434
1/15/2022,18,10022,6350,5556,361,1,0,22290
1/15/2022,19,10026,6065,5564,516,0,0,22171
1/15/2022,20,10027,5982,5419,585,0,1,22014
1/15/2022,21,10029,5790,5027,755,0,0,21601
1/15/2022,22,10027,5654,4437,1088,0,0,21206
1/15/2022,23,10026,5563,4096,1300,0,0,20985
1/15/2022,24,10027,5267,4028,1338,0,0,20660
1/16/2022,1,10030,4863,3941,1427,0,0,20261
1/16/2022,2,10037,4674,3726,1566,0,0,20003
1/16/2022,3,10037,4614,3825,1605,0,0,20081
1/16/2022,4,10038,4890,3743,1349,0,0,20020
1/16/2022,5,10042,5094,3686,1362,0,0,20184
1/16/2022,6,10039,4966,3807,1378,0,0,20190
1/16/2022,7,10041,4714,4033,1365,1,0,20154
1/16/2022,8,10043,4945,4214,1397,1,0,20600
1/16/2022,9,10043,4734,4502,1480,28,0,20787
1/16/2022,10,10036,4520,4554,1175,109,0,20394
1/16/2022,11,10033,4700,4450,920,198,0,20301
1/16/2022,12,10034,4985,4238,815,271,0,20343
1/16/2022,13,10040,4891,4217,571,283,0,20002
1/16/2022,14,10036,4899,4144,405,235,0,19719
1/16/2022,15,10041,3842,4148,488,185,0,18704
1/16/2022,16,10042,4070,4218,766,119,0,19215
1/16/2022,17,10039,4385,4660,881,25,0,19990
1/16/2022,18,10039,5756,5038,724,1,0,21558
1/16/2022,19,10046,5814,5070,898,0,0,21828
1/16/2022,20,10048,5133,4732,1526,0,0,21439
1/16/2022,21,10052,4864,4619,1516,0,0,21051
1/16/2022,22,10048,5078,4191,1196,0,0,20513
1/16/2022,23,10047,5094,3882,846,0,0,19869
1/16/2022,24,10052,5063,3784,830,0,0,19729
1/17/2022,1,10053,3915,3660,1219,0,0,18847
1/17/2022,2,10050,3138,3640,1799,0,4,18631
1/17/2022,3,10054,2612,3114,2200,0,13,17993
1/17/2022,4,10061,2433,3143,1942,0,15,17594
1/17/2022,5,10062,2517,3035,1699,0,15,17328
1/17/2022,6,10065,2571,3198,1572,0,16,17422
1/17/2022,7,10054,2592,3272,2586,0,28,18532
1/17/2022,8,10057,2612,3666,3108,0,32,19475
1/17/2022,9,10042,2638,3684,3735,2,33,20134
1/17/2022,10,10042,2637,3742,3784,10,32,20247
1/17/2022,11,10049,2510,4008,3757,22,32,20378
1/17/2022,12,10048,2836,3859,3774,21,32,20570
1/17/2022,13,10050,2809,3414,3704,12,33,20022
1/17/2022,14,10053,2548,3392,3646,17,33,19689
1/17/2022,15,10054,2453,3384,3419,12,33,19355
1/17/2022,16,10051,2470,3647,3414,6,33,19621
1/17/2022,17,10053,2472,3917,3731,1,33,20207
1/17/2022,18,10052,2546,4734,3790,0,31,21153
1/17/2022,19,10050,2454,4350,3783,0,31,20668
1/17/2022,20,10052,2159,4206,3508,0,31,19956
1/17/2022,21,10055,1787,4390,3272,0,31,19535
1/17/2022,22,10059,1714,3588,3224,0,31,18616
1/17/2022,23,10050,1389,3475,2974,0,31,17919
1/17/2022,24,10055,1100,3332,2783,0,24,17294
1/18/2022,1,10058,1005,3238,2184,0,17,16502
1/18/2022,2,10056,1165,3173,2410,0,16,16820
1/18/2022,3,10062,1180,3143,2921,0,19,17325
1/18/2022,4,10059,1341,3195,2076,0,18,16689
1/18/2022,5,10059,1954,3453,2063,0,16,17545
1/18/2022,6,10001,2498,3315,1086,0,19,16919
1/18/2022,7,9984,2669,3608,1614,0,27,17902
1/18/2022,8,9978,3050,4173,1603,1,31,18836
1/18/2022,9,9975,3660,4436,1353,2,32,19458
1/18/2022,10,9975,3999,4406,1149,21,32,19582
1/18/2022,11,9973,4416,4285,981,33,32,19720
1/18/2022,12,10030,4732,3974,874,50,32,19692
1/18/2022,13,10046,4952,3848,863,79,31,19819
1/18/2022,14,10042,4466,4010,1054,99,32,19703
1/18/2022,15,10044,3544,4306,1438,77,32,19441
1/18/2022,16,10044,3369,4364,1816,42,32,19667
1/18/2022,17,10046,3424,4778,2324,13,32,20617
1/18/2022,18,10048,3831,5087,2617,0,32,21615
1/18/2022,19,10041,3647,4806,2917,0,31,21442
1/18/2022,20,10042,3362,4331,3199,0,32,20966
1/18/2022,21,10044,3285,3651,3276,0,31,20287
1/18/2022,22,10038,2707,3555,2892,0,32,19224
1/18/2022,23,10043,1464,3436,3345,0,31,18319
1/18/2022,24,10048,486,3338,4148,0,23,18043
1/19/2022,1,9617,278,3190,3846,0,17,16948
1/19/2022,2,9232,187,3111,4255,0,16,16801
1/19/2022,3,9239,136,3150,4251,0,16,16792
1/19/2022,4,9244,250,2929,4318,0,16,16757
1/19/2022,5,9245,651,2910,4173,0,16,16995
1/19/2022,6,9243,1277,3068,3535,0,27,17150
1/19/2022,7,9240,2344,3111,3517,0,36,18248
1/19/2022,8,9240,2376,4002,3927,0,32,19577
1/19/2022,9,9237,2562,4281,3809,1,31,19921
1/19/2022,10,9237,2528,4224,3707,13,32,19741
1/19/2022,11,9233,2703,3996,3872,46,40,19890
1/19/2022,12,9239,2518,3830,3947,80,43,19657
1/19/2022,13,9239,2494,3859,3880,113,38,19623
1/19/2022,14,9235,2589,3716,3647,130,30,19347
1/19/2022,15,9238,2996,3768,3906,88,33,20029
1/19/2022,16,9224,2945,4057,3871,43,31,20171
1/19/2022,17,9227,3238,4751,3936,8,30,21190
1/19/2022,18,9224,4467,4895,3915,0,30,22531
1/19/2022,19,9232,4879,4618,3845,0,31,22605
1/19/2022,20,9233,4434,4367,3978,0,31,22043
1/19/2022,21,9230,4232,4272,3929,0,32,21695
1/19/2022,22,9233,2904,4327,3673,0,32,20169
1/19/2022,23,9228,2600,3692,3437,0,31,18988
1/19/2022,24,9224,2789,3643,3185,0,23,18864
1/20/2022,1,9215,2681,3599,2828,0,17,18340
1/20/2022,2,9214,2970,3553,2376,0,17,18130
1/20/2022,3,9216,3154,3429,2282,0,17,18098
1/20/2022,4,9213,3062,3414,2209,0,17,17915
1/20/2022,5,9214,3304,3529,2016,0,17,18080
1/20/2022,6,9210,3456,3656,2050,0,20,18392
1/20/2022,7,9223,4732,4307,1762,1,26,20051
1/20/2022,8,9223,5756,4831,1481,1,31,21323
1/20/2022,9,9221,5685,4634,1355,49,31,20975
1/20/2022,10,9218,5055,4630,1275,166,31,20375
1/20/2022,11,9214,4838,4708,1149,231,31,20171
1/20/2022,12,9214,5557,4105,989,261,31,20157
1/20/2022,13,9213,4954,3906,837,257,31,19198
1/20/2022,14,9210,4490,4206,812,236,31,18985
1/20/2022,15,9216,4211,4399,906,187,31,18950
1/20/2022,16,9217,4569,4678,847,147,31,19489
1/20/2022,17,9216,5508,5174,682,41,31,20652
1/20/2022,18,9213,6970,5082,573,0,31,21869
1/20/2022,19,9216,7107,5106,529,0,31,21989
1/20/2022,20,9218,6518,5015,675,0,31,21457
1/20/2022,21,9209,6641,4828,623,0,32,21333
1/20/2022,22,9209,6715,4480,551,0,32,20987
1/20/2022,23,9212,6589,3904,658,0,32,20395
1/20/2022,24,9210,6075,3806,633,0,22,19746
1/21/2022,1,9218,6038,3580,604,0,17,19457
1/21/2022,2,9436,5867,3175,633,0,17,19128
1/21/2022,3,9444,5412,3327,565,0,17,18765
1/21/2022,4,9539,5123,3516,519,0,17,18714
1/21/2022,5,9626,5024,3728,501,0,17,18896
1/21/2022,6,9622,5368,3889,468,0,19,19366
1/21/2022,7,9628,5910,4394,519,1,3,20455
1/21/2022,8,9621,6680,4402,583,1,17,21304
1/21/2022,9,9704,6710,4359,598,29,26,21426
1/21/2022,10,9792,6378,4355,581,105,25,21236
1/21/2022,11,9798,6347,4395,526,190,27,21283
1/21/2022,12,9795,6209,4366,468,267,27,21132
1/21/2022,13,9793,6692,4178,431,288,25,21407
1/21/2022,14,9798,6441,3932,470,289,26,20956
1/21/2022,15,9800,6070,3921,547,254,26,20618
1/21/2022,16,9799,5878,4586,666,180,25,21134
1/21/2022,17,9801,5808,5062,807,55,26,21559
1/21/2022,18,9802,6328,5190,1045,1,26,22392
1/21/2022,19,9800,6538,5177,1346,0,28,22889
1/21/2022,20,9801,6568,4926,1564,0,34,22893
1/21/2022,21,9800,6541,4584,1647,0,33,22605
1/21/2022,22,9837,6345,4004,1686,0,27,21899
1/21/2022,23,9897,5825,3523,1859,0,39,21143
1/21/2022,24,9906,4898,3238,1854,0,57,19953
1/22/2022,1,9912,3935,3292,1919,0,62,19120
1/22/2022,2,9914,3682,3233,1925,0,51,18805
1/22/2022,3,9919,3109,3270,1987,0,52,18337
1/22/2022,4,9918,2908,3229,2109,0,51,18215
1/22/2022,5,9919,2701,3350,2182,0,52,18204
1/22/2022,6,9916,2702,3238,2584,0,53,18493
1/22/2022,7,9922,2790,3216,2931,1,52,18912
1/22/2022,8,9918,2839,3468,3137,2,47,19411
1/22/2022,9,9963,2897,3474,2988,36,47,19405
1/22/2022,10,9962,2886,3805,3710,61,47,20471
1/22/2022,11,9960,2713,3834,3955,126,47,20635
1/22/2022,12,9965,2663,3686,4116,143,47,20620
1/22/2022,13,9964,2692,3911,4155,127,47,20896
1/22/2022,14,9967,2558,3870,4214,106,47,20762
1/22/2022,15,9973,2961,3601,4306,60,47,20948
1/22/2022,16,9968,3144,3669,4318,34,47,21180
1/22/2022,17,9995,3061,4137,4324,8,47,21572
1/22/2022,18,10005,3081,4582,4272,1,47,21988
1/22/2022,19,10008,2918,4729,3977,0,47,21679
1/22/2022,20,10008,2761,4423,4045,0,47,21284
1/22/2022,21,10006,2587,4082,4026,0,47,20748
1/22/2022,22,10004,2417,3763,3866,0,47,20097
1/22/2022,23,10004,2387,3667,3461,0,47,19566
1/22/2022,24,10000,2166,3318,3066,0,47,18597
1/23/2022,1,9999,1420,3046,2510,0,47,17022
1/23/2022,2,9997,1231,3031,2206,0,47,16512
1/23/2022,3,10081,1089,3090,2199,0,47,16506
1/23/2022,4,10207,1210,3393,1702,0,47,16559
1/23/2022,5,10208,1686,3409,1310,0,47,16660
1/23/2022,6,10343,1453,3424,1109,0,47,16376
1/23/2022,7,10536,1691,3660,1015,0,47,16949
1/23/2022,8,10538,1807,3578,948,0,47,16918
1/23/2022,9,10527,2279,3875,978,6,47,17712
1/23/2022,10,10535,3095,4068,917,25,47,18687
1/23/2022,11,10531,3323,3931,985,50,47,18867
1/23/2022,12,10532,3260,3772,1246,70,47,18927
1/23/2022,13,10527,3449,3681,1356,79,47,19139
1/23/2022,14,10534,3427,3552,1323,94,47,18977
1/23/2022,15,10536,3359,3679,1290,86,47,18997
1/23/2022,16,10540,3334,4162,1395,60,47,19538
1/23/2022,17,10534,4027,5294,970,16,47,20888
1/23/2022,18,10537,5499,5332,660,1,47,22076
1/23/2022,19,10535,5776,5245,562,0,47,22165
1/23/2022,20,10569,5604,5146,549,0,47,21915
1/23/2022,21,10682,5390,4902,534,0,49,21557
1/23/2022,22,10683,4983,4358,504,0,49,20577
1/23/2022,23,10677,4675,3836,572,0,49,19809
1/23/2022,24,10682,3845,3400,618,0,50,18595
1/24/2022,1,10680,3614,3631,698,0,50,18673
1/24/2022,2,10679,3470,3440,781,0,49,18419
1/24/2022,3,10686,3305,3377,787,0,49,18204
1/24/2022,4,10694,3220,3239,859,0,51,18063
1/24/2022,5,10691,3197,3319,1146,0,56,18409
1/24/2022,6,10686,3203,3616,1306,0,57,18868
1/24/2022,7,10687,3702,4214,1370,1,57,20031
1/24/2022,8,10686,4515,4569,1483,1,57,21311
1/24/2022,9,10686,4680,4635,1597,8,57,21663
1/24/2022,10,10698,5309,4660,1751,31,56,22505
1/24/2022,11,10772,5388,4533,1952,45,56,22746
1/24/2022,12,10740,5161,4254,2088,65,57,22365
1/24/2022,13,10728,4843,4157,2117,69,56,21970
1/24/2022,14,10731,4797,4280,1903,64,56,21831
1/24/2022,15,10732,5248,4289,1667,46,56,22038
1/24/2022,16,10728,5455,4461,1357,29,56,22086
1/24/2022,17,10725,5703,5044,1065,8,56,22601
1/24/2022,18,10721,5866,5143,847,1,61,22639
1/24/2022,19,10725,6051,5130,759,0,70,22735
1/24/2022,20,10724,5991,4863,833,0,72,22483
1/24/2022,21,10772,6027,4423,949,0,72,22243
1/24/2022,22,10775,5713,4057,1072,0,72,21689
1/24/2022,23,10772,4534,3581,1278,0,72,20237
1/24/2022,24,10773,3141,3355,1549,0,66,18884
1/25/2022,1,10776,2382,3039,1839,0,61,18097
1/25/2022,2,10775,2213,2979,1999,0,60,18026
1/25/2022,3,10734,2220,2994,2146,0,60,18154
1/25/2022,4,10780,2362,2953,2019,0,62,18176
1/25/2022,5,10775,2474,2938,1963,0,61,18211
1/25/2022,6,10773,2641,3348,1765,0,67,18594
1/25/2022,7,10770,2883,3762,2070,0,81,19566
1/25/2022,8,10771,3857,4322,1711,1,78,20740
1/25/2022,9,10771,4963,4271,1592,8,76,21681
1/25/2022,10,10771,4577,4222,1411,56,75,21112
1/25/2022,11,10770,4764,4106,1252,106,78,21076
1/25/2022,12,10764,5140,4056,1060,122,85,21227
1/25/2022,13,10761,5023,3929,1053,139,83,20988
1/25/2022,14,10764,4514,3939,1012,136,84,20449
1/25/2022,15,10768,4514,4032,918,138,84,20454
1/25/2022,16,10757,4601,4246,870,99,86,20659
1/25/2022,17,10754,5144,4724,742,35,89,21488
1/25/2022,18,10745,5999,5058,749,1,81,22633
1/25/2022,19,10746,6192,4946,675,0,74,22633
1/25/2022,20,10748,5855,5020,748,0,78,22449
1/25/2022,21,10743,5681,4955,576,0,74,22029
1/25/2022,22,10744,5473,4373,595,0,75,21260
1/25/2022,23,10738,4105,3983,676,0,74,19576
1/25/2022,24,10747,3418,3750,686,0,69,18670
1/26/2022,1,10742,3427,3709,698,0,67,18643
1/26/2022,2,10740,3681,3480,839,0,60,18800
1/26/2022,3,10739,3400,3471,1088,0,60,18758
1/26/2022,4,10739,3396,3420,1209,0,60,18824
1/26/2022,5,10744,3451,3352,1445,0,59,19051
1/26/2022,6,10749,3547,3711,1357,0,61,19425
1/26/2022,7,10757,4614,4172,1301,0,69,20913
1/26/2022,8,10758,4932,4859,1295,2,73,21919
1/26/2022,9,10755,5541,4908,1292,12,54,22562
1/26/2022,10,10748,5553,4919,978,67,56,22321
1/26/2022,11,10748,5596,4944,561,128,89,22066
1/26/2022,12,10748,5564,4488,407,137,95,21439
1/26/2022,13,10747,5341,4123,374,147,94,20826
1/26/2022,14,10738,4462,4129,371,207,77,19984
1/26/2022,15,10750,4539,4194,526,197,76,20282
1/26/2022,16,10744,4880,4445,735,129,76,21009
1/26/2022,17,10752,4623,4954,1014,33,83,21459
1/26/2022,18,10761,4728,4888,1531,1,92,22001
1/26/2022,19,10775,4660,4768,2100,0,89,22392
1/26/2022,20,10778,4502,4481,2809,0,88,22658
1/26/2022,21,10770,3919,4228,3182,0,81,22180
1/26/2022,22,10769,3874,3875,3310,0,76,21904
1/26/2022,23,10768,2948,3343,3431,0,81,20571
1/26/2022,24,10765,2025,3107,3469,0,68,19434
1/27/2022,1,10763,1199,3175,3451,0,68,18656
1/27/2022,2,10752,997,3048,3389,0,70,18256
1/27/2022,3,10759,1007,3077,3046,0,68,17957
1/27/2022,4,10767,1083,3071,2750,0,65,17736
1/27/2022,5,10764,1384,3038,2649,0,66,17901
1/27/2022,6,10786,1782,3072,2651,0,67,18358
1/27/2022,7,10780,2117,3177,3549,1,77,19701
1/27/2022,8,10779,2107,3635,4220,2,80,20823
1/27/2022,9,10782,2108,3761,4407,15,81,21154
1/27/2022,10,10779,2096,4114,4363,65,83,21500
1/27/2022,11,10784,2081,3875,4338,85,83,21246
1/27/2022,12,10783,2082,3969,4347,90,83,21354
1/27/2022,13,10781,1812,3945,4337,80,82,21037
1/27/2022,14,10785,1962,4053,4309,65,82,21256
1/27/2022,15,10784,2231,3992,4232,56,83,21378
1/27/2022,16,10796,2499,4272,4027,35,82,21711
1/27/2022,17,10801,2920,4663,3673,12,83,22152
1/27/2022,18,10796,3489,4952,3363,1,83,22684
1/27/2022,19,10795,3972,4764,3149,0,83,22763
1/27/2022,20,10793,3409,4182,3209,0,83,21676
1/27/2022,21,10780,3282,3656,3091,0,83,20892
1/27/2022,22,10781,2610,3300,2504,0,82,19277
1/27/2022,23,10768,1698,3159,2572,0,83,18280
1/27/2022,24,10778,1046,3317,2462,0,70,17673
1/28/2022,1,10777,794,3222,2231,0,65,17089
1/28/2022,2,10782,795,3230,1594,0,64,16465
1/28/2022,3,10780,800,3210,1499,0,64,16353
1/28/2022,4,10783,1035,3036,1775,0,64,16693
1/28/2022,5,10785,1536,3133,2081,0,63,17598
1/28/2022,6,10788,1734,3408,2297,0,65,18292
1/28/2022,7,10790,2090,3907,1884,0,76,18747
1/28/2022,8,10787,2365,4554,1982,2,80,19770
1/28/2022,9,10786,3496,4798,1830,14,81,21005
1/28/2022,10,10786,3025,4669,1752,58,81,20371
1/28/2022,11,10787,3317,4516,1566,106,80,20372
1/28/2022,12,10782,2971,4342,1564,167,76,19902
1/28/2022,13,10781,2830,4297,1490,244,69,19711
1/28/2022,14,10781,3007,4159,1462,251,80,19740
1/28/2022,15,10785,3243,4099,1419,238,81,19865
1/28/2022,16,10784,3585,4593,1228,171,82,20443
1/28/2022,17,10781,3974,5473,1159,54,81,21522
1/28/2022,18,10764,5377,5504,1012,2,81,22740
1/28/2022,19,10768,5801,5428,1125,0,81,23203
1/28/2022,20,10784,5435,5308,1201,0,82,22810
1/28/2022,21,10782,5538,4947,1335,0,81,22683
1/28/2022,22,10778,5396,4484,1315,0,82,22055
1/28/2022,23,10781,4937,4345,1135,0,82,21280
1/28/2022,24,10782,4104,4070,1055,0,69,20080
1/29/2022,1,10785,3561,3936,1071,0,51,19404
1/29/2022,2,10786,3177,3886,1136,0,47,19032
1/29/2022,3,10787,2995,3833,1161,0,47,18823
1/29/2022,4,10783,3029,3652,1219,0,47,18730
1/29/2022,5,10782,3075,3820,1103,0,47,18827
1/29/2022,6,10781,3287,3900,1050,0,47,19065
1/29/2022,7,10784,3916,4375,973,2,47,20097
1/29/2022,8,10784,4474,4751,859,2,47,20917
1/29/2022,9,10780,5037,4853,733,43,47,21493
1/29/2022,10,10783,5270,5003,632,140,47,21875
1/29/2022,11,10785,5267,4844,426,212,47,21581
1/29/2022,12,10798,5151,4476,276,240,47,20988
1/29/2022,13,10794,5123,4303,167,252,47,20686
1/29/2022,14,10798,5062,4073,158,256,47,20394
1/29/2022,15,10794,4921,4082,148,241,47,20233
1/29/2022,16,10795,5066,4244,147,175,47,20474
1/29/2022,17,10792,4532,5243,233,68,47,20915
1/29/2022,18,10801,5345,5466,390,3,47,22052
1/29/2022,19,10803,5709,5381,629,0,47,22569
1/29/2022,20,10803,5262,5240,893,0,47,22245
1/29/2022,21,10792,4460,4914,1157,0,47,21370
1/29/2022,22,10803,3797,4342,1382,0,47,20371
1/29/2022,23,10816,3220,3862,1526,0,47,19471
1/29/2022,24,10823,3170,3680,1516,0,47,19236
1/30/2022,1,10822,3066,3360,1383,0,47,18678
1/30/2022,2,10820,3343,2951,1256,0,47,18417
1/30/2022,3,10830,3201,3162,1107,0,47,18347
1/30/2022,4,10825,3290,3205,917,0,47,18284
1/30/2022,5,10823,3471,3207,726,0,47,18274
1/30/2022,6,10815,3375,3219,546,0,47,18002
1/30/2022,7,10824,3739,3350,564,2,47,18526
1/30/2022,8,10818,3420,3637,454,2,47,18378
1/30/2022,9,10829,3362,4299,451,30,47,19018
1/30/2022,10,10831,3413,4079,394,78,47,18842
1/30/2022,11,10833,3325,4421,334,100,47,19060
1/30/2022,12,10826,3473,4284,296,143,47,19069
1/30/2022,13,10828,3524,4150,291,165,47,19005
1/30/2022,14,10831,3447,4135,296,161,47,18917
1/30/2022,15,10829,3816,4106,268,116,47,19182
1/30/2022,16,10826,4154,4330,194,62,47,19613
1/30/2022,17,10840,4610,5108,130,29,47,20764
1/30/2022,18,10855,4989,5439,175,2,47,21507
1/30/2022,19,10863,4698,5424,249,0,47,21281
1/30/2022,20,10863,3951,5222,270,0,47,20353
1/30/2022,21,10863,3356,5117,273,0,47,19656
1/30/2022,22,10860,3260,4775,240,0,47,19182
1/30/2022,23,10855,3392,3945,307,0,47,18546
1/30/2022,24,10848,3136,3528,400,0,47,17959
1/31/2022,1,10850,2997,3261,345,0,51,17504
1/31/2022,2,10844,2964,3295,295,0,66,17464
1/31/2022,3,10846,2966,3354,436,0,67,17669
1/31/2022,4,10843,2977,3401,350,0,67,17638
1/31/2022,5,10850,3083,3454,263,0,67,17717
1/31/2022,6,10849,3208,3677,194,0,70,17998
1/31/2022,7,10848,4378,3989,184,1,76,19476
1/31/2022,8,10851,5367,4314,175,1,81,20789
1/31/2022,9,10851,5700,4379,181,42,81,21234
1/31/2022,10,10849,5778,4405,180,127,74,21413
1/31/2022,11,10849,5545,4266,159,194,47,21060
1/31/2022,12,10844,5059,4033,172,208,47,20363
1/31/2022,13,10843,3784,3882,208,242,59,19018
1/31/2022,14,10844,3564,3701,219,245,73,18646
1/31/2022,15,10847,3432,3873,230,233,80,18695
1/31/2022,16,10858,3525,3855,281,179,82,18780
1/31/2022,17,10856,4068,4528,355,74,82,19963
1/31/2022,18,10854,4914,4830,481,6,82,21167
1/31/2022,19,10861,5053,4780,955,0,81,21730
1/31/2022,20,10859,3991,4751,1641,0,81,21323
1/31/2022,21,10855,3634,4227,2187,0,81,20984
1/31/2022,22,10852,2730,3725,2499,0,81,19887
1/31/2022,23,10849,1771,3437,2103,0,80,18240
1/31/2022,24,10845,906,3593,2183,0,71,17598
2/1/2022,1,10845,688,3343,2347,0,68,17291
2/1/2022,2,10839,275,3301,2507,0,66,16988
2/1/2022,3,10835,139,3380,2496,0,66,16916
2/1/2022,4,10836,314,3344,2251,0,66,16811
2/1/2022,5,10848,595,3303,2290,0,67,17103
2/1/2022,6,10850,824,3408,2419,0,67,17568
2/1/2022,7,10844,956,3480,3456,1,75,18812
2/1/2022,8,10848,963,3878,3809,5,81,19584
2/1/2022,9,10843,955,3916,3941,50,81,19786
2/1/2022,10,10844,960,3859,3677,132,82,19554
2/1/2022,11,10838,959,3704,3503,223,82,19309
2/1/2022,12,10833,832,3705,3492,253,82,19197
2/1/2022,13,10835,455,3710,3021,243,82,18346
2/1/2022,14,10839,245,3744,3105,234,82,18249
2/1/2022,15,10839,545,3778,3179,191,82,18614
2/1/2022,16,10847,797,3682,2841,127,82,18376
2/1/2022,17,10850,891,4166,3606,54,46,19613
2/1/2022,18,10853,950,4502,3951,2,35,20293
2/1/2022,19,10848,1005,4521,4109,0,36,20519
2/1/2022,20,10842,923,4012,4358,0,36,20171
2/1/2022,21,10836,867,3810,4434,0,36,19983
2/1/2022,22,10836,417,3842,4403,0,36,19534
2/1/2022,23,10838,294,3615,4059,0,35,18841
2/1/2022,24,10843,139,3537,3345,0,24,17888
2/2/2022,1,10845,134,3565,1719,0,19,16282
2/2/2022,2,10841,135,3412,1918,0,19,16325
2/2/2022,3,10850,175,3353,1955,0,19,16352
2/2/2022,4,10853,245,3495,1723,0,19,16335
2/2/2022,5,10856,427,3595,1590,0,19,16487
2/2/2022,6,10858,777,3417,1234,0,24,16310
2/2/2022,7,10857,1292,3409,1130,0,31,16719
2/2/2022,8,10856,1547,3772,1236,5,34,17450
2/2/2022,9,10852,1926,4199,1104,42,34,18157
2/2/2022,10,10847,1814,4099,873,87,34,17754
2/2/2022,11,10855,2144,4131,884,122,34,18170
2/2/2022,12,10861,2097,4434,1086,127,34,18639
2/2/2022,13,10862,2072,4716,1230,106,34,19020
2/2/2022,14,10855,2106,4318,1593,75,34,18981
2/2/2022,15,10857,1806,4383,1738,49,34,18867
2/2/2022,16,10856,1773,4354,1945,33,34,18995
2/2/2022,17,10857,1768,4072,2526,12,33,19268
2/2/2022,18,10857,1791,4431,2906,1,33,20019
2/2/2022,19,10856,1747,4394,2969,0,34,20000
2/2/2022,20,10852,1230,4499,2835,0,35,19451
2/2/2022,21,10851,1069,4430,2764,0,35,19149
2/2/2022,22,10848,839,4141,2903,0,36,18767
2/2/2022,23,10846,372,3967,3002,0,36,18223
2/2/2022,24,10850,214,4083,2894,0,29,18070
2/3/2022,1,10832,149,3788,2908,0,20,17697
2/3/2022,2,10846,134,3827,2873,0,19,17699
2/3/2022,3,10850,135,3719,2641,0,18,17363
2/3/2022,4,10851,155,3785,2430,0,18,17239
2/3/2022,5,10851,281,3763,2545,0,19,17459
2/3/2022,6,10857,465,3669,2084,0,15,17090
2/3/2022,7,10863,814,3512,2112,0,32,17333
2/3/2022,8,10864,918,3872,2207,0,47,17908
2/3/2022,9,10858,977,4384,2666,8,44,18937
2/3/2022,10,10852,1086,4576,2751,30,41,19336
2/3/2022,11,10850,1173,4565,2841,41,38,19508
2/3/2022,12,10842,1429,4395,2880,42,35,19623
2/3/2022,13,10834,1548,4111,3062,41,36,19632
2/3/2022,14,10836,1280,3910,3375,41,36,19478
2/3/2022,15,10840,1432,3706,3178,39,43,19238
2/3/2022,16,10841,1546,3758,3314,34,47,19540
2/3/2022,17,10836,1558,4613,3413,13,46,20479
2/3/2022,18,10839,1761,4971,3315,0,50,20936
2/3/2022,19,10844,2074,4900,3168,0,47,21033
2/3/2022,20,10844,2398,4692,2955,0,48,20937
2/3/2022,21,10843,2435,4394,2935,0,50,20657
2/3/2022,22,10847,1857,4000,3001,0,51,19756
2/3/2022,23,10846,789,3774,3026,0,55,18490
2/3/2022,24,10847,578,3712,2920,0,44,18101
2/4/2022,1,10842,583,3745,2944,0,32,18146
2/4/2022,2,10849,700,4077,2853,0,24,18503
2/4/2022,3,10852,1051,4077,2779,0,21,18780
2/4/2022,4,10850,1480,4082,2530,0,20,18962
2/4/2022,5,10848,1882,3948,2417,0,20,19115
2/4/2022,6,10855,2184,3684,2119,0,22,18864
2/4/2022,7,10844,3221,4222,2007,0,32,20326
2/4/2022,8,10844,4571,4395,1896,0,36,21742
2/4/2022,9,10840,5218,4757,1490,4,36,22345
2/4/2022,10,10845,5589,4699,1125,17,39,22314
2/4/2022,11,10838,5673,4786,890,35,40,22262
2/4/2022,12,10845,5509,4578,729,33,36,21730
2/4/2022,13,10835,5640,4429,618,34,36,21592
2/4/2022,14,10818,5793,4231,553,37,36,21468
2/4/2022,15,10807,5648,4261,513,29,36,21294
2/4/2022,16,10799,5237,4736,470,27,36,21305
2/4/2022,17,10800,5138,4741,422,13,36,21150
2/4/2022,18,10807,5328,4984,373,1,36,21529
2/4/2022,19,10699,5807,4754,441,0,36,21737
2/4/2022,20,10468,5533,4641,527,0,36,21205
2/4/2022,21,10057,5972,4562,613,0,36,21240
2/4/2022,22,10021,5942,4467,682,0,35,21147
2/4/2022,23,10028,5541,4408,624,0,35,20636
2/4/2022,24,10024,5162,4120,461,0,18,19785
2/5/2022,1,10018,4544,4185,417,0,1,19165
2/5/2022,2,10015,3978,4141,526,0,0,18660
2/5/2022,3,10023,3160,4156,583,0,0,17922
2/5/2022,4,10019,3607,4081,557,0,0,18264
2/5/2022,5,10023,3727,4018,651,0,0,18419
2/5/2022,6,10019,3388,4077,777,0,0,18261
2/5/2022,7,10025,3842,4119,839,1,3,18829
2/5/2022,8,10026,4256,4472,837,1,1,19593
2/5/2022,9,10026,5036,4471,721,14,0,20268
2/5/2022,10,10022,5344,4505,481,45,0,20397
2/5/2022,11,10023,5663,4594,278,65,0,20623
2/5/2022,12,10022,5635,4215,187,78,0,20137
2/5/2022,13,10020,5352,4187,135,89,0,19783
2/5/2022,14,10015,4521,4127,140,98,0,18901
2/5/2022,15,10028,4013,4108,176,96,0,18421
2/5/2022,16,10028,3890,4507,316,72,0,18813
2/5/2022,17,10029,4221,4810,583,20,0,19663
2/5/2022,18,10014,4574,4978,919,3,0,20488
2/5/2022,19,10024,5071,4855,1387,0,0,21337
2/5/2022,20,10028,4300,4685,1964,0,0,20977
2/5/2022,21,10021,3389,4503,2224,0,0,20137
2/5/2022,22,10024,2777,4013,2497,0,0,19311
2/5/2022,23,10021,2015,3653,2612,0,0,18301
2/5/2022,24,10025,1153,3703,3176,0,0,18057
2/6/2022,1,10027,994,3489,3099,0,0,17609
2/6/2022,2,10024,800,3560,3256,0,0,17640
2/6/2022,3,10029,761,3452,3191,0,0,17433
2/6/2022,4,10036,752,3420,3712,0,0,17920
2/6/2022,5,10032,833,3551,3846,0,0,18262
2/6/2022,6,10034,1042,3476,3411,0,0,17963
2/6/2022,7,10037,1379,3528,3399,1,0,18344
2/6/2022,8,10039,1528,3642,3852,2,0,19063
2/6/2022,9,10038,1539,3769,4043,15,0,19404
2/6/2022,10,10040,1592,4099,4049,50,0,19830
2/6/2022,11,10040,1783,3975,4025,75,0,19898
2/6/2022,12,10037,1929,3822,3956,97,0,19841
2/6/2022,13,10041,1909,3443,3834,109,0,19336
2/6/2022,14,10047,1547,3507,3711,120,0,18932
2/6/2022,15,10003,1766,3576,3352,133,0,18830
2/6/2022,16,10047,1942,3661,3067,116,0,18833
2/6/2022,17,10042,2270,4239,3079,61,0,19691
2/6/2022,18,10043,2621,4740,3252,7,0,20663
2/6/2022,19,10040,2726,4578,3364,0,0,20708
2/6/2022,20,10037,2451,4372,3494,0,0,20354
2/6/2022,21,10044,2302,3966,3367,0,0,19679
2/6/2022,22,10037,1897,3646,3390,0,0,18970
2/6/2022,23,10039,1656,3433,3088,0,0,18216
2/6/2022,24,10039,870,3516,2844,0,0,17269
2/7/2022,1,10035,399,3380,2987,0,4,16805
2/7/2022,2,10037,482,3322,2446,0,9,16296
2/7/2022,3,10044,733,3295,1911,0,10,15993
2/7/2022,4,10043,902,3289,1797,0,11,16042
2/7/2022,5,10050,1313,3293,1442,0,11,16109
2/7/2022,6,10044,2063,3289,1281,0,13,16690
2/7/2022,7,10038,2846,3597,1535,1,22,18039
2/7/2022,8,10040,3152,4308,2095,3,37,19635
2/7/2022,9,10037,3567,4399,2058,26,26,20113
2/7/2022,10,10036,3657,4439,1816,92,26,20066
2/7/2022,11,10046,3698,4341,1638,174,26,19923
2/7/2022,12,10048,3113,4288,1543,234,26,19252
2/7/2022,13,10041,2606,4130,1609,247,26,18659
2/7/2022,14,10047,2392,4001,1568,229,26,18263
2/7/2022,15,10042,2806,3835,1570,201,26,18480
2/7/2022,16,10045,3229,4070,1486,91,26,18947
2/7/2022,17,10047,3640,4688,1299,33,26,19733
2/7/2022,18,10059,4678,4911,1277,4,29,20958
2/7/2022,19,10054,4496,4901,1232,0,28,20711
2/7/2022,20,10053,4605,4711,1188,0,27,20584
2/7/2022,21,10052,3802,4600,1218,0,27,19699
2/7/2022,22,10051,3293,4345,1119,0,27,18835
2/7/2022,23,10054,3019,4182,884,0,27,18166
2/7/2022,24,10053,1950,4163,742,0,17,16925
2/8/2022,1,10053,2111,4025,647,0,12,16848
2/8/2022,2,10053,2188,4073,644,0,11,16969
2/8/2022,3,10056,2172,3900,722,0,12,16862
2/8/2022,4,10055,2154,3575,818,0,12,16614
2/8/2022,5,10048,2168,3617,781,0,12,16626
2/8/2022,6,10054,2336,4025,772,0,15,17202
2/8/2022,7,10016,2707,4312,835,1,31,17902
2/8/2022,8,10004,3401,4456,782,2,36,18681
2/8/2022,9,10005,3403,4486,777,25,37,18733
2/8/2022,10,9945,3311,4494,783,94,41,18668
2/8/2022,11,9938,3002,4561,807,168,43,18519
2/8/2022,12,9989,2782,4517,882,188,49,18407
2/8/2022,13,9889,2609,4184,1172,198,52,18104
2/8/2022,14,9866,2573,4023,1604,182,48,18296
2/8/2022,15,10052,2618,3745,1817,153,47,18432
2/8/2022,16,10066,2695,3764,1740,117,49,18431
2/8/2022,17,10050,2679,4388,1653,60,46,18876
2/8/2022,18,10055,2845,4876,1754,6,47,19583
2/8/2022,19,10060,3355,4832,1782,0,47,20076
2/8/2022,20,10059,2872,4591,2100,0,46,19668
2/8/2022,21,10058,2511,4076,2678,0,48,19371
2/8/2022,22,10058,2097,3661,2912,0,35,18763
2/8/2022,23,10051,1750,3526,3005,0,42,18374
2/8/2022,24,10058,744,3514,2970,0,41,17327
2/9/2022,1,10058,246,3412,2875,0,34,16625
2/9/2022,2,10056,137,3368,3148,0,27,16736
2/9/2022,3,10052,144,3470,2851,0,26,16543
2/9/2022,4,10055,228,3362,2997,0,22,16664
2/9/2022,5,10064,511,3267,2999,0,19,16860
2/9/2022,6,10065,966,3281,2756,0,29,17097
2/9/2022,7,10057,1092,3343,3103,1,36,17632
2/9/2022,8,10057,1162,3718,3891,8,41,18877
2/9/2022,9,10059,1163,3670,3661,52,40,18645
2/9/2022,10,10052,1178,3721,3297,101,37,18386
2/9/2022,11,10055,1191,3641,3599,212,33,18731
2/9/2022,12,10056,868,3725,3042,265,20,17976
2/9/2022,13,10053,826,3836,3135,246,29,18125
2/9/2022,14,10039,762,3804,3290,199,41,18135
2/9/2022,15,10045,779,3813,2872,233,45,17787
2/9/2022,16,10038,1010,3735,3054,123,37,17997
2/9/2022,17,10051,1040,4397,2762,76,9,18335
2/9/2022,18,10051,1158,4542,3306,6,0,19063
2/9/2022,19,10048,1275,4710,3340,0,0,19373
2/9/2022,20,10048,1227,4420,3229,0,11,18935
2/9/2022,21,10047,981,4279,3074,0,24,18405
2/9/2022,22,10041,656,3907,3182,0,27,17813
2/9/2022,23,10043,353,3553,3217,0,27,17193
2/9/2022,24,10042,153,3463,2986,0,19,16663
2/10/2022,1,10037,129,3457,2758,0,14,16395
2/10/2022,2,10038,135,3302,2462,0,12,15949
2/10/2022,3,10035,143,3366,2304,0,11,15859
2/10/2022,4,10036,244,3330,2473,0,12,16095
2/10/2022,5,10034,497,3367,2120,0,12,16030
2/10/2022,6,10039,860,3357,2110,0,15,16381
2/10/2022,7,10038,1113,3655,2298,1,24,17129
2/10/2022,8,10042,1231,4224,2652,1,28,18178
2/10/2022,9,10041,1699,4473,2420,16,26,18675
2/10/2022,10,10039,1678,4345,2510,40,27,18639
2/10/2022,11,10040,1366,4335,2567,71,26,18405
2/10/2022,12,10044,1544,4228,2413,76,26,18331
2/10/2022,13,10042,1804,4078,2479,143,27,18573
2/10/2022,14,10041,1433,3890,2537,117,28,18046
2/10/2022,15,10044,1502,4071,2401,105,27,18150
2/10/2022,16,10043,1580,4191,2558,44,26,18442
2/10/2022,17,10047,1608,4453,2495,16,26,18645
2/10/2022,18,10043,1813,5024,1971,2,26,18879
2/10/2022,19,10048,2622,4931,1845,0,26,19472
2/10/2022,20,10045,2093,4650,2119,0,26,18933
2/10/2022,21,10043,1683,4268,2333,0,26,18353
2/10/2022,22,10045,1508,3935,2492,0,26,18006
2/10/2022,23,10042,1296,3720,2576,0,26,17660
2/10/2022,24,10032,645,3744,2596,0,18,17035
2/11/2022,1,10033,217,3569,2626,0,16,16461
2/11/2022,2,10037,129,3549,2727,0,13,16455
2/11/2022,3,10042,129,3343,3082,0,13,16609
2/11/2022,4,10027,129,3307,3126,0,13,16602
2/11/2022,5,10028,129,3292,3274,0,12,16735
2/11/2022,6,10030,130,3335,3147,0,15,16657
2/11/2022,7,10037,130,3535,3840,1,23,17566
2/11/2022,8,10040,129,3808,4328,6,27,18338
2/11/2022,9,10040,131,3958,4364,38,26,18557
2/11/2022,10,10036,191,4279,4334,92,27,18959
2/11/2022,11,10036,330,3958,4346,82,27,18779
2/11/2022,12,10047,496,4199,4363,80,27,19212
2/11/2022,13,10049,713,4077,4325,99,27,19290
2/11/2022,14,10052,888,4069,4118,83,27,19237
2/11/2022,15,10050,1006,4122,4076,60,27,19341
2/11/2022,16,10048,1124,4129,3997,28,27,19353
2/11/2022,17,10043,1313,4395,3823,11,27,19612
2/11/2022,18,10040,1133,4668,3865,2,27,19735
2/11/2022,19,10042,1005,4758,3852,0,27,19684
2/11/2022,20,10038,932,4485,3861,0,27,19343
2/11/2022,21,10038,957,4500,3877,0,27,19399
2/11/2022,22,10039,485,4224,3840,0,26,18614
2/11/2022,23,10034,197,3750,3851,0,42,17874
2/11/2022,24,10035,129,3429,3577,0,63,17233
2/12/2022,1,10037,129,3367,2989,0,53,16575
2/12/2022,2,10038,129,3065,3057,0,51,16340
2/12/2022,3,10035,129,3117,2679,0,51,16011
2/12/2022,4,10038,129,3088,2578,0,48,15881
2/12/2022,5,10035,129,3068,2628,0,48,15908
2/12/2022,6,10041,129,3380,2909,0,48,16507
2/12/2022,7,10041,141,3474,3610,1,48,17315
2/12/2022,8,10045,155,3789,3730,1,48,17768
2/12/2022,9,10041,188,4028,3658,16,48,17979
2/12/2022,10,10036,376,4279,3425,70,48,18234
2/12/2022,11,10038,817,4546,2926,143,48,18518
2/12/2022,12,10045,1263,4080,2635,178,48,18249
2/12/2022,13,10051,1288,3612,2299,248,48,17546
2/12/2022,14,10061,1621,3750,1759,270,48,17509
2/12/2022,15,10057,2157,3908,1439,222,48,17831
2/12/2022,16,10054,2437,3762,1129,160,48,17590
2/12/2022,17,10058,2536,4589,994,103,48,18328
2/12/2022,18,10064,3327,4864,814,10,48,19127
2/12/2022,19,10063,4238,4640,646,0,48,19635
2/12/2022,20,10063,4246,4465,533,0,48,19355
2/12/2022,21,10063,4156,4161,514,0,48,18942
2/12/2022,22,10057,3809,4100,515,0,48,18529
2/12/2022,23,10050,3090,4024,519,0,48,17731
2/12/2022,24,10048,2628,3972,460,0,48,17156
2/13/2022,1,10052,1901,4060,420,0,15,16448
2/13/2022,2,10056,1757,3976,415,0,0,16204
2/13/2022,3,10055,1914,3891,355,0,0,16215
2/13/2022,4,10054,2373,3958,380,0,0,16765
2/13/2022,5,10049,2297,3848,447,0,0,16641
2/13/2022,6,10050,2538,3953,534,0,0,17075
2/13/2022,7,10048,3265,4112,564,2,0,17991
2/13/2022,8,10050,3642,4427,631,10,0,18760
2/13/2022,9,10052,3704,4334,516,76,0,18682
2/13/2022,10,10039,3963,4253,284,166,0,18705
2/13/2022,11,10034,4090,4221,168,250,0,18763
2/13/2022,12,10029,4411,4025,151,323,0,18939
2/13/2022,13,10038,4708,4031,99,328,0,19204
2/13/2022,14,10035,4978,3910,56,251,0,19230
2/13/2022,15,10038,4838,3918,39,216,0,19049
2/13/2022,16,10040,4604,4284,110,173,0,19211
2/13/2022,17,10041,5219,4480,166,74,0,19980
2/13/2022,18,10043,5810,4875,221,8,0,20957
2/13/2022,19,10038,6068,4901,370,0,0,21377
2/13/2022,20,10035,5747,4881,494,0,0,21157
2/13/2022,21,10036,5461,4706,628,0,0,20831
2/13/2022,22,10039,5635,4433,748,0,0,20855
2/13/2022,23,10036,4890,3900,928,0,0,19754
2/13/2022,24,10035,4474,3855,893,0,0,19257
2/14/2022,1,10035,4021,3762,731,0,0,18549
2/14/2022,2,10034,4251,3754,658,0,8,18705
2/14/2022,3,10040,4518,3822,578,0,10,18968
2/14/2022,4,10039,4785,3777,448,0,10,19059
2/14/2022,5,10038,4893,3819,463,0,10,19223
2/14/2022,6,10036,5005,3950,516,0,13,19520
2/14/2022,7,10040,5133,4368,489,2,21,20053
2/14/2022,8,10033,5416,4668,509,17,26,20669
2/14/2022,9,10031,5675,4647,440,124,27,20944
2/14/2022,10,10031,5966,4555,278,241,27,21098
2/14/2022,11,10033,6057,4075,199,316,27,20707
2/14/2022,12,10037,5720,4085,208,355,27,20432
2/14/2022,13,10036,5663,4038,317,361,28,20443
2/14/2022,14,10038,5298,3988,429,341,29,20123
2/14/2022,15,10036,4377,4143,475,294,27,19352
2/14/2022,16,10033,5216,4242,449,229,27,20196
2/14/2022,17,10035,5583,4894,381,124,28,21045
2/14/2022,18,10032,6301,4865,375,13,27,21613
2/14/2022,19,10033,6395,4859,565,0,27,21879
2/14/2022,20,10031,6709,4645,823,0,27,22235
2/14/2022,21,10033,6536,4396,1046,0,27,22038
2/14/2022,22,10035,6297,4182,1100,0,27,21641
2/14/2022,23,9611,5636,3913,1228,0,27,20415
2/14/2022,24,9197,5162,3978,1363,0,15,19715
2/15/2022,1,9159,3820,4011,1654,0,10,18654
2/15/2022,2,9161,3508,4095,1751,0,10,18525
2/15/2022,3,9159,4005,3943,1737,0,10,18854
2/15/2022,4,9161,3817,4077,1735,0,10,18800
2/15/2022,5,9160,3961,4146,1588,0,10,18865
2/15/2022,6,9166,4267,4279,1319,0,12,19043
2/15/2022,7,9163,5413,4597,1035,2,21,20231
2/15/2022,8,9160,6160,4940,758,10,28,21056
2/15/2022,9,9159,6610,4888,384,78,27,21146
2/15/2022,10,9161,6421,4662,184,235,27,20690
2/15/2022,11,9161,6372,4537,73,334,27,20504
2/15/2022,12,9165,5606,4396,56,365,27,19615
2/15/2022,13,9160,4984,4294,94,332,27,18891
2/15/2022,14,9163,3988,4195,155,355,27,17883
2/15/2022,15,9170,3731,4257,207,369,27,17761
2/15/2022,16,9174,3710,4528,286,300,27,18025
2/15/2022,17,9172,4981,4609,346,151,27,19286
2/15/2022,18,9163,6357,4786,525,16,27,20874
2/15/2022,19,9160,6227,4872,1173,0,27,21459
2/15/2022,20,9163,5566,4920,2008,0,27,21684
2/15/2022,21,9152,4740,4812,2691,0,27,21422
2/15/2022,22,9155,3653,4564,3257,0,28,20657
2/15/2022,23,9158,2423,3866,3488,0,45,18980
2/15/2022,24,9166,1470,3724,3695,0,60,18115
2/16/2022,1,9157,871,3228,2979,0,60,16295
2/16/2022,2,9162,572,3162,2665,0,60,15621
2/16/2022,3,9158,514,3150,2775,0,60,15657
2/16/2022,4,9160,520,3133,3000,0,60,15873
2/16/2022,5,9163,764,3047,3326,0,59,16359
2/16/2022,6,9166,1216,3054,3974,0,62,17472
2/16/2022,7,9168,1713,3458,4369,2,68,18778
2/16/2022,8,9167,2578,3806,4358,8,73,19990
2/16/2022,9,9167,3108,3752,4387,62,74,20550
2/16/2022,10,9169,2624,3774,4297,163,74,20101
2/16/2022,11,9170,2113,3622,4166,202,74,19347
2/16/2022,12,9166,1733,3200,3566,242,75,17982
2/16/2022,13,9164,1324,3276,4040,248,73,18125
2/16/2022,14,9165,1167,3285,4183,229,74,18103
2/16/2022,15,9167,1319,3603,4172,146,74,18481
2/16/2022,16,9166,1109,3584,4244,68,75,18246
2/16/2022,17,9170,1133,3632,4270,16,74,18295
2/16/2022,18,9170,1181,4202,4294,2,73,18922
2/16/2022,19,9170,1171,4148,4219,1,74,18783
2/16/2022,20,9168,963,4356,4332,0,75,18894
2/16/2022,21,9167,815,4240,4287,0,74,18583
2/16/2022,22,9164,588,3828,4340,0,75,17995
2/16/2022,23,9164,355,3390,4328,0,74,17311
2/16/2022,24,9153,137,3111,4183,0,65,16649
2/17/2022,1,9152,138,3219,3846,0,59,16414
2/17/2022,2,9156,136,3354,3904,0,60,16610
2/17/2022,3,9164,135,3611,3656,0,59,16625
2/17/2022,4,9162,150,3813,3213,0,60,16398
2/17/2022,5,9165,353,3887,3271,0,60,16736
2/17/2022,6,9168,490,3752,3049,0,62,16521
2/17/2022,7,9169,878,4401,2646,0,68,17162
2/17/2022,8,9174,1037,4259,3047,1,74,17592
2/17/2022,9,9165,1003,4442,2558,6,74,17248
2/17/2022,10,9164,1493,4579,2388,18,74,17716
2/17/2022,11,9158,1122,4252,2919,30,74,17555
2/17/2022,12,9156,1341,4574,2424,45,74,17614
2/17/2022,13,9160,1916,4699,2045,34,74,17928
2/17/2022,14,9162,2151,4690,1672,39,74,17788
2/17/2022,15,9169,2400,4522,1766,40,74,17971
2/17/2022,16,9168,2488,4374,1795,23,74,17922
2/17/2022,17,9176,2500,4473,1852,9,73,18083
2/17/2022,18,9174,2681,4803,1729,2,74,18463
2/17/2022,19,9189,2812,4753,1664,0,74,18492
2/17/2022,20,9185,2639,4613,1708,0,75,18220
2/17/2022,21,9184,2742,4449,1845,0,75,18295
2/17/2022,22,9186,2606,4216,2021,0,74,18103
2/17/2022,23,9181,1803,3935,2134,0,74,17127
2/17/2022,24,9182,867,4000,2105,0,66,16220
2/18/2022,1,9187,587,3838,2065,0,60,15737
2/18/2022,2,9184,841,3891,1909,0,59,15884
2/18/2022,3,9176,1037,3917,1846,0,59,16035
2/18/2022,4,9177,1114,3948,1808,0,58,16105
2/18/2022,5,9177,1136,3633,1788,0,58,15792
2/18/2022,6,9181,1497,3585,1623,0,61,15947
2/18/2022,7,9180,2026,4020,1479,1,70,16776
2/18/2022,8,9179,2651,4731,1413,2,74,18050
2/18/2022,9,9177,3230,4762,1236,25,75,18505
2/18/2022,10,9177,3559,4661,1035,57,75,18564
2/18/2022,11,9178,3497,4652,908,103,73,18411
2/18/2022,12,9179,3607,4797,696,140,73,18492
2/18/2022,13,9176,3661,4654,575,159,75,18300
2/18/2022,14,9181,3640,4292,674,208,74,18069
2/18/2022,15,9184,2530,4381,932,195,75,17297
2/18/2022,16,9179,2375,4098,1237,126,74,17089
2/18/2022,17,9173,2341,4709,1658,64,74,18019
2/18/2022,18,9177,2383,5040,2053,12,75,18740
2/18/2022,19,9177,2765,5025,2532,0,75,19574
2/18/2022,20,9175,2753,4882,2722,0,73,19605
2/18/2022,21,9174,3208,4617,2728,0,74,19801
2/18/2022,22,9176,3005,4297,3026,0,73,19577
2/18/2022,23,9177,2766,3975,3068,0,74,19060
2/18/2022,24,9178,1974,3877,3376,0,65,18470
2/19/2022,1,9174,1329,3603,3638,0,53,17797
2/19/2022,2,9176,857,3774,3786,0,47,17640
2/19/2022,3,9181,776,3773,3802,0,47,17579
2/19/2022,4,9183,792,3753,3740,0,47,17515
2/19/2022,5,9181,695,3693,3772,0,47,17388
2/19/2022,6,9186,662,3771,3853,0,47,17519
2/19/2022,7,9186,851,3919,3893,1,47,17897
2/19/2022,8,9183,1059,4332,4023,4,48,18649
2/19/2022,9,9185,984,4384,4040,60,48,18701
2/19/2022,10,9168,948,4331,4025,152,47,18671
2/19/2022,11,9167,997,4252,3968,221,47,18652
2/19/2022,12,9169,1167,4454,3949,276,47,19062
2/19/2022,13,9174,1245,4186,4014,296,48,18963
2/19/2022,14,9167,1291,4093,3899,221,48,18719
2/19/2022,15,9167,1784,3891,3758,249,47,18896
2/19/2022,16,9170,2014,3898,3162,191,49,18484
2/19/2022,17,9169,2151,4144,3189,108,48,18809
2/19/2022,18,9167,2763,4874,2787,24,47,19662
2/19/2022,19,9164,3588,4861,2117,0,47,19777
2/19/2022,20,9165,3926,4725,2058,0,47,19921
2/19/2022,21,9165,3756,4465,2284,0,47,19717
2/19/2022,22,9165,3116,4223,2293,0,47,18844
2/19/2022,23,9168,2465,4025,2114,0,48,17820
2/19/2022,24,9168,2251,4076,1981,0,48,17524
2/20/2022,1,9164,1808,4153,2225,0,48,17398
2/20/2022,2,9165,1303,3908,2662,0,47,17085
2/20/2022,3,9163,1209,3658,2876,0,47,16953
2/20/2022,4,9161,1136,3449,2724,0,48,16518
2/20/2022,5,9162,804,3300,3295,0,48,16609
2/20/2022,6,9170,344,3198,3591,0,48,16351
2/20/2022,7,9169,271,3407,3983,1,47,16878
2/20/2022,8,9170,272,3553,4225,7,48,17275
2/20/2022,9,9168,272,3665,4410,43,48,17606
2/20/2022,10,9168,272,3912,4411,124,48,17935
2/20/2022,11,9161,272,3769,4371,203,53,17829
2/20/2022,12,9159,286,3473,4380,321,57,17676
2/20/2022,13,9166,335,3394,4226,305,57,17483
2/20/2022,14,9170,516,3531,4183,282,59,17741
2/20/2022,15,9169,910,3398,3839,286,58,17660
2/20/2022,16,9172,921,3456,3577,264,57,17447
2/20/2022,17,9170,922,3729,3816,153,54,17844
2/20/2022,18,9175,918,4036,4079,27,47,18282
2/20/2022,19,9172,918,3984,4443,0,47,18564
2/20/2022,20,9169,918,4043,4462,0,47,18639
2/20/2022,21,9170,971,3998,4372,0,48,18559
2/20/2022,22,9172,346,4081,4173,0,48,17820
2/20/2022,23,9168,262,3948,3721,0,47,17146
2/20/2022,24,9173,266,3885,3245,0,47,16616
2/21/2022,1,9168,244,3645,2829,0,47,15933
2/21/2022,2,9165,277,3654,2586,0,47,15729
2/21/2022,3,9167,189,3485,2205,0,47,15093
2/21/2022,4,9172,265,3680,1897,0,47,15061
2/21/2022,5,9168,495,3811,1541,0,47,15062
2/21/2022,6,9166,824,3600,1325,0,47,14962
2/21/2022,7,9167,1357,3981,1063,2,47,15617
2/21/2022,8,9166,1746,4445,748,13,48,16166
2/21/2022,9,9164,2192,4256,649,80,48,16389
2/21/2022,10,9166,2209,4216,579,180,48,16398
2/21/2022,11,9164,2097,3798,564,264,48,15935
2/21/2022,12,9166,2124,3668,630,295,47,15930
2/21/2022,13,9166,1792,3559,579,305,48,15449
2/21/2022,14,9170,1767,3654,807,308,48,15754
2/21/2022,15,9172,1975,3677,599,272,47,15742
2/21/2022,16,9171,2111,3725,410,187,47,15651
2/21/2022,17,9171,2117,4294,581,60,48,16271
2/21/2022,18,9168,2064,4497,1532,14,48,17323
2/21/2022,19,9170,1600,4919,2285,0,47,18021
2/21/2022,20,9168,1164,4503,2745,0,48,17628
2/21/2022,21,9169,944,4065,3039,0,48,17265
2/21/2022,22,9173,1000,4171,3068,0,48,17460
2/21/2022,23,9172,724,4153,3163,0,48,17260
2/21/2022,24,9175,453,3888,3155,0,48,16719
2/22/2022,1,9168,166,3798,3119,0,48,16299
2/22/2022,2,9164,131,3627,3189,0,54,16165
2/22/2022,3,9161,132,3473,3281,0,57,16104
2/22/2022,4,9160,144,3548,3271,0,57,16180
2/22/2022,5,9159,290,3802,3338,0,58,16647
2/22/2022,6,9161,449,3345,3397,0,62,16414
2/22/2022,7,9158,852,4158,3292,0,73,17533
2/22/2022,8,9160,1651,4385,3213,6,75,18490
2/22/2022,9,9161,1774,4481,3352,25,74,18867
2/22/2022,10,9139,1734,4357,3319,45,74,18668
2/22/2022,11,9099,1781,4456,3200,50,74,18660
2/22/2022,12,9110,1596,4251,3427,47,74,18505
2/22/2022,13,9105,1391,4312,3610,43,74,18535
2/22/2022,14,9101,1118,4560,3599,31,74,18483
2/22/2022,15,9105,1148,4754,3427,23,75,18532
2/22/2022,16,9105,1419,5161,3103,18,75,18881
2/22/2022,17,9115,1776,5314,2924,11,75,19215
2/22/2022,18,9157,1774,5047,3259,2,75,19314
2/22/2022,19,9164,1439,4982,3420,0,74,19079
2/22/2022,20,9173,1385,4897,3294,0,74,18823
2/22/2022,21,9166,1280,4798,3062,0,75,18381
2/22/2022,22,9164,1147,4405,2972,0,75,17763
2/22/2022,23,9165,907,3875,2957,0,74,16978
2/22/2022,24,9168,518,3188,3197,0,68,16139
2/23/2022,1,9165,227,3030,3322,0,59,15803
2/23/2022,2,9167,139,3447,3069,0,58,15880
2/23/2022,3,9165,244,3861,2856,0,56,16182
2/23/2022,4,9143,195,3460,2921,0,57,15776
2/23/2022,5,9132,258,3076,2905,0,57,15428
2/23/2022,6,9139,393,3182,2914,0,60,15688
2/23/2022,7,9137,609,3515,2906,0,69,16236
2/23/2022,8,9133,1096,4584,3225,4,74,18116
2/23/2022,9,9152,1323,4776,3177,43,75,18546
2/23/2022,10,9155,1480,4833,3381,103,74,19026
2/23/2022,11,9151,1180,4707,3373,204,74,18689
2/23/2022,12,9154,1108,4499,3182,272,74,18289
2/23/2022,13,9151,1228,4467,3258,233,75,18412
2/23/2022,14,9150,1462,4389,2984,192,74,18251
2/23/2022,15,9157,1751,4438,2753,189,74,18362
2/23/2022,16,9168,2340,4363,2232,161,74,18338
2/23/2022,17,9170,2615,4747,2092,103,75,18802
2/23/2022,18,9171,3919,5496,1671,22,75,20354
2/23/2022,19,9176,4696,5410,1521,1,75,20879
2/23/2022,20,9173,4149,5511,1256,0,74,20163
2/23/2022,21,9172,4257,5393,1027,0,74,19923
2/23/2022,22,9170,4490,4952,802,0,75,19489
2/23/2022,23,9164,4490,4525,668,0,75,18922
2/23/2022,24,9165,3525,4333,668,0,68,17759
2/24/2022,1,9161,2975,4436,689,0,59,17320
2/24/2022,2,9162,2929,4167,787,0,59,17104
2/24/2022,3,9165,2798,4081,892,0,58,16994
2/24/2022,4,9167,2442,4128,986,0,55,16778
2/24/2022,5,9165,2707,4069,970,0,59,16970
2/24/2022,6,9164,3481,4051,894,0,60,17650
2/24/2022,7,9166,4712,4305,739,1,68,18991
2/24/2022,8,9167,5586,4351,744,31,74,19953
2/24/2022,9,9167,5381,4363,530,137,75,19653
2/24/2022,10,9170,4723,4146,778,297,73,19187
2/24/2022,11,9169,4503,4138,1037,378,74,19299
2/24/2022,12,9171,3616,4058,1216,426,74,18561
2/24/2022,13,9172,3576,4018,1079,430,75,18350
2/24/2022,14,9171,3314,4047,1004,425,75,18036
2/24/2022,15,9171,3201,3966,1140,410,74,17962
2/24/2022,16,9174,3292,3958,1429,335,74,18262
2/24/2022,17,9170,3896,4539,1640,179,74,19498
2/24/2022,18,9170,4163,4522,2196,33,78,20162
2/24/2022,19,9167,4366,4650,2447,0,83,20713
2/24/2022,20,9166,5497,4719,2209,0,74,21665
2/24/2022,21,9164,5817,4676,2250,0,74,21981
2/24/2022,22,9157,5511,4070,2611,0,74,21423
2/24/2022,23,9166,3902,3824,2850,0,75,19817
2/24/2022,24,9163,3471,3752,2769,0,66,19221
2/25/2022,1,9162,2893,3686,3002,0,59,18802
2/25/2022,2,9163,2518,3287,2953,0,59,17980
2/25/2022,3,9169,2490,3484,2934,0,60,18137
2/25/2022,4,9168,2645,3607,2494,0,60,17974
2/25/2022,5,9167,3226,3600,2352,0,59,18404
2/25/2022,6,9158,3842,3633,2107,0,61,18801
2/25/2022,7,9154,4435,4028,2160,0,48,19825
2/25/2022,8,9160,5226,4396,2252,5,53,21092
2/25/2022,9,9162,5472,4446,2248,36,73,21437
2/25/2022,10,9161,6011,4586,1771,56,73,21658
2/25/2022,11,9154,6177,4461,1547,88,73,21500
2/25/2022,12,9154,6219,4335,1480,107,81,21376
2/25/2022,13,9156,5864,3844,1457,182,74,20577
2/25/2022,14,9163,5846,3801,1447,177,73,20507
2/25/2022,15,9174,5578,3895,1334,168,73,20222
2/25/2022,16,9172,5868,4109,1142,183,73,20547
2/25/2022,17,9169,5510,4336,915,119,73,20122
2/25/2022,18,9164,5833,4446,764,28,73,20308
2/25/2022,19,9167,6515,4588,591,0,74,20935
2/25/2022,20,9164,6546,4662,460,0,74,20906
2/25/2022,21,9167,6453,4356,473,0,74,20523
2/25/2022,22,9168,6274,4255,503,0,74,20274
2/25/2022,23,9168,6038,3950,532,0,74,19762
2/25/2022,24,9170,4748,3814,622,0,62,18416
2/26/2022,1,9170,4637,3868,705,0,50,18430
2/26/2022,2,9163,3842,3760,1035,0,47,17847
2/26/2022,3,9163,3538,3747,1351,0,47,17846
2/26/2022,4,9166,3388,3651,1399,0,48,17652
2/26/2022,5,9168,3473,3760,1396,0,47,17844
2/26/2022,6,9168,3526,3846,1450,0,47,18037
2/26/2022,7,9171,3957,3866,1621,1,48,18664
2/26/2022,8,9172,4235,4150,1746,14,48,19365
2/26/2022,9,9168,4103,4046,1904,86,47,19354
2/26/2022,10,9174,3548,3930,2155,136,47,18990
2/26/2022,11,9167,3126,3745,2473,249,47,18807
2/26/2022,12,9174,2278,3266,2847,273,48,17886
2/26/2022,13,9173,2116,3281,3518,204,49,18341
2/26/2022,14,9172,1803,3480,3848,194,49,18546
2/26/2022,15,9165,1918,3498,4017,154,49,18801
2/26/2022,16,9165,2390,3370,3703,105,49,18782
2/26/2022,17,9172,2628,3482,3521,67,51,18921
2/26/2022,18,9170,2616,3613,3989,20,50,19458
2/26/2022,19,9167,2626,3783,4185,0,47,19808
2/26/2022,20,9172,2625,3527,4296,0,48,19668
2/26/2022,21,9174,2296,3407,4429,0,48,19354
2/26/2022,22,9176,1718,3181,4418,0,47,18540
2/26/2022,23,9175,1152,3440,4357,0,47,18171
2/26/2022,24,9178,822,3099,4376,0,48,17523
2/27/2022,1,9183,418,2710,4266,0,47,16624
2/27/2022,2,9178,192,2825,4175,0,47,16417
2/27/2022,3,9182,135,2823,4312,0,48,16500
2/27/2022,4,9182,135,2836,4384,0,48,16585
2/27/2022,5,9174,135,2941,4404,0,48,16702
2/27/2022,6,9171,132,3310,4308,0,48,16969
2/27/2022,7,9173,131,3406,4301,1,47,17059
2/27/2022,8,9175,131,3522,4285,17,48,17178
2/27/2022,9,9173,132,3525,4202,79,48,17159
2/27/2022,10,9177,152,3689,3937,127,47,17129
2/27/2022,11,9176,218,3458,3683,152,47,16734
2/27/2022,12,9180,153,3225,3549,212,47,16366
2/27/2022,13,9172,266,3293,3513,234,49,16527
2/27/2022,14,9166,530,3531,3319,239,48,16833
2/27/2022,15,9147,1356,3586,2898,218,48,17253
2/27/2022,16,9164,2088,3272,2636,192,52,17404
2/27/2022,17,9172,2462,3531,2508,90,49,17812
2/27/2022,18,9174,2850,4065,2573,23,12,18697
2/27/2022,19,9173,3176,4349,2328,1,0,19027
2/27/2022,20,9170,3153,4291,2444,0,0,19058
2/27/2022,21,9167,3100,4057,2466,0,1,18791
2/27/2022,22,9171,2654,3610,2607,0,0,18042
2/27/2022,23,9170,2741,3331,2147,0,0,17389
2/27/2022,24,9174,2973,3222,1453,0,0,16822
2/28/2022,1,9172,3211,3306,1164,0,0,16853
2/28/2022,2,9175,3497,3448,1003,0,0,17123
2/28/2022,3,9173,3375,3454,753,0,0,16755
2/28/2022,4,9174,3868,3555,667,0,0,17264
2/28/2022,5,9171,3472,3630,555,0,15,16843
2/28/2022,6,9172,4187,3759,484,1,17,17620
2/28/2022,7,9172,5785,3967,487,2,24,19437
2/28/2022,8,9171,6095,4118,415,56,26,19881
2/28/2022,9,9168,5426,4175,315,203,27,19314
2/28/2022,10,9169,4615,4282,282,329,27,18704
2/28/2022,11,9172,4550,4073,320,384,28,18527
2/28/2022,12,9173,4719,3762,416,384,27,18481
2/28/2022,13,9172,4763,3620,488,385,26,18454
2/28/2022,14,9171,5234,3678,525,309,26,18943
2/28/2022,15,9170,5176,3659,701,261,27,18994
2/28/2022,16,9177,4981,3704,794,185,23,18864
2/28/2022,17,9173,4937,4194,1088,99,24,19515
2/28/2022,18,9174,5132,4356,1271,25,26,19984
2/28/2022,19,9171,5408,4424,1841,1,25,20870
2/28/2022,20,9171,4838,4476,2332,0,25,20842
2/28/2022,21,9168,4850,4354,2078,0,25,20475
2/28/2022,22,9169,4939,3768,2104,0,27,20007
2/28/2022,23,9177,3601,3479,2371,0,26,18654
2/28/2022,24,9164,2996,3319,2601,0,17,18097
3/1/2022,1,9161,2309,3422,2583,0,13,17488
3/1/2022,2,9172,2232,3395,2558,0,12,17369
3/1/2022,3,9166,2657,3484,2250,0,12,17569
3/1/2022,4,9167,3060,3470,1839,0,12,17548
3/1/2022,5,9161,3691,3336,1826,0,11,18025
3/1/2022,6,9068,3845,3413,2013,0,14,18353
3/1/2022,7,9066,4073,3825,2181,2,7,19154
3/1/2022,8,9066,4687,4140,2195,13,33,20134
3/1/2022,9,9075,5211,4073,2013,45,31,20448
3/1/2022,10,9084,5301,3873,1951,89,27,20325
3/1/2022,11,9179,5424,3749,1816,147,28,20343
3/1/2022,12,9186,5266,3602,1674,194,28,19950
3/1/2022,13,9181,4818,3618,1633,199,28,19477
3/1/2022,14,9183,4439,3747,1654,140,30,19193
3/1/2022,15,9183,4414,3631,1446,130,29,18833
3/1/2022,16,9184,4225,3671,1563,104,27,18774
3/1/2022,17,9181,4384,4082,2000,51,27,19725
3/1/2022,18,9182,4507,4338,2084,21,27,20159
3/1/2022,19,9179,4473,4389,2288,1,26,20356
3/1/2022,20,9176,4124,4569,2019,0,27,19915
3/1/2022,21,9176,4690,4424,1707,0,26,20023
3/1/2022,22,9172,4381,3883,1408,0,26,18870
3/1/2022,23,9172,3563,3701,1082,0,26,17544
3/1/2022,24,9171,3172,3588,841,0,17,16789
3/2/2022,1,9173,2565,3751,608,0,13,16110
3/2/2022,2,9172,2474,3697,363,0,13,15719
3/2/2022,3,9173,2639,3623,271,0,13,15719
3/2/2022,4,9168,2895,3568,357,0,12,16000
3/2/2022,5,9169,2981,3247,229,0,26,15652
3/2/2022,6,9171,3404,3852,255,0,39,16721
3/2/2022,7,9170,4775,4101,299,1,52,18398
3/2/2022,8,9176,5144,4342,294,23,56,19035
3/2/2022,9,9172,5119,4375,234,77,56,19033
3/2/2022,10,9173,4946,4246,440,211,50,19066
3/2/2022,11,9177,3509,3971,663,270,49,17639
3/2/2022,12,9173,2911,3589,1053,320,53,17099
3/2/2022,13,9173,2730,3485,1170,288,58,16904
3/2/2022,14,9174,2745,3873,1191,247,57,17287
3/2/2022,15,9177,3086,3821,1176,200,57,17517
3/2/2022,16,9173,2978,3897,1130,115,55,17348
3/2/2022,17,9172,3586,4384,1050,62,51,18305
3/2/2022,18,9176,4268,4592,1172,11,49,19268
3/2/2022,19,9179,4554,4663,1108,0,45,19549
3/2/2022,20,9180,4304,4575,1437,0,45,19541
3/2/2022,21,9178,3303,4250,2550,0,51,19332
3/2/2022,22,9181,2709,3409,2795,0,54,18148
3/2/2022,23,9178,1855,3215,2326,0,53,16627
3/2/2022,24,9178,1383,3175,2164,0,30,15930
3/3/2022,1,9171,1227,3191,2153,0,10,15752
3/3/2022,2,9170,1230,3203,2352,0,11,15966
3/3/2022,3,9171,1258,3142,2733,0,11,16315
3/3/2022,4,9171,1418,3441,2375,0,11,16416
3/3/2022,5,9174,1810,3443,2062,0,11,16500
3/3/2022,6,9171,2166,3437,1461,0,13,16248
3/3/2022,7,9170,3063,4169,1077,1,23,17503
3/3/2022,8,9170,3689,4383,878,14,49,18183
3/3/2022,9,9166,4008,4309,865,84,48,18480
3/3/2022,10,9165,4034,4335,858,171,42,18605
3/3/2022,11,9164,3853,4069,777,264,51,18178
3/3/2022,12,9164,3171,3833,926,314,43,17451
3/3/2022,13,9166,2758,3639,1264,362,54,17243
3/3/2022,14,9169,2482,3344,1517,388,51,16951
3/3/2022,15,9168,2606,3530,1502,362,45,17213
3/3/2022,16,9172,3108,3515,1162,264,41,17262
3/3/2022,17,9174,3365,3950,1213,185,31,17918
3/3/2022,18,9173,3919,4807,1159,58,27,19143
3/3/2022,19,9175,4906,5035,883,0,27,20026
3/3/2022,20,9174,5311,4891,788,0,27,20191
3/3/2022,21,9176,5346,4645,721,0,27,19915
3/3/2022,22,9179,4810,4259,690,0,27,18965
3/3/2022,23,9177,4278,3880,759,0,27,18121
3/3/2022,24,9178,3256,3773,879,0,16,17102
3/4/2022,1,9178,2969,3569,949,0,12,16677
3/4/2022,2,9177,2509,3506,1298,0,12,16502
3/4/2022,3,9176,2317,3378,1649,0,12,16532
3/4/2022,4,9175,2349,3236,1667,0,12,16439
3/4/2022,5,9181,2577,3338,1547,0,12,16655
3/4/2022,6,9179,3060,3809,1569,1,13,17631
3/4/2022,7,9180,4183,4188,1664,1,19,19235
3/4/2022,8,9179,4394,4641,1609,43,25,19891
3/4/2022,9,9177,4594,4679,1410,150,27,20037
3/4/2022,10,9182,3613,4341,1281,267,27,18711
3/4/2022,11,9183,3125,3879,1546,353,28,18114
3/4/2022,12,9183,2590,3364,1386,398,27,16948
3/4/2022,13,9190,2173,3335,1616,381,27,16722
3/4/2022,14,9188,2207,3396,1649,353,28,16821
3/4/2022,15,9191,2586,3457,1739,315,35,17323
3/4/2022,16,9195,2813,3483,1430,297,39,17257
3/4/2022,17,9193,2891,3952,898,178,42,17154
3/4/2022,18,9189,3000,4439,1101,43,41,17813
3/4/2022,19,9190,3115,4849,944,1,41,18140
3/4/2022,20,9191,3335,4835,831,0,31,18223
3/4/2022,21,9189,3197,4704,754,0,27,17871
3/4/2022,22,9185,3145,4281,647,0,29,17287
3/4/2022,23,9184,2822,3894,586,0,29,16515
3/4/2022,24,9173,2407,3598,535,0,13,15726
3/5/2022,1,9160,1843,3713,490,0,0,15206
3/5/2022,2,9182,1669,3728,463,0,0,15042
3/5/2022,3,9183,1314,3275,628,0,0,14400
3/5/2022,4,9182,950,3283,830,0,0,14245
3/5/2022,5,9181,864,3300,946,0,0,14291
3/5/2022,6,9181,952,3341,1210,0,0,14684
3/5/2022,7,9183,1105,3552,1544,2,0,15386
3/5/2022,8,9180,1243,3754,1738,26,0,15941
3/5/2022,9,9180,1362,3917,1954,77,0,16490
3/5/2022,10,9180,1476,3904,2262,139,0,16961
3/5/2022,11,9171,1477,3703,2086,212,0,16649
3/5/2022,12,9173,1245,3524,2330,231,0,16503
3/5/2022,13,9166,847,3460,2641,269,0,16383
3/5/2022,14,9165,787,3489,2379,276,0,16096
3/5/2022,15,9163,978,3703,2526,282,0,16652
3/5/2022,16,9160,1138,4085,2496,138,0,17017
3/5/2022,17,9165,786,4328,2780,69,0,17128
3/5/2022,18,9159,613,4705,2944,21,0,17442
3/5/2022,19,9160,1022,4870,2751,0,0,17803
3/5/2022,20,9165,1011,4290,2709,0,0,17175
3/5/2022,21,9165,841,3830,2947,0,0,16783
3/5/2022,22,9163,249,3724,3222,0,0,16358
3/5/2022,23,9167,130,3412,3404,0,0,16113
3/5/2022,24,9168,130,3091,3346,0,0,15735
3/6/2022,1,9164,130,3030,3199,0,0,15523
3/6/2022,2,9168,130,2959,3276,0,0,15533
3/6/2022,3,9173,130,3003,3041,0,3,15350
3/6/2022,4,9177,130,3041,3074,0,4,15426
3/6/2022,5,9176,129,3071,2930,0,13,15319
3/6/2022,6,9176,130,3120,3127,0,16,15569
3/6/2022,7,9177,130,3243,3255,0,14,15819
3/6/2022,8,9182,131,3331,3070,14,9,15737
3/6/2022,9,9180,130,3388,3074,110,0,15882
3/6/2022,10,9175,130,3492,2810,205,1,15813
3/6/2022,11,9179,130,3510,2541,355,9,15724
3/6/2022,12,9170,130,3623,2548,359,9,15839
3/6/2022,13,9171,138,3506,3106,308,3,16232
3/6/2022,14,9170,149,3679,2472,290,0,15760
3/6/2022,15,9165,236,3590,2578,290,0,15859
3/6/2022,16,9163,390,3967,3125,214,0,16859
3/6/2022,17,9154,550,4202,3402,119,0,17427
3/6/2022,18,9150,583,4529,3961,35,0,18258
3/6/2022,19,9169,585,4554,3730,0,0,18038
3/6/2022,20,9174,599,4149,3369,0,0,17291
3/6/2022,21,9178,604,4384,2787,0,0,16953
3/6/2022,22,9179,871,4359,2244,0,0,16653
3/6/2022,23,9179,367,4458,1454,0,0,15458
3/6/2022,24,9173,533,4531,730,0,0,14967
3/7/2022,1,9175,629,4126,490,0,0,14420
3/7/2022,2,9182,474,3641,304,0,7,13608
3/7/2022,3,9186,373,3635,253,0,10,13457
3/7/2022,4,9183,573,3822,200,0,10,13788
3/7/2022,5,9185,1093,3519,244,0,10,14051
3/7/2022,6,9185,1646,3396,213,0,13,14453
3/7/2022,7,9181,2122,3949,568,0,22,15842
3/7/2022,8,9181,2653,4547,707,4,27,17119
3/7/2022,9,9176,3326,4689,607,19,27,17844
3/7/2022,10,9175,3250,4709,638,33,27,17832
3/7/2022,11,9172,3195,4531,646,41,27,17612
3/7/2022,12,9188,3749,4559,441,57,27,18021
3/7/2022,13,9179,3790,4356,735,51,27,18138
3/7/2022,14,9177,3320,4086,1460,50,27,18120
3/7/2022,15,9186,2596,3995,1835,56,27,17695
3/7/2022,16,9186,2600,4176,2380,41,27,18410
3/7/2022,17,9180,2910,4515,2598,28,27,19258
3/7/2022,18,9178,3216,4802,2663,8,27,19894
3/7/2022,19,9174,3328,4803,2811,1,27,20144
3/7/2022,20,9177,3307,4917,2634,0,27,20062
3/7/2022,21,9176,2435,4527,2697,0,27,18862
3/7/2022,22,9179,1680,4291,2459,0,27,17636
3/7/2022,23,9177,1031,4097,2269,0,27,16601
3/7/2022,24,9182,822,3836,2385,0,18,16243
3/8/2022,1,9182,523,3760,2612,0,10,16087
3/8/2022,2,9178,518,3613,2697,0,10,16016
3/8/2022,3,9175,597,3423,2820,0,9,16024
3/8/2022,4,9176,775,3772,2356,0,9,16088
3/8/2022,5,9179,1020,3796,1838,0,9,15842
3/8/2022,6,9185,1375,3878,1271,1,13,15723
3/8/2022,7,9190,2039,4148,921,2,20,16320
3/8/2022,8,9190,2540,4411,666,35,8,16850
3/8/2022,9,9186,2773,4476,498,130,24,17087
3/8/2022,10,9188,2801,4321,390,240,27,16967
3/8/2022,11,9187,2694,4082,351,318,27,16659
3/8/2022,12,9187,2264,3959,465,321,27,16223
3/8/2022,13,9192,2148,3815,718,301,27,16201
3/8/2022,14,9189,2101,3537,1041,314,27,16209
3/8/2022,15,9191,2013,3498,1246,291,27,16266
3/8/2022,16,9187,2044,3774,1232,218,27,16482
3/8/2022,17,9187,2119,4162,1342,122,27,16959
3/8/2022,18,9190,2471,4990,1206,27,27,17911
3/8/2022,19,9191,2744,5012,1312,1,27,18287
3/8/2022,20,9194,2883,5090,1352,1,27,18547
3/8/2022,21,9188,3402,4890,1306,0,27,18813
3/8/2022,22,9188,3386,4584,1237,0,27,18422
3/8/2022,23,9185,2327,4143,1310,0,27,16992
3/8/2022,24,9183,1699,3434,1287,0,20,15623
3/9/2022,1,9183,1922,3356,1118,0,10,15589
3/9/2022,2,9186,1917,3344,1383,0,9,15839
3/9/2022,3,8851,2041,3541,1165,0,9,15607
3/9/2022,4,8387,2734,3740,877,0,9,15747
3/9/2022,5,8391,2705,3755,565,0,16,15432
3/9/2022,6,8390,2820,3707,603,0,18,15538
3/9/2022,7,8384,3728,4308,593,1,41,17055
3/9/2022,8,8383,4216,4589,632,21,73,17914
3/9/2022,9,8384,4161,4482,570,69,80,17746
3/9/2022,10,8383,3876,4381,492,142,81,17355
3/9/2022,11,8396,3700,4243,615,183,82,17219
3/9/2022,12,8396,2983,4243,735,228,83,16668
3/9/2022,13,8388,2845,4000,863,266,83,16445
3/9/2022,14,8394,2400,3802,1132,256,81,16065
3/9/2022,15,8386,2447,3686,1143,266,83,16011
3/9/2022,16,8368,2454,3739,1342,239,82,16224
3/9/2022,17,8371,2453,4102,1433,148,82,16589
3/9/2022,18,8366,2457,4555,1900,53,82,17413
3/9/2022,19,8357,2531,5050,1979,0,83,18000
3/9/2022,20,8354,2653,5090,2120,0,83,18300
3/9/2022,21,8355,2157,4822,2314,0,83,17731
3/9/2022,22,8354,2063,4557,2219,0,83,17276
3/9/2022,23,8358,1866,4190,1984,0,38,16436
3/9/2022,24,8350,1981,3792,1798,0,20,15941
3/10/2022,1,8350,1889,4027,1654,0,11,15931
3/10/2022,2,8346,1882,3886,1473,0,10,15597
3/10/2022,3,8344,1885,3856,1505,0,13,15603
3/10/2022,4,8351,2010,4128,1095,0,13,15597
3/10/2022,5,8351,2268,4150,717,0,11,15497
3/10/2022,6,8358,2413,4128,544,1,28,15472
3/10/2022,7,8358,2880,4385,537,3,34,16197
3/10/2022,8,8359,3456,4791,510,49,79,17244
3/10/2022,9,8358,3509,4828,366,110,78,17249
3/10/2022,10,8358,3143,4540,219,217,76,16553
3/10/2022,11,8359,2851,4270,287,309,79,16155
3/10/2022,12,8361,2475,4173,459,370,79,15917
3/10/2022,13,8358,2446,4010,394,385,78,15671
3/10/2022,14,8360,2201,3973,397,353,78,15362
3/10/2022,15,8359,2350,3970,377,345,78,15479
3/10/2022,16,8363,2615,4037,291,261,73,15640
3/10/2022,17,8363,2815,4611,277,158,79,16303
3/10/2022,18,8365,3434,4972,268,56,79,17174
3/10/2022,19,8363,3296,5067,330,1,79,17136
3/10/2022,20,8365,3436,5203,400,1,79,17484
3/10/2022,21,8362,3925,5019,291,0,81,17678
3/10/2022,22,8363,4114,4611,226,0,79,17393
3/10/2022,23,8365,3695,4216,192,0,39,16507
3/10/2022,24,8362,3002,3972,140,0,19,15495
3/11/2022,1,8363,2310,3985,119,0,10,14787
3/11/2022,2,8365,2091,3975,112,0,10,14553
3/11/2022,3,8371,2194,3952,165,0,10,14692
3/11/2022,4,8377,2280,3864,275,0,10,14806
3/11/2022,5,8390,2371,3698,342,0,12,14813
3/11/2022,6,8397,2515,3960,294,1,28,15195
3/11/2022,7,8397,3035,4420,320,3,68,16243
3/11/2022,8,8397,3914,4722,309,35,76,17453
3/11/2022,9,8396,4178,4739,272,107,76,17768
3/11/2022,10,8396,4099,4544,231,209,76,17555
3/11/2022,11,8396,3698,4612,229,210,76,17221
3/11/2022,12,8397,3533,4886,243,189,76,17324
3/11/2022,13,8399,3713,4641,304,158,76,17291
3/11/2022,14,8401,3527,4310,443,133,76,16890
3/11/2022,15,8399,3305,4314,448,91,76,16633
3/11/2022,16,8395,3157,4441,521,57,76,16647
3/11/2022,17,8392,3383,4731,586,33,76,17201
3/11/2022,18,8393,3260,4901,884,11,76,17525
3/11/2022,19,8394,3164,5007,1158,0,78,17801
3/11/2022,20,8394,2683,5034,1289,0,78,17478
3/11/2022,21,8393,2323,4897,1496,0,77,17186
3/11/2022,22,8396,2197,4356,1892,0,78,16919
3/11/2022,23,8393,1282,4337,2201,0,37,16250
3/11/2022,24,8388,661,3736,2974,0,14,15773
3/12/2022,1,8390,160,3245,3240,0,6,15041
3/12/2022,2,8385,131,3231,3285,0,0,15032
3/12/2022,3,8379,130,3189,3485,0,0,15183
3/12/2022,4,8356,144,3159,3590,0,0,15249
3/12/2022,5,8356,150,3245,3767,0,0,15518
3/12/2022,6,8360,235,3280,3535,0,0,15410
3/12/2022,7,8361,416,3442,3412,1,0,15632
3/12/2022,8,8366,544,3668,3570,7,0,16155
3/12/2022,9,8362,676,4141,3632,27,0,16838
3/12/2022,10,8360,810,4141,3670,65,0,17046
3/12/2022,11,8360,815,3870,3726,101,0,16872
3/12/2022,12,8360,868,3761,3766,135,0,16890
3/12/2022,13,8359,842,3432,3849,157,0,16639
3/12/2022,14,8359,1066,3215,3918,157,0,16715
3/12/2022,15,8356,1509,3133,3879,181,0,17058
3/12/2022,16,8352,1802,3250,4100,124,0,17628
3/12/2022,17,8353,1889,3429,3641,66,0,17378
3/12/2022,18,8353,1965,3572,3841,27,0,17758
3/12/2022,19,8356,1974,3981,4033,1,0,18345
3/12/2022,20,8356,2037,3983,3950,0,0,18326
3/12/2022,21,8357,2045,3782,3856,0,0,18040
3/12/2022,22,8357,1484,3839,3714,0,0,17394
3/12/2022,23,8356,1212,3748,3424,0,0,16740
3/12/2022,24,8354,774,3826,2981,0,0,15935
3/13/2022,1,8356,898,3683,2590,0,0,15527
3/13/2022,2,8357,781,3533,2380,0,0,15051
3/13/2022,3,8350,612,3446,2130,0,0,14538
3/13/2022,4,8353,623,3712,2081,0,0,14769
3/13/2022,5,8352,742,3601,2216,0,0,14911
3/13/2022,6,8354,777,3506,2450,1,0,15088
3/13/2022,7,8355,740,3607,2858,3,0,15563
3/13/2022,8,8353,730,3734,3099,10,0,15926
3/13/2022,9,8346,785,3882,3453,34,0,16500
3/13/2022,10,8351,796,3740,3730,78,0,16695
3/13/2022,11,8349,803,3891,3807,114,0,16964
3/13/2022,12,8350,989,3802,3734,171,0,17046
3/13/2022,13,8349,997,3603,3660,156,0,16765
3/13/2022,14,8353,1151,3420,3532,118,0,16574
3/13/2022,15,8348,1342,3593,3266,124,0,16673
3/13/2022,16,8355,1745,4097,2811,82,0,17090
3/13/2022,17,8356,2466,4166,2292,47,0,17327
3/13/2022,18,8399,3120,4202,2031,17,0,17769
3/13/2022,19,8585,2965,4402,1992,2,0,17946
3/13/2022,20,8591,2605,4384,2070,0,0,17650
3/13/2022,21,8718,2119,4238,2068,0,0,17143
3/13/2022,22,8809,1920,3852,2155,0,0,16736
3/13/2022,23,8810,1515,3634,1872,0,0,15831
3/13/2022,24,8881,942,3922,1401,0,0,15146
3/14/2022,1,8891,1114,4190,1097,0,0,15292
3/14/2022,2,8888,1043,3772,1033,0,0,14736
3/14/2022,3,8885,949,3734,1007,0,0,14575
3/14/2022,4,8891,1268,3660,1077,0,0,14896
3/14/2022,5,8901,1729,3587,1103,0,12,15332
3/14/2022,6,8901,2558,3624,1205,1,21,16310
3/14/2022,7,8895,3306,4121,1199,2,26,17549
3/14/2022,8,8895,3783,4338,1240,37,44,18337
3/14/2022,9,8898,3728,4332,1221,121,71,18371
3/14/2022,10,8902,3242,4280,970,203,77,17674
3/14/2022,11,8900,2735,4100,1059,283,78,17155
3/14/2022,12,8904,2142,3644,1186,341,78,16295
3/14/2022,13,8905,1992,3670,1095,334,78,16074
3/14/2022,14,8909,1996,3635,1408,280,79,16307
3/14/2022,15,8912,2013,3727,1546,206,80,16484
3/14/2022,16,8899,2118,3860,1190,134,79,16280
3/14/2022,17,8897,2459,4338,1159,72,78,17003
3/14/2022,18,8908,2426,4611,946,27,80,16998
3/14/2022,19,8911,2768,4930,845,0,80,17534
3/14/2022,20,8907,2717,4854,770,0,80,17328
3/14/2022,21,8902,2442,4475,967,0,81,16867
3/14/2022,22,8902,2096,4420,744,0,77,16239
3/14/2022,23,8904,2378,3969,390,0,66,15707
3/14/2022,24,8904,1623,3851,564,0,59,15001
3/15/2022,1,8906,1567,3545,650,0,59,14727
3/15/2022,2,8905,1575,3437,726,0,59,14702
3/15/2022,3,8904,1644,3867,649,0,59,15123
3/15/2022,4,8903,1909,3842,570,0,59,15283
3/15/2022,5,8906,2149,3538,505,0,61,15159
3/15/2022,6,8906,2408,3728,535,2,67,15646
3/15/2022,7,8903,2568,4114,855,4,73,16517
3/15/2022,8,8902,2973,4427,881,43,73,17299
3/15/2022,9,8903,2801,4479,825,110,74,17192
3/15/2022,10,8898,2969,4523,715,180,75,17360
3/15/2022,11,8899,2787,4517,691,207,74,17175
3/15/2022,12,8902,3008,4326,543,184,74,17037
3/15/2022,13,8906,3010,4222,377,138,75,16728
3/15/2022,14,8893,3122,4335,221,156,27,16754
3/15/2022,15,8853,3241,4307,234,122,77,16834
3/15/2022,16,8850,3113,4485,242,66,32,16788
3/15/2022,17,8858,2952,4620,272,58,37,16797
3/15/2022,18,8895,3170,4843,229,20,28,17185
3/15/2022,19,8949,3140,5000,226,2,27,17344
3/15/2022,20,8953,3141,4964,255,1,27,17341
3/15/2022,21,9076,2821,4915,352,0,27,17191
3/15/2022,22,9112,2089,4477,470,0,27,16175
3/15/2022,23,9125,1670,3944,624,0,16,15379
3/15/2022,24,9125,1013,3800,624,0,12,14574
3/16/2022,1,9121,958,3751,517,0,12,14359
3/16/2022,2,9092,1215,3790,509,0,12,14618
3/16/2022,3,9053,1314,3757,512,0,12,14648
3/16/2022,4,9038,1304,3801,385,0,13,14541
3/16/2022,5,8998,1611,3679,360,0,15,14663
3/16/2022,6,8953,2391,4096,332,0,23,15795
3/16/2022,7,8952,3019,4587,282,2,27,16869
3/16/2022,8,8939,3239,4564,299,23,27,17091
3/16/2022,9,8908,2968,4533,358,77,73,16917
3/16/2022,10,8889,2918,4493,359,125,73,16857
3/16/2022,11,8892,2639,4348,404,186,73,16542
3/16/2022,12,8878,2355,4190,464,276,73,16236
3/16/2022,13,8868,2134,4088,480,316,73,15959
3/16/2022,14,8865,2042,4025,436,291,73,15732
3/16/2022,15,8865,2029,4038,510,240,73,15755
3/16/2022,16,8863,2222,4220,476,209,73,16063
3/16/2022,17,8861,2239,4487,584,122,73,16366
3/16/2022,18,8860,2264,4731,899,32,73,16859
3/16/2022,19,8860,2033,4883,1360,3,73,17212
3/16/2022,20,8860,1757,4308,1874,0,72,16871
3/16/2022,21,8860,1734,4055,2218,0,73,16940
3/16/2022,22,8849,1401,3914,2295,0,73,16532
3/16/2022,23,8838,1175,3618,2392,0,63,16086
3/16/2022,24,8838,783,3262,2547,0,60,15490
3/17/2022,1,8849,684,3136,2451,0,13,15133
3/17/2022,2,8847,562,3579,2249,0,13,15250
3/17/2022,3,8852,644,3766,1920,0,12,15194
3/17/2022,4,8849,745,3721,1655,0,13,14983
3/17/2022,5,8854,1046,3312,1675,0,15,14902
3/17/2022,6,8855,1581,3328,1584,0,23,15371
3/17/2022,7,8852,1782,3873,1769,5,27,16308
3/17/2022,8,8851,1962,4122,1822,80,47,16884
3/17/2022,9,8845,1965,3977,1525,205,65,16582
3/17/2022,10,8842,1966,4071,1060,327,79,16345
3/17/2022,11,8838,1963,4155,839,367,78,16240
3/17/2022,12,8841,1680,3860,737,397,78,15593
3/17/2022,13,8848,1963,3589,655,399,78,15532
3/17/2022,14,8848,1847,3704,720,388,78,15585
3/17/2022,15,8847,1461,3733,859,367,78,15345
3/17/2022,16,8862,1460,3717,869,283,78,15269
3/17/2022,17,8868,1594,4464,870,174,78,16048
3/17/2022,18,8865,1602,4407,938,54,78,15944
3/17/2022,19,8861,1555,4726,993,3,77,16215
3/17/2022,20,8861,1592,4541,1201,0,77,16272
3/17/2022,21,8868,1367,4124,1289,0,55,15703
3/17/2022,22,8867,871,4172,1274,0,30,15214
3/17/2022,23,8868,443,4144,1269,0,19,14743
3/17/2022,24,8866,373,3857,1225,0,14,14335
3/18/2022,1,8866,398,4025,962,0,13,14264
3/18/2022,2,8866,408,3704,1067,0,14,14059
3/18/2022,3,8866,391,3576,1385,0,13,14231
3/18/2022,4,8871,477,3375,1429,0,13,14165
3/18/2022,5,8869,787,3381,1184,0,25,14246
3/18/2022,6,8866,1220,3784,962,1,45,14878
3/18/2022,7,8866,1555,4483,821,6,76,15807
3/18/2022,8,8870,1850,4681,705,35,77,16218
3/18/2022,9,8872,2227,4769,535,125,77,16605
3/18/2022,10,8875,1959,4659,462,201,77,16233
3/18/2022,11,8876,1803,4473,489,229,77,15947
3/18/2022,12,8872,1754,4267,461,262,77,15693
3/18/2022,13,8874,1638,3972,582,268,77,15411
3/18/2022,14,8869,1615,3708,598,220,77,15087
3/18/2022,15,8871,1117,4067,810,171,77,15113
3/18/2022,16,8875,821,4295,1175,127,77,15370
3/18/2022,17,8873,794,4356,1603,73,76,15775
3/18/2022,18,8877,789,4185,1863,26,77,15817
3/18/2022,19,8878,792,4028,2473,2,77,16250
3/18/2022,20,8876,464,3958,2715,0,77,16090
3/18/2022,21,8880,367,3719,3075,0,77,16118
3/18/2022,22,8871,366,3782,2935,0,64,16018
3/18/2022,23,8875,387,3586,2871,0,37,15756
3/18/2022,24,8873,366,3365,2573,0,1,15178
3/19/2022,1,8868,367,3339,2525,0,0,15099
3/19/2022,2,8862,366,3551,2572,0,0,15351
3/19/2022,3,8861,367,3443,2369,0,0,15040
3/19/2022,4,8854,367,3435,2721,0,6,15383
3/19/2022,5,8854,366,3550,2533,0,9,15312
3/19/2022,6,8857,381,3953,1998,0,39,15228
3/19/2022,7,8857,416,4610,1717,1,56,15657
3/19/2022,8,8851,496,4610,1665,13,82,15717
3/19/2022,9,8855,447,4427,1939,40,78,15786
3/19/2022,10,8850,409,4324,2122,72,64,15841
3/19/2022,11,8854,482,4593,1988,84,64,16065
3/19/2022,12,8856,527,4447,2076,108,58,16072
3/19/2022,13,8861,529,4240,2254,108,63,16055
3/19/2022,14,8860,399,3912,2436,77,48,15732
3/19/2022,15,8857,400,3936,2464,57,24,15738
3/19/2022,16,8857,433,3981,2559,64,4,15898
3/19/2022,17,8855,403,3859,2728,42,0,15887
3/19/2022,18,8857,369,3587,2990,10,0,15813
3/19/2022,19,8857,369,3630,2898,1,0,15755
3/19/2022,20,8852,368,3953,2619,0,0,15792
3/19/2022,21,8852,382,3850,2645,0,0,15729
3/19/2022,22,8846,368,3312,2627,0,0,15153
3/19/2022,23,8846,366,3241,2569,0,0,15022
3/19/2022,24,8840,367,3187,2700,0,0,15094
3/20/2022,1,8837,368,3209,2785,0,0,15199
3/20/2022,2,8839,369,3256,2617,0,0,15081
3/20/2022,3,8835,369,3480,2598,0,0,15282
3/20/2022,4,8839,368,3459,2698,0,0,15364
3/20/2022,5,8838,367,3298,2728,0,0,15231
3/20/2022,6,8834,369,3643,2718,2,0,15566
3/20/2022,7,8835,383,4059,2605,2,0,15884
3/20/2022,8,8835,380,4768,2365,15,0,16363
3/20/2022,9,8833,478,4594,2199,43,0,16147
3/20/2022,10,8840,432,4212,2003,88,2,15577
3/20/2022,11,8836,402,4188,1696,161,9,15292
3/20/2022,12,8834,406,3608,1663,279,13,14803
3/20/2022,13,8837,539,3562,1674,305,14,14931
3/20/2022,14,8834,615,3347,1529,313,8,14646
3/20/2022,15,8831,813,3397,1522,325,0,14888
3/20/2022,16,8823,1018,3521,1695,319,0,15376
3/20/2022,17,8831,1531,3779,1404,206,0,15751
3/20/2022,18,8832,1384,4243,1026,80,0,15565
3/20/2022,19,8834,1638,4549,927,6,0,15954
3/20/2022,20,8829,1922,4359,995,0,0,16105
3/20/2022,21,8836,1645,4243,812,0,0,15536
3/20/2022,22,8833,1371,4095,632,0,0,14931
3/20/2022,23,8831,616,4081,798,0,0,14326
3/20/2022,24,8832,314,3874,995,0,0,14015
3/21/2022,1,8836,159,3550,1124,0,6,13675
3/21/2022,2,8835,235,3995,969,0,9,14043
3/21/2022,3,8829,647,4047,834,0,9,14366
3/21/2022,4,8832,1323,3821,794,0,9,14779
3/21/2022,5,8829,1704,3567,566,0,14,14680
3/21/2022,6,8833,1891,3997,666,2,31,15420
3/21/2022,7,8831,2343,4454,663,13,46,16350
3/21/2022,8,8831,2417,4485,463,95,69,16360
3/21/2022,9,8828,2016,4136,321,243,54,15598
3/21/2022,10,8826,1985,4021,212,379,53,15476
3/21/2022,11,8826,1975,3880,259,420,76,15436
3/21/2022,12,8827,2045,3667,365,426,76,15406
3/21/2022,13,8826,1685,3579,474,411,77,15052
3/21/2022,14,8830,1818,3293,556,393,77,14967
3/21/2022,15,8827,1856,3390,268,331,77,14749
3/21/2022,16,8824,1938,3557,363,228,77,14987
3/21/2022,17,8823,1692,4139,644,145,77,15520
3/21/2022,18,8816,1659,4999,709,45,77,16305
3/21/2022,19,8818,1767,5253,908,2,77,16825
3/21/2022,20,8818,1629,5159,1207,0,77,16890
3/21/2022,21,8812,1572,4408,1461,0,56,16309
3/21/2022,22,8807,1172,4337,1445,0,54,15815
3/21/2022,23,8807,798,4547,1378,0,19,15549
3/21/2022,24,8801,772,4527,1390,0,11,15501
3/22/2022,1,8801,770,3930,1475,0,11,14987
3/22/2022,2,8797,790,3657,1521,0,11,14776
3/22/2022,3,8799,940,3691,1659,0,11,15100
3/22/2022,4,8825,999,3543,1825,0,11,15203
3/22/2022,5,8615,1389,3295,2014,0,14,15327
3/22/2022,6,8322,1508,3710,2385,1,25,15951
3/22/2022,7,8317,1933,4827,2366,13,27,17483
3/22/2022,8,8320,1721,4830,2151,92,27,17141
3/22/2022,9,8318,1533,4620,2239,221,27,16958
3/22/2022,10,8312,1498,4359,2319,321,27,16836
3/22/2022,11,8328,1496,4345,2477,329,42,17017
3/22/2022,12,8329,1184,4604,2319,320,74,16830
3/22/2022,13,8328,1606,4714,2073,319,77,17117
3/22/2022,14,8331,1441,4490,2083,283,77,16705
3/22/2022,15,8338,1260,4440,2077,260,77,16452
3/22/2022,16,8339,1239,4292,2175,208,77,16330
3/22/2022,17,8345,1127,4569,2398,99,77,16615
3/22/2022,18,8333,1119,5036,2674,31,77,17270
3/22/2022,19,8328,1274,5383,2871,2,76,17934
3/22/2022,20,8335,1618,4827,3231,0,75,18086
3/22/2022,21,8337,1439,4320,3688,0,74,17858
3/22/2022,22,8330,500,3869,3791,0,73,16563
3/22/2022,23,8329,155,3415,3688,0,33,15620
3/22/2022,24,8331,129,3302,3717,0,11,15490
3/23/2022,1,8340,130,3249,3764,0,11,15494
3/23/2022,2,8348,138,3271,3897,0,11,15665
3/23/2022,3,8347,150,3259,4007,0,11,15774
3/23/2022,4,8343,250,3396,4097,0,11,16097
3/23/2022,5,8356,383,3368,3889,0,12,16008
3/23/2022,6,8358,549,3916,3964,0,20,16807
3/23/2022,7,8351,622,4709,4062,6,26,17776
3/23/2022,8,8351,921,5171,3897,21,26,18387
3/23/2022,9,8350,873,5188,3852,50,26,18339
3/23/2022,10,8349,594,4861,3813,86,36,17739
3/23/2022,11,8349,721,4900,3801,136,39,17946
3/23/2022,12,8349,581,4124,3641,172,37,16904
3/23/2022,13,8348,219,4087,3729,125,47,16555
3/23/2022,14,8363,207,3960,4036,108,59,16733
3/23/2022,15,8369,408,3908,4099,81,83,16948
3/23/2022,16,8369,618,4482,4200,46,85,17800
3/23/2022,17,8371,880,4875,4273,26,77,18502
3/23/2022,18,8375,838,5014,4099,9,76,18411
3/23/2022,19,8374,942,5169,3768,1,77,18331
3/23/2022,20,8375,829,4926,3522,0,77,17729
3/23/2022,21,8377,780,4963,3256,0,72,17448
3/23/2022,22,8376,963,4689,2589,0,37,16654
3/23/2022,23,8377,900,4188,2157,0,16,15638
3/23/2022,24,8376,579,3867,2142,0,12,14976
3/24/2022,1,8372,237,3720,2551,0,12,14892
3/24/2022,2,8373,131,3403,3035,0,11,14953
3/24/2022,3,8373,147,3400,3081,0,12,15013
3/24/2022,4,8372,267,3519,3343,0,12,15513
3/24/2022,5,8376,469,3549,3546,0,16,15956
3/24/2022,6,8381,727,3755,3318,1,23,16205
3/24/2022,7,8381,730,4244,3835,3,27,17220
3/24/2022,8,8380,743,4402,3986,15,26,17552
3/24/2022,9,8377,788,4531,3942,56,27,17721
3/24/2022,10,8380,831,4462,3961,134,26,17794
3/24/2022,11,8376,750,4708,3991,237,26,18088
3/24/2022,12,8377,761,4470,3864,229,26,17727
3/24/2022,13,8382,467,4314,3630,209,26,17028
3/24/2022,14,8381,649,4505,3295,177,26,17033
3/24/2022,15,8380,845,4324,3070,193,31,16843
3/24/2022,16,8378,1100,4328,2878,159,38,16881
3/24/2022,17,8381,1111,4459,2722,94,66,16833
3/24/2022,18,8380,1114,4418,2561,29,76,16578
3/24/2022,19,8383,1115,4873,2193,2,76,16642
3/24/2022,20,8379,1199,5182,1880,0,76,16716
3/24/2022,21,8377,1152,4716,1896,0,70,16211
3/24/2022,22,8381,539,4567,1794,0,37,15318
3/24/2022,23,8380,309,4333,1879,0,17,14918
3/24/2022,24,8381,128,4030,1892,0,12,14443
3/25/2022,1,8384,158,3945,2068,0,12,14567
3/25/2022,2,8389,329,3486,2433,0,12,14649
3/25/2022,3,8391,499,3390,2425,0,12,14717
3/25/2022,4,8388,785,3724,2535,0,23,15455
3/25/2022,5,8393,1440,3505,2014,0,33,15385
3/25/2022,6,8394,1512,3748,2141,1,72,15868
3/25/2022,7,8392,1682,4516,2066,10,77,16743
3/25/2022,8,8393,2231,4851,1689,59,77,17300
3/25/2022,9,8392,1854,4915,1603,92,77,16933
3/25/2022,10,8396,1826,4862,1521,109,77,16791
3/25/2022,11,8397,1794,4831,1490,159,77,16748
3/25/2022,12,8394,1920,4759,1402,131,77,16683
3/25/2022,13,8390,2004,4751,1465,100,63,16773
3/25/2022,14,8387,1533,4668,1780,87,27,16482
3/25/2022,15,8385,987,4739,2036,75,27,16249
3/25/2022,16,8387,960,4768,1972,75,27,16189
3/25/2022,17,8390,1274,4937,1960,47,32,16640
3/25/2022,18,8389,1235,5212,1761,17,39,16653
3/25/2022,19,8391,1333,5358,1513,2,67,16664
3/25/2022,20,8389,1339,5254,1490,0,77,16549
3/25/2022,21,8388,1133,4626,1754,0,76,15977
3/25/2022,22,8384,1121,4251,1957,0,77,15790
3/25/2022,23,8380,656,4332,2189,0,67,15624
3/25/2022,24,8373,372,4143,2331,0,14,15233
3/26/2022,1,8368,535,3666,2460,0,0,15029
3/26/2022,2,8369,528,3517,2375,0,0,14789
3/26/2022,3,8375,529,3640,2078,0,0,14622
3/26/2022,4,8381,536,3660,2044,0,0,14621
3/26/2022,5,8377,648,3732,2051,0,16,14824
3/26/2022,6,8382,983,4067,2088,1,22,15543
3/26/2022,7,8382,1200,4362,2172,5,47,16168
3/26/2022,8,8380,1394,4898,2254,29,62,17017
3/26/2022,9,8383,1036,4678,2498,91,51,16737
3/26/2022,10,8377,1299,4884,2634,108,49,17351
3/26/2022,11,8386,1059,4624,2758,145,47,17019
3/26/2022,12,8384,626,4281,3115,168,46,16620
3/26/2022,13,8384,258,3900,3411,125,46,16124
3/26/2022,14,8381,213,3965,3581,118,42,16300
3/26/2022,15,8382,417,3914,3795,96,10,16614
3/26/2022,16,8381,569,4140,4014,88,0,17192
3/26/2022,17,8381,571,4157,3967,50,0,17126
3/26/2022,18,8378,570,4328,4078,18,0,17372
3/26/2022,19,8377,563,4128,4088,1,0,17157
3/26/2022,20,8378,564,4032,3998,1,0,16973
3/26/2022,21,8372,564,4188,3993,0,0,17117
3/26/2022,22,8373,233,4244,4045,0,0,16895
3/26/2022,23,8377,153,3919,4047,0,0,16496
3/26/2022,24,8372,153,3763,3914,0,0,16202
3/27/2022,1,8373,153,3557,3901,0,0,15984
3/27/2022,2,8370,152,3515,3790,0,0,15827
3/27/2022,3,8375,152,3499,3917,0,0,15943
3/27/2022,4,8371,153,3360,3795,0,0,15679
3/27/2022,5,8372,153,3444,3791,0,2,15762
3/27/2022,6,8375,153,3564,3787,0,14,15893
3/27/2022,7,8374,153,3937,3803,2,44,16313
3/27/2022,8,8376,153,4018,4116,18,46,16727
3/27/2022,9,8374,154,4561,4088,53,50,17280
3/27/2022,10,8372,209,4769,3992,92,50,17484
3/27/2022,11,8376,189,4557,3968,160,45,17295
3/27/2022,12,8373,165,4621,4004,216,9,17388
3/27/2022,13,8380,171,4412,4000,225,0,17188
3/27/2022,14,8376,198,4331,4054,227,0,17186
3/27/2022,15,8376,311,4391,3995,193,0,17266
3/27/2022,16,8380,516,4620,4090,179,4,17789
3/27/2022,17,8383,1015,4702,4105,129,7,18341
3/27/2022,18,8380,1041,4977,4013,53,36,18500
3/27/2022,19,8380,1072,5249,3930,6,50,18687
3/27/2022,20,8376,1010,5173,3679,1,50,18289
3/27/2022,21,8372,1528,4963,3512,0,36,18411
3/27/2022,22,8379,1370,4507,3568,0,32,17856
3/27/2022,23,8377,1112,4260,3535,0,3,17287
3/27/2022,24,8378,1066,3868,3397,0,0,16709
3/28/2022,1,8374,1105,3962,3002,0,4,16447
3/28/2022,2,8375,1379,4205,2646,0,12,16617
3/28/2022,3,8378,1696,4182,2433,0,12,16701
3/28/2022,4,8381,1896,4117,2506,0,17,16917
3/28/2022,5,8377,2150,3952,2711,0,29,17219
3/28/2022,6,8373,2656,4663,2843,2,67,18604
3/28/2022,7,8370,3384,4838,3038,8,73,19711
3/28/2022,8,8371,3148,4817,3336,62,73,19807
3/28/2022,9,8375,2422,4855,3502,116,73,19343
3/28/2022,10,8367,2333,4773,3649,170,73,19365
3/28/2022,11,8370,1961,4730,3833,226,73,19193
3/28/2022,12,8370,1877,4547,3731,277,73,18875
3/28/2022,13,8372,1798,4219,3654,308,70,18421
3/28/2022,14,8373,1773,4152,3583,290,34,18205
3/28/2022,15,8374,1884,4340,3371,286,27,18282
3/28/2022,16,8373,2172,4528,3236,226,27,18562
3/28/2022,17,8374,3185,4894,2940,156,29,19578
3/28/2022,18,8370,3301,5378,2529,71,43,19692
3/28/2022,19,8372,3498,5527,2078,7,74,19556
3/28/2022,20,8373,3561,5557,1637,0,74,19202
3/28/2022,21,8379,3582,5534,1225,0,73,18793
3/28/2022,22,8386,3159,4871,1028,0,72,17516
3/28/2022,23,8390,2466,4480,904,0,64,16304
3/28/2022,24,8389,2271,4314,872,0,15,15861
3/29/2022,1,8370,2564,4117,928,0,10,15989
3/29/2022,2,8376,2594,4028,1047,0,9,16054
3/29/2022,3,8379,2572,4067,1177,0,10,16205
3/29/2022,4,8384,2352,4102,1261,0,10,16109
3/29/2022,5,8387,2468,4313,1171,0,13,16352
3/29/2022,6,8385,3696,4832,1080,2,24,18019
3/29/2022,7,8386,3873,5183,939,21,29,18431
3/29/2022,8,8559,3686,5146,582,128,29,18130
3/29/2022,9,8621,3132,4975,433,273,28,17462
3/29/2022,10,8614,2636,4777,355,364,27,16773
3/29/2022,11,8763,2186,4624,251,413,27,16264
3/29/2022,12,8830,1772,4598,216,424,27,15867
3/29/2022,13,8836,1805,4642,221,426,27,15957
3/29/2022,14,8828,1751,4415,275,430,27,15726
3/29/2022,15,8881,1607,4359,372,426,27,15672
3/29/2022,16,8913,1682,4161,451,379,27,15613
3/29/2022,17,8918,1769,4718,481,246,27,16159
3/29/2022,18,8920,1860,5148,487,87,27,16529
3/29/2022,19,8919,2291,5418,492,5,27,17152
3/29/2022,20,8920,2455,5536,604,0,27,17542
3/29/2022,21,8922,2203,5104,875,0,27,17131
3/29/2022,22,8906,1611,4387,1134,0,27,16065
3/29/2022,23,8916,1094,3950,1214,0,19,15193
3/29/2022,24,8920,747,3800,1393,0,10,14870
3/30/2022,1,8915,717,3687,1515,0,10,14844
3/30/2022,2,8913,706,3318,1817,0,10,14764
3/30/2022,3,8916,578,3293,1908,0,11,14706
3/30/2022,4,8913,622,3323,2492,0,12,15362
3/30/2022,5,8914,880,3220,2596,0,28,15638
3/30/2022,6,8913,963,4015,3199,1,40,17131
3/30/2022,7,8916,1074,4706,3285,9,43,18033
3/30/2022,8,8917,1141,5270,3248,42,27,18645
3/30/2022,9,8877,1020,4880,3240,85,27,18129
3/30/2022,10,8876,1161,4882,3348,124,27,18418
3/30/2022,11,8866,1015,4645,3455,156,27,18164
3/30/2022,12,8855,1038,4611,3507,193,32,18236
3/30/2022,13,8853,1012,4306,3472,144,42,17829
3/30/2022,14,8851,1273,4653,3012,103,43,17935
3/30/2022,15,8857,1578,4999,2636,107,44,18221
3/30/2022,16,8854,1638,4861,2633,75,41,18102
3/30/2022,17,8856,1564,4787,2709,52,39,18007
3/30/2022,18,8859,1222,4766,2861,16,34,17758
3/30/2022,19,8862,1123,4543,3075,3,33,17639
3/30/2022,20,8862,1095,4533,3087,0,31,17608
3/30/2022,21,8862,934,4347,3149,0,32,17324
3/30/2022,22,8859,730,4432,2729,0,28,16778
3/30/2022,23,8859,1064,4552,1925,0,21,16421
3/30/2022,24,8863,885,3714,2302,0,14,15778
3/31/2022,1,8861,316,3496,2665,0,12,15350
3/31/2022,2,8863,126,3205,3286,0,12,15492
3/31/2022,3,8861,126,3122,3630,0,12,15751
3/31/2022,4,8862,127,3103,3687,0,12,15791
3/31/2022,5,8863,128,3124,3883,0,15,16013
3/31/2022,6,8861,135,3493,4020,1,20,16530
3/31/2022,7,8862,155,4155,4045,3,27,17247
3/31/2022,8,8864,148,4530,3908,27,20,17497
3/31/2022,9,8870,128,4200,3812,61,26,17097
3/31/2022,10,8869,128,3986,3444,103,27,16557
3/31/2022,11,8868,127,3971,3723,148,27,16864
3/31/2022,12,8869,127,3608,3969,66,27,16666
3/31/2022,13,8869,141,3649,3970,126,27,16782
3/31/2022,14,8864,179,3507,3995,178,27,16750
3/31/2022,15,8860,238,3626,4018,170,27,16939
3/31/2022,16,8855,537,3823,4040,155,27,17437
3/31/2022,17,8858,508,4243,3839,126,27,17601
3/31/2022,18,8858,501,4320,3780,44,27,17530
3/31/2022,19,8859,501,4423,3638,3,27,17451
3/31/2022,20,8858,502,4657,3253,0,27,17297
3/31/2022,21,8853,516,4947,2669,0,27,17012
3/31/2022,22,8853,229,4413,2453,0,27,15975
3/31/2022,23,8855,127,4094,2248,0,16,15340
3/31/2022,24,8859,127,3984,2005,0,4,14979
4/1/2022,1,8861,128,3800,1802,0,0,14591
4/1/2022,2,8861,167,3629,1767,0,0,14424
4/1/2022,3,8860,174,3626,1730,0,0,14390
4/1/2022,4,8855,410,3624,1868,0,0,14757
4/1/2022,5,8857,852,3215,1881,0,1,14806
4/1/2022,6,8858,916,3602,1878,2,6,15262
4/1/2022,7,8857,1074,4361,1986,12,26,16316
4/1/2022,8,8859,1350,4760,1992,43,26,17030
4/1/2022,9,8859,1103,4703,2381,71,32,17149
4/1/2022,10,8861,742,4441,2619,106,34,16803
4/1/2022,11,8865,736,4165,2647,155,34,16602
4/1/2022,12,8864,428,4054,2920,211,33,16510
4/1/2022,13,8858,402,3895,3061,187,31,16434
4/1/2022,14,8853,418,4035,3336,200,22,16864
4/1/2022,15,8965,436,4094,3451,169,18,17133
4/1/2022,16,9064,495,4214,3426,127,13,17339
4/1/2022,17,9080,720,4468,3130,68,0,17466
4/1/2022,18,9082,715,4922,2746,25,0,17490
4/1/2022,19,9086,636,5250,2166,4,0,17142
4/1/2022,20,9100,703,5421,1738,0,0,16962
4/1/2022,21,9100,531,5178,1425,0,0,16234
4/1/2022,22,9111,540,4778,1224,0,0,15653
4/1/2022,23,9127,534,4265,1012,0,0,14938
4/1/2022,24,9132,332,4043,803,0,0,14310
4/2/2022,1,9134,234,4025,661,0,0,14054
4/2/2022,2,9128,250,3879,590,0,0,13847
4/2/2022,3,9131,203,3770,458,0,0,13562
4/2/2022,4,9137,368,4071,331,0,0,13907
4/2/2022,5,9145,809,3831,242,1,0,14028
4/2/2022,6,9150,849,4290,246,2,0,14537
4/2/2022,7,9172,851,4446,220,28,0,14717
4/2/2022,8,9172,733,4576,189,137,2,14809
4/2/2022,9,9173,562,4748,208,280,6,14977
4/2/2022,10,9169,561,4832,266,370,28,15226
4/2/2022,11,9170,622,4608,362,406,50,15218
4/2/2022,12,9167,590,4311,455,413,50,14986
4/2/2022,13,9173,573,4200,461,399,50,14856
4/2/2022,14,9180,608,4190,358,372,62,14770
4/2/2022,15,9180,883,4300,249,325,65,15002
4/2/2022,16,9189,874,4233,216,225,50,14787
4/2/2022,17,9186,1107,4646,122,133,50,15244
4/2/2022,18,9191,1360,4766,135,47,50,15549
4/2/2022,19,9192,1165,4845,152,9,50,15413
4/2/2022,20,9192,1369,4961,204,0,50,15776
4/2/2022,21,9194,1148,4671,309,0,50,15372
4/2/2022,22,9193,919,4225,273,0,50,14660
4/2/2022,23,9191,681,4070,149,0,45,14136
4/2/2022,24,9194,636,3876,156,0,20,13882
4/3/2022,1,9193,335,3570,196,0,0,13294
4/3/2022,2,9191,158,3471,251,0,0,13071
4/3/2022,3,9186,148,3657,264,0,0,13255
4/3/2022,4,9187,293,3707,384,0,0,13571
4/3/2022,5,9183,520,3607,497,0,0,13807
4/3/2022,6,9182,532,3478,742,1,0,13935
4/3/2022,7,9185,543,3815,1006,11,0,14560
4/3/2022,8,9183,568,4263,1049,37,0,15100
4/3/2022,9,9181,920,4503,944,84,0,15632
4/3/2022,10,9179,1078,4416,925,109,0,15707
4/3/2022,11,9179,983,4338,1016,146,0,15662
4/3/2022,12,9185,1039,4067,1058,193,5,15547
4/3/2022,13,8910,1075,3995,1124,137,17,15258
4/3/2022,14,8662,1383,4108,1175,134,48,15510
4/3/2022,15,8663,1413,4055,1165,136,50,15482
4/3/2022,16,8666,1751,4401,1062,87,50,16017
4/3/2022,17,8663,1955,4775,943,69,65,16470
4/3/2022,18,8664,1941,4969,774,39,77,16464
4/3/2022,19,8661,2031,5177,540,7,88,16504
4/3/2022,20,8660,2024,5198,354,0,98,16334
4/3/2022,21,8665,1847,5082,327,0,53,15974
4/3/2022,22,8660,1715,4698,338,0,5,15416
4/3/2022,23,8666,1698,4129,276,0,0,14769
4/3/2022,24,8664,1523,3712,254,0,0,14153
4/4/2022,1,8662,1487,3608,235,0,0,13992
4/4/2022,2,8660,1501,3550,227,0,0,13938
4/4/2022,3,8662,1400,3611,268,0,0,13941
4/4/2022,4,8661,1455,3614,311,0,0,14041
4/4/2022,5,8665,1497,3759,278,0,4,14203
4/4/2022,6,8659,2169,4859,329,3,31,16050
4/4/2022,7,8660,2246,5017,467,30,60,16480
4/4/2022,8,8657,2004,4946,470,113,64,16254
4/4/2022,9,8655,1930,5053,298,221,55,16212
4/4/2022,10,8655,2287,5026,285,314,50,16617
4/4/2022,11,8662,2325,4669,438,265,34,16393
4/4/2022,12,8669,1879,4716,617,271,0,16152
4/4/2022,13,8671,1991,4378,902,207,0,16149
4/4/2022,14,8672,1620,4327,1236,218,0,16073
4/4/2022,15,8676,1494,3997,1638,190,0,15995
4/4/2022,16,8673,1581,4216,1519,133,6,16128
4/4/2022,17,8675,1814,4781,1228,107,38,16643
4/4/2022,18,8674,2219,4916,955,49,49,16862
4/4/2022,19,8673,2380,5141,922,6,49,17171
4/4/2022,20,8673,2290,5093,999,1,47,17103
4/4/2022,21,8669,1940,4798,1082,0,43,16532
4/4/2022,22,8668,1426,4398,1218,0,10,15720
4/4/2022,23,8669,1160,3739,1265,0,0,14833
4/4/2022,24,8667,1079,3358,1352,0,0,14456
4/5/2022,1,8664,1071,3415,1392,0,0,14542
4/5/2022,2,8662,1157,3298,1406,0,0,14523
4/5/2022,3,8671,1126,3320,1206,0,0,14323
4/5/2022,4,8670,1221,3537,1090,0,1,14519
4/5/2022,5,8676,1269,3576,1132,0,25,14678
4/5/2022,6,8674,1943,4025,1029,1,46,15718
4/5/2022,7,8596,2299,4563,896,9,46,16409
4/5/2022,8,8589,2333,4786,586,47,46,16387
4/5/2022,9,8583,2266,4990,370,168,46,16423
4/5/2022,10,8591,2131,4918,203,276,37,16156
4/5/2022,11,8557,2014,4658,214,314,12,15769
4/5/2022,12,8487,2131,4366,248,321,0,15553
4/5/2022,13,8490,1650,4258,280,381,0,15059
4/5/2022,14,8490,1635,4296,302,372,0,15095
4/5/2022,15,8490,1405,4209,357,294,0,14755
4/5/2022,16,8497,1464,4706,339,217,0,15223
4/5/2022,17,8497,1568,4854,339,165,0,15423
4/5/2022,18,8499,1418,4933,437,75,0,15362
4/5/2022,19,8499,1450,5025,690,11,0,15675
4/5/2022,20,8491,1479,4814,1219,1,0,16004
4/5/2022,21,8494,1420,4526,1821,0,0,16261
4/5/2022,22,8488,646,4064,2277,0,0,15475
4/5/2022,23,8492,280,3327,2583,0,0,14682
4/5/2022,24,8486,128,3323,2706,0,0,14643
4/6/2022,1,8485,131,3040,2993,0,3,14652
4/6/2022,2,8488,168,3105,2626,0,13,14400
4/6/2022,3,8491,207,3050,2581,0,46,14375
4/6/2022,4,8488,322,3209,2554,0,48,14621
4/6/2022,5,8487,631,3337,2313,1,49,14818
4/6/2022,6,8490,739,3768,2309,2,50,15358
4/6/2022,7,8491,859,4070,2419,23,43,15905
4/6/2022,8,8490,968,4444,2357,117,1,16377
4/6/2022,9,8491,972,4513,2140,231,0,16347
4/6/2022,10,8489,1091,4616,2252,285,0,16733
4/6/2022,11,8487,417,4232,2730,304,0,16170
4/6/2022,12,8482,129,4059,2834,299,0,15803
4/6/2022,13,8482,132,3972,2835,321,0,15742
4/6/2022,14,8481,242,4453,2805,221,0,16202
4/6/2022,15,8482,383,4187,2963,170,0,16185
4/6/2022,16,8480,694,4697,2972,91,0,16934
4/6/2022,17,8478,884,4881,2733,70,0,17046
4/6/2022,18,8481,916,4889,2907,21,0,17214
4/6/2022,19,8486,826,4917,2760,2,0,16991
4/6/2022,20,8486,844,4982,2386,0,0,16698
4/6/2022,21,8490,1030,4949,1544,0,0,16013
4/6/2022,22,8487,1098,4679,1088,0,0,15352
4/6/2022,23,8476,810,3979,1113,0,0,14378
4/6/2022,24,8476,547,3785,1356,0,0,14164
4/7/2022,1,8478,215,3478,1742,0,0,13913
4/7/2022,2,8478,206,3368,2085,0,0,14137
4/7/2022,3,8477,541,3210,2083,0,0,14311
4/7/2022,4,8480,662,3198,2021,0,0,14361
4/7/2022,5,8474,893,3331,1763,0,0,14461
4/7/2022,6,8477,878,3646,2037,1,0,15039
4/7/2022,7,8475,902,4403,1965,9,0,15754
4/7/2022,8,8475,1062,4998,1801,61,0,16397
4/7/2022,9,8473,1045,4917,1703,116,0,16254
4/7/2022,10,8471,652,4779,2052,183,0,16137
4/7/2022,11,8470,248,4566,2298,202,0,15784
4/7/2022,12,8472,166,4324,2316,250,0,15528
4/7/2022,13,8475,202,4116,2502,201,0,15496
4/7/2022,14,8473,461,4019,2375,226,7,15561
4/7/2022,15,8461,939,4582,1997,161,20,16160
4/7/2022,16,8462,1319,4515,1746,85,42,16169
4/7/2022,17,8476,1563,5175,1411,52,50,16727
4/7/2022,18,8479,1547,5203,977,40,50,16296
4/7/2022,19,8479,1237,5500,682,5,50,15953
4/7/2022,20,8482,1462,5363,655,0,50,16012
4/7/2022,21,8483,1385,4961,735,0,50,15614
4/7/2022,22,8486,1258,4792,747,0,48,15331
4/7/2022,23,8458,1073,4285,735,0,9,14560
4/7/2022,24,8451,930,3844,704,0,0,13929
4/8/2022,1,8452,892,3561,804,0,0,13709
4/8/2022,2,8454,887,3522,949,0,0,13812
4/8/2022,3,8451,955,3414,1079,0,0,13899
4/8/2022,4,8450,1017,3545,1010,0,0,14022
4/8/2022,5,8435,1207,3518,809,0,0,13969
4/8/2022,6,8435,1466,3994,840,2,0,14737
4/8/2022,7,8433,1813,4707,900,7,0,15860
4/8/2022,8,8429,2003,5001,743,49,0,16225
4/8/2022,9,8428,2188,5015,773,153,0,16557
4/8/2022,10,8424,2107,4853,1083,223,0,16690
4/8/2022,11,8403,1804,4625,1428,218,2,16480
4/8/2022,12,8405,1358,4168,1638,207,22,15798
4/8/2022,13,8389,1135,3935,1827,287,46,15619
4/8/2022,14,8300,981,3561,1697,351,45,14935
4/8/2022,15,8295,795,3790,1747,318,45,14990
4/8/2022,16,8318,791,3942,1733,260,45,15089
4/8/2022,17,8514,784,4627,1540,186,45,15696
4/8/2022,18,8623,803,5182,1279,65,57,16009
4/8/2022,19,8659,784,5457,1036,11,64,16011
4/8/2022,20,8661,786,5634,881,0,70,16032
4/8/2022,21,8663,841,5461,882,0,69,15916
4/8/2022,22,8666,783,5084,698,0,48,15279
4/8/2022,23,8662,788,4475,677,0,21,14623
4/8/2022,24,8655,580,3963,692,0,0,13890
4/9/2022,1,8654,343,3852,717,0,0,13566
4/9/2022,2,8661,329,3806,661,0,0,13457
4/9/2022,3,8660,533,4041,606,0,0,13840
4/9/2022,4,8663,632,3893,537,0,0,13725
4/9/2022,5,8665,772,3661,421,1,0,13520
4/9/2022,6,8667,816,3861,510,2,0,13856
4/9/2022,7,8667,1037,4102,544,28,0,14378
4/9/2022,8,8665,1114,4691,553,93,0,15116
4/9/2022,9,8665,1121,4591,586,168,0,15131
4/9/2022,10,8665,1163,4765,738,202,0,15533
4/9/2022,11,8664,1158,4560,897,194,0,15473
4/9/2022,12,8667,1227,4409,1034,192,0,15529
4/9/2022,13,8666,1131,4351,1294,159,0,15601
4/9/2022,14,8669,1073,4556,1344,164,0,15806
4/9/2022,15,8665,838,4676,1334,138,0,15651
4/9/2022,16,8667,1165,4489,1361,104,0,15786
4/9/2022,17,8666,1221,4744,1295,64,0,15990
4/9/2022,18,8663,1238,4990,1122,27,0,16040
4/9/2022,19,8660,1282,5175,1032,4,0,16153
4/9/2022,20,8655,995,5091,1047,0,0,15788
4/9/2022,21,8659,1036,5054,825,0,0,15574
4/9/2022,22,8661,718,4692,846,0,0,14917
4/9/2022,23,8663,581,3951,1051,0,0,14246
4/9/2022,24,8658,206,3764,1190,0,0,13818
4/10/2022,1,8658,140,3470,1384,0,0,13652
4/10/2022,2,8653,137,3440,1611,0,0,13841
4/10/2022,3,8650,136,3430,1801,0,0,14017
4/10/2022,4,8653,135,3584,1723,0,0,14095
4/10/2022,5,8659,151,3419,1963,1,0,14193
4/10/2022,6,8660,192,3446,1757,2,0,14057
4/10/2022,7,8659,333,3552,1863,18,0,14425
4/10/2022,8,8656,337,3990,1935,83,0,15001
4/10/2022,9,8655,330,4261,1671,171,0,15088
4/10/2022,10,8654,344,4235,1665,253,0,15151
4/10/2022,11,8653,348,4144,1435,208,0,14788
4/10/2022,12,8658,402,4213,1196,217,0,14686
4/10/2022,13,8658,535,4333,929,238,0,14693
4/10/2022,14,8662,809,3993,838,274,0,14576
4/10/2022,15,8623,888,4017,672,279,0,14479
4/10/2022,16,8658,950,4167,728,237,0,14740
4/10/2022,17,8661,1089,4573,696,185,0,15204
4/10/2022,18,8662,925,4681,688,86,0,15042
4/10/2022,19,8665,895,4960,763,13,0,15296
4/10/2022,20,8665,886,4574,808,0,0,14933
4/10/2022,21,8668,786,4502,829,0,0,14785
4/10/2022,22,8667,686,4149,920,0,0,14422
4/10/2022,23,8666,365,3823,924,0,0,13778
4/10/2022,24,8663,155,3475,1388,0,0,13681
4/11/2022,1,8663,128,3374,1864,0,0,14029
4/11/2022,2,8664,128,3308,2126,0,0,14226
4/11/2022,3,8659,129,3268,2672,0,0,14728
4/11/2022,4,8660,194,3289,2690,0,0,14833
4/11/2022,5,8663,428,3290,2797,0,0,15178
4/11/2022,6,8669,710,3380,3098,2,0,15859
4/11/2022,7,8666,705,3810,3602,36,0,16819
4/11/2022,8,8666,692,4354,3281,119,0,17112
4/11/2022,9,8665,555,4716,3014,167,0,17117
4/11/2022,10,8664,551,4223,2279,222,0,15939
4/11/2022,11,8667,546,4046,2517,345,0,16121
4/11/2022,12,8665,276,3945,2494,370,0,15750
4/11/2022,13,8658,460,3695,2311,375,0,15499
4/11/2022,14,8654,556,3751,2683,232,0,15876
4/11/2022,15,8657,671,4016,2619,168,0,16131
4/11/2022,16,8659,944,4020,2808,102,1,16534
4/11/2022,17,8659,938,4350,2770,74,11,16802
4/11/2022,18,8655,930,4885,2497,23,45,17035
4/11/2022,19,8653,866,5288,2080,2,54,16943
4/11/2022,20,8654,738,5206,1739,0,54,16391
4/11/2022,21,8655,736,4593,1811,0,54,15849
4/11/2022,22,8663,243,4305,1744,0,50,15005
4/11/2022,23,8663,128,4322,1562,0,11,14686
4/11/2022,24,8659,128,4469,1311,0,0,14567
4/12/2022,1,8659,159,4410,1018,0,0,14246
4/12/2022,2,8660,182,4048,880,0,0,13770
4/12/2022,3,8662,320,4124,679,0,0,13785
4/12/2022,4,8661,638,4386,558,0,0,14243
4/12/2022,5,8662,1145,3887,468,1,8,14171
4/12/2022,6,8664,1139,4370,349,2,42,14566
4/12/2022,7,8662,1257,4993,183,30,48,15173
4/12/2022,8,8663,1294,5274,207,154,55,15647
4/12/2022,9,8659,1279,5240,212,295,55,15740
4/12/2022,10,8662,1140,4698,423,381,55,15359
4/12/2022,11,8662,464,4904,418,399,55,14902
4/12/2022,12,8660,358,4750,461,411,55,14695
4/12/2022,13,8660,388,4414,548,408,55,14473
4/12/2022,14,8653,550,4247,704,409,55,14618
4/12/2022,15,8655,548,4202,783,395,55,14638
4/12/2022,16,8657,626,4637,738,329,55,15042
4/12/2022,17,8656,821,4948,713,206,55,15399
4/12/2022,18,8652,942,5566,747,89,55,16051
4/12/2022,19,8652,937,5438,928,14,55,16024
4/12/2022,20,8656,932,5190,1375,0,55,16208
4/12/2022,21,8650,426,4641,1797,0,55,15569
4/12/2022,22,8649,312,4278,1995,0,53,15287
4/12/2022,23,8648,313,3807,2120,0,7,14895
4/12/2022,24,8654,311,3542,2207,0,0,14714
4/13/2022,1,8659,135,3346,1953,0,0,14093
4/13/2022,2,8662,126,3116,1949,0,0,13853
4/13/2022,3,8674,129,3208,1772,0,0,13783
4/13/2022,4,8692,129,3164,1944,0,0,13929
4/13/2022,5,8733,126,3107,2699,1,0,14666
4/13/2022,6,8741,127,3661,3028,2,0,15559
4/13/2022,7,8749,128,4476,3271,17,0,16641
4/13/2022,8,8748,127,4773,3392,44,0,17084
4/13/2022,9,8750,127,4743,3427,85,0,17132
4/13/2022,10,8787,127,4490,3535,130,16,17085
4/13/2022,11,8863,127,4424,3500,122,48,17084
4/13/2022,12,8911,127,4373,3560,174,55,17200
4/13/2022,13,8908,128,4421,3617,156,56,17286
4/13/2022,14,8917,128,4536,3511,123,56,17271
4/13/2022,15,8920,129,4412,3463,177,40,17141
4/13/2022,16,8921,128,4783,3533,120,0,17485
4/13/2022,17,8922,129,4909,3397,86,0,17443
4/13/2022,18,8915,129,4835,3530,32,0,17441
4/13/2022,19,8912,129,5070,3407,8,0,17526
4/13/2022,20,8917,129,5128,3335,0,0,17509
4/13/2022,21,8915,129,4737,3400,0,0,17181
4/13/2022,22,9002,130,4226,3206,0,0,16564
4/13/2022,23,9070,132,3589,2588,0,0,15379
4/13/2022,24,9097,149,3363,2004,0,0,14613
4/14/2022,1,9098,157,3223,1673,0,0,14151
4/14/2022,2,9090,157,3196,1225,0,1,13669
4/14/2022,3,9086,157,3158,1072,0,0,13473
4/14/2022,4,9084,158,3205,1248,0,1,13696
4/14/2022,5,8989,156,3210,1714,0,20,14089
4/14/2022,6,8992,157,3261,2653,2,50,15115
4/14/2022,7,8988,159,3807,3140,5,51,16150
4/14/2022,8,8984,158,4576,3395,30,51,17194
4/14/2022,9,8985,158,4608,3406,110,51,17318
4/14/2022,10,9028,159,4290,3091,176,50,16794
4/14/2022,11,9096,157,4248,2816,248,16,16581
4/14/2022,12,9129,157,4188,2467,263,0,16204
4/14/2022,13,9137,158,4132,2019,297,0,15743
4/14/2022,14,9138,159,4078,2058,285,0,15718
4/14/2022,15,9133,160,3997,2256,279,0,15825
4/14/2022,16,9131,158,3955,2768,263,0,16275
4/14/2022,17,9137,141,4235,2877,206,0,16596
4/14/2022,18,9143,127,4807,2658,87,11,16833
4/14/2022,19,9142,127,4764,3072,13,42,17160
4/14/2022,20,9141,127,4677,3784,0,48,17777
4/14/2022,21,9142,128,4629,3391,0,49,17339
4/14/2022,22,9144,127,4446,2817,0,49,16583
4/14/2022,23,9145,127,3833,2354,0,49,15508
4/14/2022,24,9141,127,3541,1744,0,49,14602
4/15/2022,1,9137,127,3504,1283,0,7,14058
4/15/2022,2,9139,126,3429,1067,0,1,13762
4/15/2022,3,9141,126,3334,1278,0,2,13881
4/15/2022,4,9140,127,3417,1119,0,0,13803
4/15/2022,5,9133,128,3353,1447,1,3,14065
4/15/2022,6,9133,129,3377,1849,3,18,14509
4/15/2022,7,9129,128,3504,1800,40,48,14649
4/15/2022,8,9129,127,3490,2194,135,51,15126
4/15/2022,9,9132,132,3584,2031,202,51,15132
4/15/2022,10,9127,124,3778,1916,239,49,15233
4/15/2022,11,9120,124,3822,2084,231,47,15428
4/15/2022,12,9121,123,3891,2132,218,47,15532
4/15/2022,13,9124,123,3920,2297,243,47,15754
4/15/2022,14,9115,123,3848,2421,237,7,15751
4/15/2022,15,9101,123,3959,2440,178,2,15803
4/15/2022,16,9102,123,4018,3103,98,1,16445
4/15/2022,17,9100,124,3944,3467,44,0,16679
4/15/2022,18,9094,124,4136,3316,25,7,16702
4/15/2022,19,9091,122,3968,3436,7,37,16661
4/15/2022,20,9091,123,3995,3452,1,56,16718
4/15/2022,21,9105,123,4156,3125,0,56,16565
4/15/2022,22,9114,123,4469,2307,0,56,16069
4/15/2022,23,9115,123,4066,1880,0,57,15241
4/15/2022,24,9120,123,3753,1541,0,56,14593
4/16/2022,1,9124,123,3746,1347,0,11,14351
4/16/2022,2,9124,123,3890,1011,0,0,14148
4/16/2022,3,9125,123,4315,571,0,0,14134
4/16/2022,4,9123,123,4336,605,0,0,14187
4/16/2022,5,9124,123,4563,587,0,0,14397
4/16/2022,6,9127,123,4903,595,2,0,14750
4/16/2022,7,9127,127,5639,508,22,0,15423
4/16/2022,8,9125,145,5760,494,99,1,15624
4/16/2022,9,9131,123,4877,627,230,0,14988
4/16/2022,10,9141,123,4978,944,331,0,15517
4/16/2022,11,9142,123,4883,1137,292,0,15577
4/16/2022,12,9141,123,4708,1370,268,0,15610
4/16/2022,13,9144,123,4639,1472,294,0,15672
4/16/2022,14,9148,123,4648,1532,312,2,15765
4/16/2022,15,9147,123,4658,1858,227,0,16013
4/16/2022,16,9143,123,4746,2159,170,0,16341
4/16/2022,17,9142,123,5504,1852,117,1,16739
4/16/2022,18,9141,123,5803,1577,46,0,16690
4/16/2022,19,9159,123,5374,1597,11,0,16264
4/16/2022,20,9152,124,5514,1652,0,0,16442
4/16/2022,21,9156,124,5651,1637,0,3,16571
4/16/2022,22,9154,124,5379,1720,0,9,16386
4/16/2022,23,9107,124,4679,1927,0,33,15870
4/16/2022,24,9095,123,3875,1878,0,56,15027
4/17/2022,1,9097,123,3832,1631,0,56,14739
4/17/2022,2,9094,123,3695,1685,0,56,14653
4/17/2022,3,9088,124,3776,1528,0,56,14572
4/17/2022,4,9100,123,3788,1626,0,48,14685
4/17/2022,5,9107,123,3934,1693,0,30,14887
4/17/2022,6,9109,123,4475,1551,2,0,15260
4/17/2022,7,9110,123,4666,1451,24,0,15374
4/17/2022,8,9107,123,5416,1227,102,0,15975
4/17/2022,9,9106,123,5461,1020,223,0,15933
4/17/2022,10,9112,124,5702,665,308,0,15911
4/17/2022,11,9114,182,5813,464,299,0,15872
4/17/2022,12,9115,143,5560,396,290,16,15520
4/17/2022,13,9117,150,4858,537,300,51,15013
4/17/2022,14,9110,161,4663,654,314,54,14956
4/17/2022,15,9108,188,4528,721,311,55,14911
4/17/2022,16,9118,314,4709,681,339,54,15215
4/17/2022,17,9110,314,4985,562,246,41,15258
4/17/2022,18,9110,314,5229,483,106,0,15242
4/17/2022,19,9111,314,5412,384,16,0,15237
4/17/2022,20,9108,314,5411,294,0,0,15127
4/17/2022,21,9116,314,5273,392,0,0,15095
4/17/2022,22,9110,162,5329,473,0,0,15074
4/17/2022,23,9110,124,5211,618,0,0,15063
4/17/2022,24,9101,124,5041,784,0,0,15050
4/18/2022,1,9106,124,4601,1073,0,0,14904
4/18/2022,2,9107,123,4310,1354,0,3,14897
4/18/2022,3,9098,123,4465,1732,0,9,15427
4/18/2022,4,9102,124,4294,1834,0,40,15394
4/18/2022,5,9095,124,4153,1757,2,54,15185
4/18/2022,6,9099,123,4222,2212,3,54,15713
4/18/2022,7,9098,124,4303,2322,52,52,15951
4/18/2022,8,9100,126,4348,2108,171,83,15936
4/18/2022,9,9102,129,4643,2179,276,78,16407
4/18/2022,10,9079,179,4461,2382,318,55,16474
4/18/2022,11,9087,200,4814,2561,292,58,17012
4/18/2022,12,9083,254,5228,2362,275,72,17274
4/18/2022,13,9081,504,5508,2005,251,99,17448
4/18/2022,14,9081,764,5092,1769,166,71,16943
4/18/2022,15,9088,844,4876,1246,110,0,16164
4/18/2022,16,9085,1011,5688,1110,67,0,16961
4/18/2022,17,9085,1479,5645,810,24,0,17043
4/18/2022,18,9092,1297,5447,840,11,0,16687
4/18/2022,19,9094,1137,4831,1063,3,0,16128
4/18/2022,20,9090,912,4850,1190,1,0,16043
4/18/2022,21,9087,923,4633,1414,0,0,16057
4/18/2022,22,9079,327,4927,1473,0,0,15806
4/18/2022,23,9040,124,4838,1467,0,0,15469
4/18/2022,24,8985,124,4791,1487,0,0,15387
4/19/2022,1,9095,124,4232,1566,0,12,15029
4/19/2022,2,9136,124,4228,1516,0,49,15053
4/19/2022,3,9139,124,4507,1555,0,53,15378
4/19/2022,4,9150,125,3987,1821,0,51,15134
4/19/2022,5,9148,125,3751,2081,0,53,15158
4/19/2022,6,9148,126,3947,2388,1,53,15663
4/19/2022,7,9141,125,5017,2516,5,54,16858
4/19/2022,8,9139,125,5195,2710,17,54,17240
4/19/2022,9,9138,125,5060,2909,65,54,17351
4/19/2022,10,9136,127,4978,3091,98,54,17484
4/19/2022,11,9121,130,5003,3326,108,54,17742
4/19/2022,12,9131,137,4951,3544,140,11,17914
4/19/2022,13,9131,144,4570,3684,147,0,17676
4/19/2022,14,9133,147,4391,3794,153,0,17618
4/19/2022,15,9136,150,4356,3841,140,0,17623
4/19/2022,16,9127,174,4672,3938,100,0,18011
4/19/2022,17,9112,298,4805,4014,68,1,18298
4/19/2022,18,9108,323,5064,3918,36,5,18454
4/19/2022,19,9104,321,5290,3737,8,0,18460
4/19/2022,20,9109,323,5257,3527,1,0,18217
4/19/2022,21,9102,323,5109,3454,0,0,17988
4/19/2022,22,9099,322,4876,3387,0,0,17684
4/19/2022,23,9099,243,4434,3151,0,0,16927
4/19/2022,24,9100,124,4381,2827,0,0,16432
4/20/2022,1,9100,126,4529,2220,0,0,15975
4/20/2022,2,9104,243,4717,1794,0,0,15858
4/20/2022,3,9099,301,4836,1509,0,0,15745
4/20/2022,4,9103,471,4464,1333,0,21,15392
4/20/2022,5,9106,649,4378,935,1,44,15113
4/20/2022,6,9110,930,4471,635,3,50,15199
4/20/2022,7,9111,927,4833,415,46,55,15387
4/20/2022,8,9106,921,4973,348,156,59,15563
4/20/2022,9,9102,942,4774,333,278,38,15467
4/20/2022,10,9096,930,5064,275,370,1,15736
4/20/2022,11,9102,608,4916,357,394,10,15387
4/20/2022,12,9107,185,4662,535,415,0,14904
4/20/2022,13,9096,121,4630,700,427,0,14974
4/20/2022,14,9101,128,4423,793,419,1,14865
4/20/2022,15,9098,260,4549,787,397,2,15093
4/20/2022,16,9095,483,4699,922,325,0,15524
4/20/2022,17,9096,741,4986,1158,215,0,16196
4/20/2022,18,9102,740,4735,1576,89,0,16242
4/20/2022,19,9101,741,4567,1936,17,0,16362
4/20/2022,20,9098,743,5000,2258,0,0,17099
4/20/2022,21,9084,753,4829,2716,0,0,17382
4/20/2022,22,9078,740,4230,3097,0,0,17145
4/20/2022,23,9073,265,3911,3183,0,0,16432
4/20/2022,24,9071,121,3713,3109,0,1,16015
4/21/2022,1,9074,122,3772,2650,0,0,15618
4/21/2022,2,9074,122,3430,2735,0,0,15361
4/21/2022,3,9073,122,3306,2757,0,8,15266
4/21/2022,4,9073,122,3328,2717,0,35,15275
4/21/2022,5,9071,123,3325,3136,1,55,15711
4/21/2022,6,9069,123,3670,3508,4,49,16423
4/21/2022,7,9065,122,4542,3933,21,49,17732
4/21/2022,8,9065,123,4792,3997,52,49,18078
4/21/2022,9,9064,123,4505,3975,73,49,17789
4/21/2022,10,9059,122,4725,3997,67,49,18019
4/21/2022,11,9066,122,4843,3949,65,49,18094
4/21/2022,12,9067,122,4610,3767,83,49,17698
4/21/2022,13,9055,122,4625,3657,101,49,17609
4/21/2022,14,9062,121,4469,3457,155,50,17314
4/21/2022,15,9055,123,4485,3224,225,14,17126
4/21/2022,16,9058,126,4795,3210,209,0,17398
4/21/2022,17,9058,125,4783,3303,161,0,17430
4/21/2022,18,9060,125,4524,3303,90,0,17102
4/21/2022,19,9054,125,4858,3051,15,13,17116
4/21/2022,20,9057,125,5253,2959,1,43,17438
4/21/2022,21,9050,124,5056,2719,1,51,17001
4/21/2022,22,9044,125,5023,2475,0,53,16720
4/21/2022,23,9040,125,4508,2332,0,52,16057
4/21/2022,24,9040,125,4195,2250,0,51,15661
4/22/2022,1,9043,125,4080,2060,0,51,15359
4/22/2022,2,9034,131,3969,2010,0,51,15195
4/22/2022,3,9039,204,4080,1783,0,52,15158
4/22/2022,4,9037,278,4446,1591,0,51,15403
4/22/2022,5,9039,412,4425,1420,2,51,15349
4/22/2022,6,9042,548,4570,1283,4,48,15495
4/22/2022,7,9041,548,5244,932,44,48,15857
4/22/2022,8,9043,567,5470,507,167,41,15795
4/22/2022,9,9033,542,5236,425,299,0,15535
4/22/2022,10,9029,551,5049,293,343,0,15265
4/22/2022,11,9040,551,5251,213,370,0,15425
4/22/2022,12,9026,226,5081,197,408,0,14938
4/22/2022,13,9014,178,4905,259,401,13,14770
4/22/2022,14,9020,377,4495,324,389,48,14653
4/22/2022,15,9015,545,4463,376,336,56,14791
4/22/2022,16,9017,542,5052,406,267,56,15340
4/22/2022,17,9017,545,5335,457,179,57,15590
4/22/2022,18,9017,539,5077,453,75,56,15217
4/22/2022,19,9015,537,5029,483,14,5,15083
4/22/2022,20,9015,537,5042,631,0,0,15225
4/22/2022,21,9008,534,4811,970,0,0,15323
4/22/2022,22,9007,205,4495,1267,0,0,14974
4/22/2022,23,9005,121,4156,1536,0,0,14818
4/22/2022,24,8999,122,3889,1771,0,0,14781
4/23/2022,1,9004,122,3860,1967,0,0,14953
4/23/2022,2,8993,122,3785,1965,0,0,14865
4/23/2022,3,9158,122,3459,2187,0,0,14926
4/23/2022,4,9255,122,3341,2268,0,0,14986
4/23/2022,5,9256,122,3378,2306,2,0,15064
4/23/2022,6,9260,122,3434,2661,3,0,15480
4/23/2022,7,9257,122,3638,2495,30,0,15542
4/23/2022,8,9251,121,3906,2747,90,0,16115
4/23/2022,9,9245,121,4157,2696,109,0,16328
4/23/2022,10,9233,121,4785,2547,124,0,16810
4/23/2022,11,9190,122,5141,2281,157,0,16891
4/23/2022,12,9329,122,5042,2380,200,0,17073
4/23/2022,13,9437,122,4650,2112,289,12,16622
4/23/2022,14,9453,125,3803,2207,305,46,15939
4/23/2022,15,9455,124,3808,2372,265,56,16080
4/23/2022,16,9450,122,4219,2531,202,56,16580
4/23/2022,17,9449,121,4572,2749,132,55,17078
4/23/2022,18,9452,121,4407,2901,57,45,16983
4/23/2022,19,9446,121,4625,2839,11,0,17042
4/23/2022,20,9439,121,4671,3076,0,0,17307
4/23/2022,21,9456,122,4583,3180,0,0,17341
4/23/2022,22,9470,121,4112,3144,19,0,16866
4/23/2022,23,9467,122,3639,2627,19,0,15874
4/23/2022,24,9481,123,3628,1997,0,0,15229
4/24/2022,1,9473,122,3503,1647,0,1,14746
4/24/2022,2,9478,123,3446,1675,0,0,14722
4/24/2022,3,9475,122,3442,1567,0,0,14606
4/24/2022,4,9476,122,3427,1512,0,0,14537
4/24/2022,5,9469,122,3434,979,1,0,14005
4/24/2022,6,9477,122,3405,1331,3,0,14338
4/24/2022,7,9461,122,3483,1522,37,0,14625
4/24/2022,8,9449,122,3402,1704,111,0,14788
4/24/2022,9,9446,121,3386,1720,205,0,14878
4/24/2022,10,9583,121,3428,1465,335,0,14932
4/24/2022,11,9640,122,3406,1318,394,0,14880
4/24/2022,12,9641,122,3412,1155,418,0,14748
4/24/2022,13,9640,125,3355,917,412,0,14449
4/24/2022,14,9639,123,3438,736,359,2,14297
4/24/2022,15,9632,125,3545,695,319,7,14323
4/24/2022,16,9620,124,3796,1100,285,17,14942
4/24/2022,17,9625,125,4134,1570,197,48,15699
4/24/2022,18,9626,125,4210,2132,75,55,16223
4/24/2022,19,9619,123,4302,2409,18,56,16527
4/24/2022,20,9616,123,4377,2498,0,55,16669
4/24/2022,21,9621,123,4549,2215,0,47,16555
4/24/2022,22,9674,123,4161,1914,0,40,15912
4/24/2022,23,9682,122,3815,1620,0,1,15240
4/24/2022,24,9690,123,3679,1161,0,0,14653
4/25/2022,1,9702,123,3409,735,0,0,13969
4/25/2022,2,9707,125,3455,612,0,0,13899
4/25/2022,3,9708,142,3361,697,0,0,13908
4/25/2022,4,9706,162,3455,776,0,0,14099
4/25/2022,5,9713,176,3414,1129,0,1,14433
4/25/2022,6,9713,183,3986,1325,3,1,15211
4/25/2022,7,9710,213,5163,1219,30,0,16335
4/25/2022,8,9712,337,5205,887,87,3,16231
4/25/2022,9,9707,337,4859,597,173,16,15689
4/25/2022,10,9711,492,5133,613,234,15,16198
4/25/2022,11,9711,616,5141,702,164,18,16352
4/25/2022,12,9708,646,5132,748,163,17,16414
4/25/2022,13,9708,721,5355,641,139,13,16577
4/25/2022,14,9706,825,5322,632,190,9,16684
4/25/2022,15,9631,794,5288,535,164,10,16422
4/25/2022,16,9598,941,5640,510,89,3,16781
4/25/2022,17,9654,1127,5402,609,54,9,16855
4/25/2022,18,9699,1086,5245,384,44,10,16468
4/25/2022,19,9698,837,5194,711,8,3,16451
4/25/2022,20,9701,805,4830,988,0,0,16324
4/25/2022,21,9693,470,4839,1322,0,0,16324
4/25/2022,22,9687,365,4572,1564,0,0,16188
4/25/2022,23,9688,364,3966,1887,0,0,15905
4/25/2022,24,9672,363,3597,1491,0,0,15123
4/26/2022,1,9675,364,3455,1041,0,0,14535
4/26/2022,2,9676,364,3429,967,0,0,14436
4/26/2022,3,9693,363,3398,1057,0,0,14511
4/26/2022,4,9701,364,3284,1272,0,0,14621
4/26/2022,5,9607,372,3644,1246,1,0,14870
4/26/2022,6,9596,382,4204,1111,2,0,15295
4/26/2022,7,9598,419,5117,956,28,0,16118
4/26/2022,8,9601,535,4957,953,86,0,16132
4/26/2022,9,9599,564,4808,954,172,0,16097
4/26/2022,10,9606,563,4994,1019,225,0,16407
4/26/2022,11,9630,562,5176,1055,231,0,16654
4/26/2022,12,9710,564,5151,1201,204,0,16830
4/26/2022,13,9712,607,5213,1409,207,0,17148
4/26/2022,14,9705,485,4958,1803,119,0,17070
4/26/2022,15,9700,373,4883,2070,102,0,17128
4/26/2022,16,9701,387,5350,2031,63,0,17532
4/26/2022,17,9692,403,5375,1941,45,0,17456
4/26/2022,18,9696,422,5233,1801,23,0,17175
4/26/2022,19,9700,465,4832,1812,4,0,16813
4/26/2022,20,9701,468,5078,1697,0,0,16944
4/26/2022,21,9698,442,5004,1600,0,0,16744
4/26/2022,22,9698,376,4571,1719,0,3,16367
4/26/2022,23,9699,375,4065,1881,0,9,16029
4/26/2022,24,9694,375,3913,1655,0,0,15637
4/27/2022,1,9702,374,3510,1396,0,0,14982
4/27/2022,2,9698,376,3518,1477,0,0,15069
4/27/2022,3,9699,396,3446,1488,0,0,15029
4/27/2022,4,9696,409,3471,1513,0,0,15089
4/27/2022,5,9693,472,3736,1800,1,0,15702
4/27/2022,6,9693,596,3888,1777,6,0,15960
4/27/2022,7,9688,696,4246,2115,38,0,16783
4/27/2022,8,9683,710,4927,2358,100,0,17778
4/27/2022,9,9681,710,4837,2238,154,0,17620
4/27/2022,10,9683,711,4808,2518,228,1,17949
4/27/2022,11,9697,712,4330,2860,274,0,17873
4/27/2022,12,9692,510,4691,2948,239,0,18080
4/27/2022,13,9693,420,4867,2808,224,0,18012
4/27/2022,14,9694,504,4709,2659,165,0,17731
4/27/2022,15,9687,639,4576,2619,172,0,17693
4/27/2022,16,9687,721,4720,2636,149,0,17913
4/27/2022,17,9690,804,5036,2595,102,0,18227
4/27/2022,18,9694,838,5284,2169,63,0,18048
4/27/2022,19,9693,864,5542,1633,17,0,17749
4/27/2022,20,9695,884,5653,1178,0,0,17410
4/27/2022,21,9702,906,5599,963,0,0,17170
4/27/2022,22,9702,867,5579,721,0,0,16869
4/27/2022,23,9703,460,5078,847,0,0,16088
4/27/2022,24,9708,382,4636,885,0,0,15611
4/28/2022,1,9704,373,4729,853,0,0,15659
4/28/2022,2,9708,373,4455,905,0,0,15441
4/28/2022,3,9711,374,4489,927,0,0,15501
4/28/2022,4,9708,374,4541,900,0,0,15523
4/28/2022,5,9709,370,4467,883,1,0,15430
4/28/2022,6,9711,374,5034,816,7,0,15942
4/28/2022,7,9711,418,5517,706,57,0,16409
4/28/2022,8,9705,504,5550,444,199,0,16402
4/28/2022,9,9712,511,5062,364,334,1,15984
4/28/2022,10,9711,431,5104,393,412,1,16052
4/28/2022,11,9709,370,5254,437,431,1,16202
4/28/2022,12,9716,377,5061,560,433,0,16147
4/28/2022,13,9712,387,4860,718,431,0,16108
4/28/2022,14,9712,522,4254,676,427,1,15592
4/28/2022,15,9712,798,4019,530,420,0,15479
4/28/2022,16,9712,977,4098,730,376,4,15897
4/28/2022,17,9715,976,4446,888,257,2,16284
4/28/2022,18,9714,977,4585,881,114,0,16271
4/28/2022,19,9712,982,4998,812,22,0,16526
4/28/2022,20,9705,1011,5587,642,1,0,16946
4/28/2022,21,9708,975,5596,543,0,0,16822
4/28/2022,22,9711,548,5469,520,0,0,16248
4/28/2022,23,9715,372,4919,592,0,0,15598
4/28/2022,24,9711,363,4618,678,0,0,15370
4/29/2022,1,9715,364,4368,689,0,0,15136
4/29/2022,2,9720,363,4217,863,0,0,15163
4/29/2022,3,9717,365,4105,1010,0,0,15197
4/29/2022,4,9721,367,4224,915,0,0,15227
4/29/2022,5,9717,381,4323,1044,0,2,15467
4/29/2022,6,9724,437,4244,1177,8,10,15600
4/29/2022,7,9724,549,4699,1173,65,5,16215
4/29/2022,8,9718,565,5270,775,191,5,16524
4/29/2022,9,9724,561,5015,706,330,3,16339
4/29/2022,10,9721,561,4760,762,410,4,16218
4/29/2022,11,9718,561,4796,683,430,0,16188
4/29/2022,12,9718,563,4789,560,433,0,16063
4/29/2022,13,9722,453,4828,559,433,0,15995
4/29/2022,14,9718,373,4492,666,433,0,15682
4/29/2022,15,9729,470,4130,653,423,0,15405
4/29/2022,16,9725,627,4090,675,368,0,15485
4/29/2022,17,9723,781,4472,817,249,0,16042
4/29/2022,18,9730,633,4904,830,110,0,16207
4/29/2022,19,9734,545,5155,734,20,0,16188
4/29/2022,20,9731,544,5355,784,0,1,16415
4/29/2022,21,9729,543,5298,1055,0,0,16625
4/29/2022,22,9727,545,4936,1247,0,0,16455
4/29/2022,23,9730,151,4175,1333,0,0,15389
4/29/2022,24,9720,68,3834,1384,0,0,15006
4/30/2022,1,8916,153,3933,1432,0,0,14434
4/30/2022,2,8919,119,3565,1709,0,0,14312
4/30/2022,3,8910,91,3566,1546,0,0,14113
4/30/2022,4,8906,92,3619,1686,0,0,14303
4/30/2022,5,8925,106,3615,2060,1,0,14707
4/30/2022,6,8930,152,3691,2272,9,0,15054
4/30/2022,7,8936,240,3867,1943,62,0,15048
4/30/2022,8,8935,365,4168,1789,188,0,15445
4/30/2022,9,8938,364,4367,1550,308,0,15527
4/30/2022,10,8943,365,4097,1404,379,0,15188
4/30/2022,11,8942,365,4066,1428,400,7,15208
4/30/2022,12,8937,364,3911,1622,416,36,15286
4/30/2022,13,8942,364,3790,1364,426,50,14936
4/30/2022,14,8949,365,3705,1050,404,50,14523
4/30/2022,15,8959,365,3714,1106,370,49,14563
4/30/2022,16,8953,366,3878,1206,313,48,14764
4/30/2022,17,8949,365,4333,1432,203,6,15288
4/30/2022,18,8948,316,4421,1733,99,0,15517
4/30/2022,19,8948,328,4469,2074,28,0,15847
4/30/2022,20,8946,337,4552,2562,0,0,16397
4/30/2022,21,8946,339,4387,2447,0,0,16119
4/30/2022,22,8950,364,4336,1964,0,0,15614
4/30/2022,23,8955,365,3904,1739,0,0,14963
4/30/2022,24,8956,364,3772,1067,0,0,14159
5/1/2022,1,8958,365,3580,812,0,0,13715
5/1/2022,2,8959,365,3495,543,0,0,13362
5/1/2022,3,8961,364,3602,449,0,0,13376
5/1/2022,4,8962,365,3627,634,0,0,13588
5/1/2022,5,8962,364,3590,827,1,0,13744
5/1/2022,6,8961,365,3665,881,9,0,13881
5/1/2022,7,8957,365,3879,1149,39,0,14389
5/1/2022,8,8948,365,3873,1234,94,0,14514
5/1/2022,9,8952,365,3870,1422,165,1,14775
5/1/2022,10,8941,365,3987,1627,213,1,15134
5/1/2022,11,8943,365,3760,2327,231,0,15626
5/1/2022,12,8966,365,3708,2329,267,0,15635
5/1/2022,13,8980,365,3802,2139,245,0,15531
5/1/2022,14,8976,368,3834,2138,221,0,15537
5/1/2022,15,8972,367,3894,2198,228,0,15659
5/1/2022,16,8979,367,4113,2316,179,1,15955
5/1/2022,17,8976,367,4605,2447,109,2,16506
5/1/2022,18,8978,367,5049,2084,56,2,16536
5/1/2022,19,8975,367,5487,1888,14,1,16732
5/1/2022,20,8971,367,5897,1671,0,4,16910
5/1/2022,21,8979,366,6003,1319,0,6,16673
5/1/2022,22,8960,384,5560,1017,0,5,15926
5/1/2022,23,8969,366,4864,970,0,1,15170
5/1/2022,24,9186,366,3875,992,0,8,14427
5/2/2022,1,9447,366,3594,671,0,10,14088
5/2/2022,2,9429,366,3551,679,0,11,14036
5/2/2022,3,9435,366,3612,485,0,8,13906
5/2/2022,4,9441,366,3705,626,0,1,14139
5/2/2022,5,9450,364,3673,1035,0,0,14522
5/2/2022,6,9459,363,4648,1033,1,0,15504
5/2/2022,7,9463,433,5719,959,17,0,16591
5/2/2022,8,9458,462,5900,947,43,0,16810
5/2/2022,9,9465,380,5647,1058,52,1,16603
5/2/2022,10,9454,366,5567,1122,103,1,16613
5/2/2022,11,9453,376,5266,1321,118,1,16535
5/2/2022,12,9451,404,5408,1422,96,1,16782
5/2/2022,13,9446,527,5340,1316,125,0,16754
5/2/2022,14,9449,539,5549,1217,128,0,16882
5/2/2022,15,9440,580,5622,1191,91,0,16924
5/2/2022,16,9445,712,5809,831,94,0,16891
5/2/2022,17,9430,939,5916,625,69,0,16979
5/2/2022,18,9436,1001,5959,522,33,0,16951
5/2/2022,19,9442,1026,5403,557,6,0,16434
5/2/2022,20,9434,1047,5740,458,0,0,16679
5/2/2022,21,9430,1118,5703,310,0,0,16561
5/2/2022,22,9445,1122,5260,304,0,0,16131
5/2/2022,23,9447,813,5125,220,0,0,15605
5/2/2022,24,9448,693,4912,174,0,0,15227
5/3/2022,1,9452,693,4460,144,0,0,14749
5/3/2022,2,9535,693,4476,114,0,0,14818
5/3/2022,3,9703,631,4032,78,0,0,14444
5/3/2022,4,9729,366,4407,190,0,0,14692
5/3/2022,5,9741,366,4516,210,0,19,14852
5/3/2022,6,9762,366,4535,397,2,36,15098
5/3/2022,7,9769,367,5030,517,26,36,15745
5/3/2022,8,9764,367,5108,721,77,37,16074
5/3/2022,9,9767,369,4894,851,115,33,16029
5/3/2022,10,9772,370,4869,928,140,30,16109
5/3/2022,11,9776,369,5132,1196,116,36,16625
5/3/2022,12,9774,370,4975,1233,136,43,16531
5/3/2022,13,9778,376,5130,1405,172,55,16916
5/3/2022,14,9833,432,4936,1653,146,78,17078
5/3/2022,15,9849,497,4870,1713,92,81,17102
5/3/2022,16,9830,581,5277,1540,60,86,17374
5/3/2022,17,9827,782,5843,979,27,88,17546
5/3/2022,18,9829,868,5580,863,20,89,17249
5/3/2022,19,9827,807,5172,1007,6,88,16907
5/3/2022,20,9828,576,5122,1454,0,88,17068
5/3/2022,21,9824,573,5106,1318,0,86,16907
5/3/2022,22,9814,425,5100,1047,0,70,16456
5/3/2022,23,9834,369,4901,931,0,18,16053
5/3/2022,24,9839,367,4457,588,0,14,15265
5/4/2022,1,9842,368,4161,392,0,13,14776
5/4/2022,2,9708,370,3938,457,0,9,14482
5/4/2022,3,9555,370,3844,674,0,18,14461
5/4/2022,4,9559,370,3898,498,0,16,14341
5/4/2022,5,9575,369,3928,1149,0,17,15038
5/4/2022,6,9843,369,3991,1721,2,5,15931
5/4/2022,7,9859,370,4525,2448,12,4,17218
5/4/2022,8,9692,373,4851,2741,38,1,17696
5/4/2022,9,9706,372,5023,2434,69,0,17604
5/4/2022,10,9859,373,4736,2353,115,0,17436
5/4/2022,11,9865,384,4727,1992,160,2,17130
5/4/2022,12,9885,420,4742,1624,246,0,16917
5/4/2022,13,9887,423,4920,1156,322,15,16723
5/4/2022,14,9883,450,4805,1044,311,44,16537
5/4/2022,15,9885,480,4826,851,262,51,16355
5/4/2022,16,9874,618,5007,771,245,51,16566
5/4/2022,17,9878,742,4905,989,188,51,16753
5/4/2022,18,9877,593,5158,1167,93,39,16927
5/4/2022,19,9879,504,5485,932,23,0,16823
5/4/2022,20,9885,508,5634,805,1,0,16833
5/4/2022,21,9876,503,5713,979,0,0,17071
5/4/2022,22,9887,194,5670,974,0,0,16725
5/4/2022,23,9891,128,4884,891,0,0,15794
5/4/2022,24,9904,130,4418,790,0,0,15242
5/5/2022,1,9904,130,3977,760,0,0,14771
5/5/2022,2,9895,139,3804,725,0,0,14563
5/5/2022,3,9906,141,3745,651,0,1,14444
5/5/2022,4,9903,189,3782,768,0,1,14643
5/5/2022,5,9899,320,4152,713,0,2,15086
5/5/2022,6,9895,319,4998,744,12,27,15995
5/5/2022,7,9899,319,5141,862,66,50,16337
5/5/2022,8,9898,320,5297,472,182,53,16222
5/5/2022,9,9906,194,5524,220,299,53,16196
5/5/2022,10,9904,149,4744,298,367,53,15515
5/5/2022,11,9901,130,5003,206,388,53,15681
5/5/2022,12,9904,135,5335,216,396,13,15999
5/5/2022,13,9920,207,5227,225,398,0,15977
5/5/2022,14,9915,353,4885,249,381,0,15783
5/5/2022,15,9922,713,4885,242,322,0,16084
5/5/2022,16,9926,998,5087,268,226,0,16505
5/5/2022,17,9921,1117,5362,372,154,0,16926
5/5/2022,18,9919,1119,5338,386,69,0,16831
5/5/2022,19,9933,1119,5562,445,23,0,17082
5/5/2022,20,9756,1120,5670,640,1,0,17187
5/5/2022,21,9235,1116,5738,706,0,0,16795
5/5/2022,22,9162,793,5465,729,0,0,16149
5/5/2022,23,9163,256,5403,788,0,0,15610
5/5/2022,24,9161,128,5122,752,0,0,15163
5/6/2022,1,9179,129,4806,650,0,0,14764
5/6/2022,2,9185,128,4381,858,0,0,14552
5/6/2022,3,9179,127,3827,1324,0,0,14457
5/6/2022,4,9178,128,3733,1403,0,0,14442
5/6/2022,5,9181,126,3877,1610,1,1,14796
5/6/2022,6,9175,127,4339,2209,10,16,15876
5/6/2022,7,9175,127,4904,2317,45,57,16625
5/6/2022,8,9177,127,5045,2464,117,78,17008
5/6/2022,9,9173,127,5025,2306,176,79,16886
5/6/2022,10,9175,127,4862,2329,235,82,16810
5/6/2022,11,9173,127,4570,2419,277,82,16648
5/6/2022,12,9167,127,4582,2301,309,56,16542
5/6/2022,13,9166,141,4336,2265,314,25,16247
5/6/2022,14,9165,151,4138,2055,293,23,15825
5/6/2022,15,9159,156,4080,2205,252,14,15866
5/6/2022,16,9156,154,4201,2305,236,4,16056
5/6/2022,17,9151,154,4321,2616,166,0,16408
5/6/2022,18,9145,154,4667,2774,88,0,16828
5/6/2022,19,9143,128,4682,3051,30,5,17039
5/6/2022,20,9144,127,4693,3167,2,10,17143
5/6/2022,21,9143,127,4746,3405,0,4,17425
5/6/2022,22,9146,127,4346,2894,0,5,16518
5/6/2022,23,9144,127,4054,2095,0,5,15425
5/6/2022,24,9144,127,3881,1299,0,2,14453
5/7/2022,1,9149,128,3705,1192,0,4,14178
5/7/2022,2,9155,127,3670,974,0,12,13938
5/7/2022,3,9153,127,3639,701,0,6,13626
5/7/2022,4,9157,127,3650,807,0,0,13741
5/7/2022,5,9165,127,3646,1035,1,0,13974
5/7/2022,6,9177,127,3811,1132,12,0,14259
5/7/2022,7,9177,127,4039,1160,66,0,14569
5/7/2022,8,9186,127,4010,1212,188,0,14723
5/7/2022,9,9183,127,4081,966,239,0,14596
5/7/2022,10,9187,127,4132,882,327,0,14655
5/7/2022,11,9182,127,3988,950,429,0,14676
5/7/2022,12,9187,126,3838,983,433,0,14567
5/7/2022,13,9188,126,3829,778,412,0,14333
5/7/2022,14,9194,127,3811,683,302,0,14117
5/7/2022,15,9200,127,3832,693,310,0,14162
5/7/2022,16,9203,128,4018,888,375,0,14612
5/7/2022,17,9205,127,4283,1163,260,0,15038
5/7/2022,18,9204,128,4512,1445,118,0,15407
5/7/2022,19,9204,128,4564,1615,24,0,15535
5/7/2022,20,9201,128,5121,1519,1,0,15970
5/7/2022,21,9204,128,5149,1615,0,0,16096
5/7/2022,22,9206,128,4688,1514,0,0,15536
5/7/2022,23,9207,127,4430,1428,0,0,15192
5/7/2022,24,9219,126,4127,924,0,0,14396
5/8/2022,1,9221,126,3863,1268,0,0,14478
5/8/2022,2,9223,126,3817,1199,0,0,14365
5/8/2022,3,9225,126,3753,1242,0,0,14346
5/8/2022,4,9221,127,3713,1278,0,0,14339
5/8/2022,5,9219,127,3710,1425,0,0,14481
5/8/2022,6,9211,127,3986,1237,10,0,14571
5/8/2022,7,9213,135,4335,1087,66,0,14836
5/8/2022,8,9204,160,4523,724,197,0,14808
5/8/2022,9,9218,203,4679,412,327,0,14839
5/8/2022,10,9215,234,4339,333,383,0,14504
5/8/2022,11,9216,234,4322,440,429,0,14641
5/8/2022,12,9213,234,4126,566,433,0,14572
5/8/2022,13,9210,234,4219,495,433,0,14591
5/8/2022,14,9209,252,4167,383,429,0,14440
5/8/2022,15,9209,289,4245,395,337,0,14475
5/8/2022,16,9205,308,4400,556,332,0,14801
5/8/2022,17,9208,345,4565,1025,247,0,15390
5/8/2022,18,9209,487,4741,1289,114,0,15840
5/8/2022,19,9210,489,4775,1566,25,0,16065
5/8/2022,20,9207,489,5006,1800,0,0,16502
5/8/2022,21,9204,489,4793,2127,0,0,16613
5/8/2022,22,9206,484,4419,2417,0,0,16526
5/8/2022,23,9209,484,4016,2155,0,0,15864
5/8/2022,24,9201,353,3892,1650,0,0,15096
5/9/2022,1,9204,149,3777,1355,0,0,14485
5/9/2022,2,9206,129,3802,1254,0,1,14392
5/9/2022,3,9214,129,3745,1231,0,1,14320
5/9/2022,4,9217,129,3790,1485,0,0,14621
5/9/2022,5,9220,128,3757,2071,1,0,15177
5/9/2022,6,9210,126,4093,2104,9,0,15542
5/9/2022,7,9207,125,4664,2115,65,0,16176
5/9/2022,8,9164,215,5144,1480,195,0,16198
5/9/2022,9,8396,486,5448,1325,312,0,15967
5/9/2022,10,8354,508,4756,1471,383,0,15472
5/9/2022,11,7595,376,5068,1960,422,0,15421
5/9/2022,12,7593,330,4889,2162,432,0,15406
5/9/2022,13,7591,485,5006,2222,431,0,15735
5/9/2022,14,7558,653,4621,2238,430,0,15500
5/9/2022,15,6778,716,5570,2252,413,8,15737
5/9/2022,16,6776,835,5900,2103,353,13,15980
5/9/2022,17,6773,1037,5853,2553,233,38,16487
5/9/2022,18,6773,893,5166,2966,107,49,15954
5/9/2022,19,6775,768,5235,2927,27,47,15779
5/9/2022,20,6771,480,5314,3189,2,48,15804
5/9/2022,21,6773,398,5297,3587,0,48,16103
5/9/2022,22,6774,368,4797,3592,0,48,15579
5/9/2022,23,6775,231,4374,3819,0,9,15208
5/9/2022,24,6772,139,4308,2654,0,0,13873
5/10/2022,1,6773,140,4032,2362,0,0,13307
5/10/2022,2,6771,140,3870,2659,0,0,13440
5/10/2022,3,6770,139,3878,2656,0,0,13443
5/10/2022,4,6766,139,4086,2786,0,0,13777
5/10/2022,5,6768,138,4301,3131,1,0,14339
5/10/2022,6,6777,139,4324,3344,13,0,14597
5/10/2022,7,6774,138,4946,3335,69,0,15262
5/10/2022,8,6771,143,5400,3280,166,0,15760
5/10/2022,9,6775,158,5453,3180,276,0,15842
5/10/2022,10,6774,168,5521,3062,351,0,15876
5/10/2022,11,6771,249,5446,2954,395,0,15815
5/10/2022,12,6766,317,5485,2502,424,11,15505
5/10/2022,13,6762,624,5756,2077,423,44,15686
5/10/2022,14,6763,588,5504,1770,396,54,15075
5/10/2022,15,6762,787,5535,1645,398,50,15177
5/10/2022,16,6766,1329,5245,1815,331,49,15535
5/10/2022,17,6763,1333,5488,2069,200,49,15902
5/10/2022,18,6762,1294,5571,2239,102,49,16017
5/10/2022,19,6761,1283,5859,2230,29,50,16212
5/10/2022,20,6763,1294,6083,2238,3,52,16433
5/10/2022,21,6764,1073,5914,2681,0,53,16485
5/10/2022,22,6763,475,5594,2913,0,52,15797
5/10/2022,23,6763,140,5182,2997,0,12,15094
5/10/2022,24,6765,136,5117,2789,0,0,14807
5/11/2022,1,6769,136,5261,2300,0,0,14466
5/11/2022,2,6775,159,5250,2164,0,0,14348
5/11/2022,3,6774,153,4602,2272,0,0,13801
5/11/2022,4,6778,267,4778,2049,0,0,13872
5/11/2022,5,6772,578,4449,1810,1,0,13610
5/11/2022,6,6773,965,4760,1704,12,0,14214
5/11/2022,7,6771,1120,5361,1537,63,0,14852
5/11/2022,8,6767,1102,5367,1336,173,0,14745
5/11/2022,9,6770,1266,5819,739,272,0,14866
5/11/2022,10,6765,1322,5692,473,369,0,14621
5/11/2022,11,6770,1417,5677,314,377,0,14555
5/11/2022,12,6764,1475,5276,247,402,0,14164
5/11/2022,13,6769,1538,5533,352,385,3,14580
5/11/2022,14,6772,1676,5220,495,392,34,14589
5/11/2022,15,6774,2054,5334,170,367,49,14748
5/11/2022,16,6770,2992,5516,106,292,48,15724
5/11/2022,17,6774,3381,5580,76,212,48,16071
5/11/2022,18,6773,3018,5634,188,102,50,15765
5/11/2022,19,6774,2631,5922,352,24,49,15752
5/11/2022,20,6769,2508,6128,626,1,59,16091
5/11/2022,21,6771,2550,6064,850,0,53,16288
5/11/2022,22,6773,1850,5801,1221,0,53,15698
5/11/2022,23,6777,1042,5299,1264,0,54,14436
5/11/2022,24,6777,719,5134,1183,0,54,13867
5/12/2022,1,6777,382,5043,1131,0,54,13387
5/12/2022,2,6779,346,5199,749,0,47,13120
5/12/2022,3,6781,399,5398,547,0,47,13172
5/12/2022,4,6783,607,5301,521,0,47,13259
5/12/2022,5,6780,896,4796,999,0,47,13518
5/12/2022,6,6777,1291,4367,1427,13,47,13922
5/12/2022,7,6779,1517,5000,1387,58,47,14788
5/12/2022,8,6773,1786,5075,1013,148,47,14842
5/12/2022,9,6777,2029,5641,325,252,47,15071
5/12/2022,10,6773,2420,5272,307,336,12,15120
5/12/2022,11,6759,2759,4680,367,375,0,14940
5/12/2022,12,6751,2522,5224,393,384,0,15274
5/12/2022,13,6756,2512,5218,678,384,1,15549
5/12/2022,14,6763,2513,5287,826,384,6,15779
5/12/2022,15,6765,2583,5574,844,344,40,16150
5/12/2022,16,6756,2780,5896,657,273,62,16424
5/12/2022,17,6754,3524,6073,742,181,59,17333
5/12/2022,18,6758,3666,6176,866,97,50,17613
5/12/2022,19,6756,3403,6231,994,29,63,17476
5/12/2022,20,6760,3237,6233,1100,4,85,17419
5/12/2022,21,6759,2631,5901,1449,0,93,16833
5/12/2022,22,6760,1317,5876,1705,0,94,15752
5/12/2022,23,6763,686,5514,2132,0,108,15203
5/12/2022,24,6764,222,4859,2439,0,113,14397
5/13/2022,1,6771,140,4649,2729,0,69,14358
5/13/2022,2,6773,140,4335,2804,0,65,14117
5/13/2022,3,6776,140,4432,2578,0,108,14034
5/13/2022,4,6775,145,4389,2569,0,121,13999
5/13/2022,5,6769,152,4461,2550,1,121,14054
5/13/2022,6,6768,186,4614,2478,7,75,14128
5/13/2022,7,6767,358,5266,2295,55,55,14796
5/13/2022,8,6764,792,5456,1732,154,49,14947
5/13/2022,9,6759,1118,5523,1653,239,48,15340
5/13/2022,10,6753,1536,5293,1399,347,48,15376
5/13/2022,11,6754,2260,5554,1163,371,48,16150
5/13/2022,12,6753,2668,5751,986,353,105,16616
5/13/2022,13,6753,2971,5898,595,353,179,16749
5/13/2022,14,6760,3214,5958,517,346,180,16975
5/13/2022,15,6759,2957,5913,523,318,115,16585
5/13/2022,16,6759,2942,5918,564,261,50,16494
5/13/2022,17,6756,3362,6001,630,173,51,16973
5/13/2022,18,6758,3039,6119,785,84,50,16835
5/13/2022,19,6760,2817,6044,899,27,49,16596
5/13/2022,20,6760,2818,6153,977,3,49,16760
5/13/2022,21,6757,2747,6172,1199,0,49,16924
5/13/2022,22,6792,2116,5379,1447,0,49,15783
5/13/2022,23,6809,824,4980,1888,0,49,14550
5/13/2022,24,6827,218,5018,1884,0,49,13996
5/14/2022,1,6831,137,5121,1751,0,49,13889
5/14/2022,2,6837,167,5407,1551,0,15,13977
5/14/2022,3,6827,181,5198,1593,0,0,13799
5/14/2022,4,6826,193,5271,1424,0,0,13714
5/14/2022,5,6836,274,5232,1467,0,0,13809
5/14/2022,6,6864,463,4733,1521,6,0,13587
5/14/2022,7,6864,636,5169,1286,56,0,14011
5/14/2022,8,6859,913,5710,884,142,1,14509
5/14/2022,9,6863,1175,5813,743,277,19,14890
5/14/2022,10,6862,1370,5741,609,369,55,15006
5/14/2022,11,6871,1579,5751,442,387,143,15173
5/14/2022,12,6862,2002,5834,317,380,174,15569
5/14/2022,13,6852,2542,5733,246,409,160,15942
5/14/2022,14,6859,2605,5746,331,412,143,16096
5/14/2022,15,6855,2943,5839,403,372,109,16521
5/14/2022,16,6858,3297,5865,483,284,109,16896
5/14/2022,17,6858,3427,5938,488,189,108,17008
5/14/2022,18,6909,3193,6017,441,89,86,16735
5/14/2022,19,6961,3478,6105,335,18,54,16951
5/14/2022,20,6959,3105,6109,595,2,14,16784
5/14/2022,21,6995,3272,6143,506,0,1,16917
5/14/2022,22,7017,2362,5707,828,0,8,15922
5/14/2022,23,7017,1485,5758,510,0,16,14786
5/14/2022,24,7017,535,5811,317,0,7,13687
5/15/2022,1,7024,457,5443,314,0,0,13238
5/15/2022,2,7033,429,5095,372,0,0,12929
5/15/2022,3,7123,167,5182,417,0,0,12889
5/15/2022,4,7158,199,5266,371,0,0,12994
5/15/2022,5,7161,228,5318,305,2,0,13014
5/15/2022,6,7155,428,5136,303,7,0,13029
5/15/2022,7,7156,787,4823,265,42,22,13095
5/15/2022,8,6870,1179,5250,228,98,49,13674
5/15/2022,9,6261,1369,5883,154,173,51,13891
5/15/2022,10,6259,1402,5689,181,275,51,13857
5/15/2022,11,6262,1739,5692,240,362,77,14372
5/15/2022,12,6261,1904,5615,374,373,62,14589
5/15/2022,13,6263,2367,4944,549,377,53,14553
5/15/2022,14,6257,2469,5611,714,312,53,15416
5/15/2022,15,6281,2451,5490,796,327,53,15398
5/15/2022,16,6288,3043,5889,982,309,58,16569
5/15/2022,17,6288,3217,6259,1008,217,60,17049
5/15/2022,18,6294,3748,6131,968,98,59,17298
5/15/2022,19,6301,3932,6223,743,22,56,17277
5/15/2022,20,6292,3476,6190,875,2,60,16895
5/15/2022,21,6304,3303,6056,929,0,91,16683
5/15/2022,22,6333,2523,5939,671,0,90,15556
5/15/2022,23,6340,2130,5708,486,0,92,14756
5/15/2022,24,6339,1223,4664,1058,0,18,13302
5/16/2022,1,6336,536,4528,1346,0,0,12746
5/16/2022,2,6334,384,4487,1512,0,0,12717
5/16/2022,3,6338,388,4835,1392,0,0,12953
5/16/2022,4,6351,532,5139,916,0,0,12938
5/16/2022,5,6384,643,4727,820,0,0,12574
5/16/2022,6,6392,948,5232,728,10,1,13311
5/16/2022,7,6391,1431,5274,1228,36,1,14361
5/16/2022,8,6393,1976,5607,894,87,0,14957
5/16/2022,9,6395,2093,5734,695,177,0,15094
5/16/2022,10,6390,2429,5748,441,202,2,15212
5/16/2022,11,6393,2764,5635,416,190,3,15401
5/16/2022,12,6394,2849,5628,489,160,9,15529
5/16/2022,13,6383,2779,5460,693,132,8,15455
5/16/2022,14,6379,2452,5494,801,170,1,15297
5/16/2022,15,6375,2286,5379,1010,163,0,15213
5/16/2022,16,6367,2343,5435,999,184,1,15329
5/16/2022,17,6375,2376,5601,962,118,0,15432
5/16/2022,18,6391,2249,5617,1034,67,0,15358
5/16/2022,19,6395,2229,5314,1063,19,0,15020
5/16/2022,20,6397,1760,5455,1222,2,0,14836
5/16/2022,21,6400,1532,5295,1341,0,0,14568
5/16/2022,22,6392,1041,5306,1542,0,0,14281
5/16/2022,23,6400,678,5103,1798,0,0,13979
5/16/2022,24,6399,462,4713,2000,0,0,13574
5/17/2022,1,6408,370,4642,2138,0,0,13558
5/17/2022,2,6405,369,4456,2469,0,0,13699
5/17/2022,3,6405,370,4388,2378,0,0,13541
5/17/2022,4,6404,370,4383,2090,0,0,13247
5/17/2022,5,6399,378,4961,2189,3,0,13930
5/17/2022,6,6394,422,5114,2118,9,0,14057
5/17/2022,7,6394,512,5177,2196,62,15,14356
5/17/2022,8,6392,615,5028,2134,138,42,14349
5/17/2022,9,6397,879,4945,1848,260,56,14385
5/17/2022,10,6396,1128,5359,1612,288,57,14840
5/17/2022,11,6388,1372,4858,1663,317,71,14669
5/17/2022,12,6394,1368,4631,1850,312,71,14626
5/17/2022,13,6395,1380,4702,1753,295,59,14584
5/17/2022,14,6391,1502,4799,1536,294,54,14576
5/17/2022,15,6390,1734,4927,1385,259,56,14751
5/17/2022,16,6389,2007,4915,1272,222,56,14861
5/17/2022,17,6390,2007,4899,1002,202,57,14557
5/17/2022,18,6391,1729,5445,1162,108,56,14891
5/17/2022,19,6399,1575,5650,986,31,56,14697
5/17/2022,20,6398,1583,5638,715,5,54,14393
5/17/2022,21,6392,1755,5793,524,0,50,14514
5/17/2022,22,6395,1666,5777,423,0,49,14310
5/17/2022,23,6407,945,5694,392,0,11,13449
5/17/2022,24,6405,425,4970,471,0,0,12271
5/18/2022,1,6398,367,4982,512,0,0,12259
5/18/2022,2,6395,373,4897,483,0,0,12148
5/18/2022,3,6402,390,4954,408,0,0,12154
5/18/2022,4,6401,498,4749,365,0,0,12013
5/18/2022,5,6408,658,4616,352,3,3,12040
5/18/2022,6,6413,988,4965,389,15,4,12774
5/18/2022,7,6409,987,5616,417,68,24,13521
5/18/2022,8,6406,985,5808,237,169,53,13658
5/18/2022,9,6406,1002,5757,189,265,70,13689
5/18/2022,10,6397,989,5589,313,288,71,13647
5/18/2022,11,6398,1045,5576,435,294,71,13819
5/18/2022,12,6407,1001,5440,680,268,71,13867
5/18/2022,13,6405,1149,5653,567,245,70,14089
5/18/2022,14,6407,1221,5668,490,216,71,14073
5/18/2022,15,6406,1226,5501,709,208,70,14120
5/18/2022,16,6407,1292,5203,926,174,71,14073
5/18/2022,17,6406,1427,5555,1023,120,69,14600
5/18/2022,18,6405,1543,5570,1167,55,34,14774
5/18/2022,19,6406,1564,5917,975,22,10,14894
5/18/2022,20,6403,1625,5987,983,1,48,15047
5/18/2022,21,6400,1529,5933,813,0,15,14690
5/18/2022,22,6398,1239,6097,641,0,0,14375
5/18/2022,23,6401,1051,5875,596,0,0,13923
5/18/2022,24,6404,530,5469,536,0,0,12939
5/19/2022,1,6405,383,5001,509,0,0,12298
5/19/2022,2,6408,384,5043,529,0,0,12364
5/19/2022,3,6394,381,5121,470,0,0,12366
5/19/2022,4,6405,491,5123,484,0,0,12503
5/19/2022,5,6395,643,4781,497,1,11,12328
5/19/2022,6,6418,813,5069,632,2,44,12978
5/19/2022,7,6421,949,5670,741,13,80,13874
5/19/2022,8,6420,1139,5638,867,25,89,14178
5/19/2022,9,6415,1178,5737,801,73,61,14265
5/19/2022,10,6414,1570,5908,730,135,87,14844
5/19/2022,11,6415,1831,5570,593,163,88,14660
5/19/2022,12,6411,1847,5237,793,189,68,14545
5/19/2022,13,6414,1841,4981,886,237,54,14413
5/19/2022,14,6411,1671,4973,892,254,54,14255
5/19/2022,15,6408,1729,5090,1080,261,57,14625
5/19/2022,16,6399,1851,5009,1256,208,48,14771
5/19/2022,17,6394,2021,5237,1116,151,70,14989
5/19/2022,18,6400,2149,5490,883,78,128,15128
5/19/2022,19,6407,2083,5357,749,25,181,14802
5/19/2022,20,6409,2196,5568,730,5,175,15083
5/19/2022,21,6409,2064,5361,1036,0,174,15044
5/19/2022,22,6416,1456,5405,1495,0,120,14892
5/19/2022,23,6414,698,4799,1919,0,52,13882
5/19/2022,24,6419,427,4904,1603,0,9,13362
5/20/2022,1,6418,379,4662,1947,0,0,13406
5/20/2022,2,6422,379,4460,2400,0,0,13661
5/20/2022,3,6413,381,4351,2881,0,0,14026
5/20/2022,4,6408,477,4367,2862,0,0,14114
5/20/2022,5,6210,586,4612,2531,2,0,13941
5/20/2022,6,5908,920,5428,1854,9,0,14119
5/20/2022,7,5907,940,5609,2129,44,0,14629
5/20/2022,8,5908,855,5296,2405,81,0,14545
5/20/2022,9,5903,1050,5313,2114,165,0,14545
5/20/2022,10,5902,1312,5260,2154,321,0,14949
5/20/2022,11,5902,1742,5269,2060,348,0,15321
5/20/2022,12,5899,2017,5279,2663,321,2,16181
5/20/2022,13,5897,1853,5457,3149,297,21,16674
5/20/2022,14,5900,1742,5352,2721,298,48,16061
5/20/2022,15,5893,1654,5123,3177,285,53,16185
5/20/2022,16,5907,1680,5270,3213,231,52,16353
5/20/2022,17,5976,1684,5172,3615,169,56,16672
5/20/2022,18,6077,1661,5385,3376,72,56,16627
5/20/2022,19,6072,1674,5190,3428,30,56,16450
5/20/2022,20,6074,1112,5796,3645,4,64,16695
5/20/2022,21,6071,1017,6001,3574,0,72,16735
5/20/2022,22,6073,821,5437,3561,0,59,15951
5/20/2022,23,6069,608,4888,3024,0,11,14600
5/20/2022,24,6330,415,4828,2589,0,0,14162
5/21/2022,1,6552,374,4786,2530,0,0,14242
5/21/2022,2,6556,374,4567,2938,0,0,14435
5/21/2022,3,6560,375,4904,2731,0,0,14570
5/21/2022,4,6564,381,4839,2589,0,0,14373
5/21/2022,5,6562,399,5006,2272,0,0,14239
5/21/2022,6,6569,549,4997,1848,8,0,13971
5/21/2022,7,6568,750,4940,1791,61,0,14110
5/21/2022,8,6569,1167,5040,1349,136,0,14261
5/21/2022,9,6619,1373,5085,1121,209,3,14410
5/21/2022,10,6722,1390,5167,1622,202,9,15112
5/21/2022,11,6727,1596,5632,1519,291,36,15801
5/21/2022,12,6726,2189,5510,1091,266,59,15841
5/21/2022,13,6719,2267,4788,241,75,56,14146
5/21/2022,14,6334,2240,4723,226,83,56,13662
5/21/2022,15,6202,2136,4957,453,103,53,13904
5/21/2022,16,6202,3036,4924,757,126,54,15099
5/21/2022,17,6207,2696,5241,1289,146,57,15636
5/21/2022,18,6208,2639,5118,854,82,31,14932
5/21/2022,19,6213,2658,5258,429,18,6,14582
5/21/2022,20,6214,2658,4933,493,1,6,14305
5/21/2022,21,6220,2653,4939,410,0,0,14222
5/21/2022,22,6220,2098,5227,354,0,0,13899
5/21/2022,23,6225,1546,5168,293,0,0,13232
5/21/2022,24,6229,1009,5137,161,0,0,12536
5/22/2022,1,6265,488,4936,170,0,0,11859
5/22/2022,2,6275,385,5190,153,0,0,12003
5/22/2022,3,6284,392,4511,264,0,0,11451
5/22/2022,4,6280,393,4301,203,0,0,11177
5/22/2022,5,6270,471,4360,481,2,0,11584
5/22/2022,6,6262,606,4320,628,7,0,11823
5/22/2022,7,6264,823,4703,323,18,0,12131
5/22/2022,8,6261,866,4768,481,69,0,12445
5/22/2022,9,6262,978,4869,1060,109,0,13278
5/22/2022,10,6268,1142,4878,1210,124,0,13622
5/22/2022,11,6280,1435,4982,1142,95,0,13934
5/22/2022,12,6277,1439,5249,839,88,0,13892
5/22/2022,13,6270,1308,5017,603,78,0,13276
5/22/2022,14,6271,1286,4692,511,98,0,12858
5/22/2022,15,6281,1489,4739,174,31,0,12714
5/22/2022,16,6274,1375,4883,352,91,0,12975
5/22/2022,17,6284,1370,4787,186,45,0,12672
5/22/2022,18,6286,1377,4847,317,62,0,12889
5/22/2022,19,6285,1374,4936,128,19,0,12742
5/22/2022,20,6286,1039,5067,322,4,0,12718
5/22/2022,21,6288,951,5425,611,0,0,13275
5/22/2022,22,6290,762,5614,655,0,1,13322
5/22/2022,23,6289,632,4930,473,0,6,12330
5/22/2022,24,6297,475,5143,442,0,9,12366
5/23/2022,1,6306,377,5143,435,0,1,12262
5/23/2022,2,6319,380,5039,429,0,0,12167
5/23/2022,3,6341,378,5124,562,0,0,12405
5/23/2022,4,6359,373,5032,623,1,0,12388
5/23/2022,5,6405,474,5143,641,1,0,12664
5/23/2022,6,6451,604,5253,707,12,0,13027
5/23/2022,7,6492,727,5039,546,53,11,12868
5/23/2022,8,6536,728,4983,304,83,12,12646
5/23/2022,9,6546,729,4994,475,214,7,12965
5/23/2022,10,6541,729,5255,375,229,3,13132
5/23/2022,11,6546,732,5316,497,270,6,13367
5/23/2022,12,6543,735,5373,485,257,3,13396
5/23/2022,13,6539,652,5308,517,233,0,13249
5/23/2022,14,6539,713,5168,616,207,0,13243
5/23/2022,15,6538,869,4915,595,202,0,13119
5/23/2022,16,6615,897,5093,520,171,0,13296
5/23/2022,17,6650,821,5585,558,124,0,13738
5/23/2022,18,6672,843,5787,512,92,0,13906
5/23/2022,19,6673,981,5443,512,43,0,13652
5/23/2022,20,6669,985,5764,448,7,0,13873
5/23/2022,21,6674,985,5818,542,0,0,14019
5/23/2022,22,6675,744,5818,629,0,0,13866
5/23/2022,23,6673,405,5521,724,0,0,13323
5/23/2022,24,6664,370,5336,816,0,0,13186
5/24/2022,1,6709,370,5236,934,0,0,13249
5/24/2022,2,6721,375,5316,853,0,0,13265
5/24/2022,3,6723,421,5570,832,0,0,13546
5/24/2022,4,6736,506,5508,898,0,0,13648
5/24/2022,5,6754,665,5042,904,2,0,13367
5/24/2022,6,6819,850,5148,926,14,0,13757
5/24/2022,7,6838,1063,5367,638,62,0,13968
5/24/2022,8,6843,1227,5571,335,124,0,14100
5/24/2022,9,6876,1243,5443,229,227,0,14018
5/24/2022,10,6894,1186,4987,275,355,0,13697
5/24/2022,11,6937,1166,5213,219,390,0,13925
5/24/2022,12,6971,1167,5127,242,398,0,13905
5/24/2022,13,7015,1169,5207,402,373,0,14166
5/24/2022,14,7017,902,5567,580,364,0,14430
5/24/2022,15,7021,856,5437,783,361,0,14458
5/24/2022,16,7017,972,5250,792,271,0,14302
5/24/2022,17,7014,1068,5466,836,199,0,14583
5/24/2022,18,7014,1074,5514,709,112,0,14423
5/24/2022,19,7019,1079,5767,731,34,0,14630
5/24/2022,20,7020,1103,6069,627,7,0,14826
5/24/2022,21,7032,1208,5986,671,0,0,14897
5/24/2022,22,7047,1064,5333,796,0,0,14240
5/24/2022,23,7063,522,5127,1029,0,0,13741
5/24/2022,24,7204,372,4964,1149,0,0,13689
5/25/2022,1,7247,371,4814,1366,0,0,13798
5/25/2022,2,7245,373,4871,1670,0,0,14159
5/25/2022,3,7249,477,4553,1603,0,0,13882
5/25/2022,4,7229,532,4680,1710,1,0,14152
5/25/2022,5,7228,594,4563,1629,1,0,14015
5/25/2022,6,7233,729,4797,1387,18,0,14164
5/25/2022,7,7243,743,5454,1284,69,0,14793
5/25/2022,8,7230,751,5698,1248,162,0,15089
5/25/2022,9,7231,755,5835,1236,258,0,15315
5/25/2022,10,7231,755,5592,1551,329,0,15458
5/25/2022,11,7232,739,5326,1965,327,0,15589
5/25/2022,12,7284,628,5211,1781,298,0,15202
5/25/2022,13,7292,647,5108,1772,322,0,15141
5/25/2022,14,7296,931,5220,1936,318,0,15701
5/25/2022,15,7296,1067,5345,2260,246,0,16214
5/25/2022,16,7291,1233,5541,2428,198,0,16691
5/25/2022,17,7290,1372,5813,2427,118,0,17020
5/25/2022,18,7289,1368,5650,2395,53,0,16755
5/25/2022,19,7293,1348,5496,2258,18,0,16413
5/25/2022,20,7292,1076,5540,2732,2,0,16642
5/25/2022,21,7286,768,5565,3079,0,0,16698
5/25/2022,22,7286,638,5100,3257,0,0,16281
5/25/2022,23,7280,466,4578,3354,0,0,15678
5/25/2022,24,7284,371,4046,3374,0,0,15075
5/26/2022,1,7284,371,3968,3112,0,0,14735
5/26/2022,2,7277,372,3973,3026,0,0,14648
5/26/2022,3,7281,371,3949,2961,0,8,14570
5/26/2022,4,7280,371,3948,3138,0,8,14745
5/26/2022,5,7284,371,3989,3042,1,13,14700
5/26/2022,6,7296,372,4290,3265,10,18,15251
5/26/2022,7,7329,371,5046,3441,42,22,16251
5/26/2022,8,7422,373,5456,3581,86,21,16939
5/26/2022,9,7522,370,5278,3652,148,4,16974
5/26/2022,10,7500,398,5274,3609,231,2,17014
5/26/2022,11,7475,487,5208,3750,290,0,17210
5/26/2022,12,7478,555,5410,3855,253,0,17551
5/26/2022,13,7480,698,5717,3859,227,0,17981
5/26/2022,14,7482,954,5188,3574,256,0,17454
5/26/2022,15,7481,1320,5265,3449,239,0,17754
5/26/2022,16,7625,1418,5648,3106,160,0,17957
5/26/2022,17,7711,1545,5785,2710,85,0,17836
5/26/2022,18,7707,1546,5888,2316,41,0,17498
5/26/2022,19,7689,1404,5887,1967,14,0,16961
5/26/2022,20,7661,1367,5675,1847,3,0,16553
5/26/2022,21,7654,1017,6203,1915,0,0,16789
5/26/2022,22,7656,927,5532,2221,0,7,16343
5/26/2022,23,7699,559,5057,2380,0,1,15696
5/26/2022,24,7819,371,4731,2286,0,0,15207
5/27/2022,1,8009,371,4399,2072,0,0,14851
5/27/2022,2,8090,371,4420,1871,0,0,14752
5/27/2022,3,8077,378,4297,1914,0,1,14667
5/27/2022,4,8200,410,4823,1443,0,1,14877
5/27/2022,5,8234,593,4434,1308,1,0,14570
5/27/2022,6,8280,848,4240,1261,3,0,14632
5/27/2022,7,8421,1247,4963,1053,15,0,15699
5/27/2022,8,8333,1544,5771,1005,38,0,16691
5/27/2022,9,8296,1635,5939,779,60,0,16709
5/27/2022,10,8442,1798,5353,596,104,0,16293
5/27/2022,11,8440,2038,5482,686,129,0,16775
5/27/2022,12,8439,2051,5243,681,188,0,16602
5/27/2022,13,8443,2046,5441,725,185,0,16840
5/27/2022,14,8441,2021,5262,589,255,1,16569
5/27/2022,15,8452,2001,5379,688,266,0,16786
5/27/2022,16,8471,2020,5980,779,202,0,17452
5/27/2022,17,8584,2068,5838,960,132,0,17582
5/27/2022,18,8590,2054,5742,955,61,0,17402
5/27/2022,19,8593,1864,5902,712,24,0,17095
5/27/2022,20,8595,1809,5673,736,5,0,16818
5/27/2022,21,8703,1485,5451,837,0,3,16479
5/27/2022,22,8737,846,5580,916,0,6,16085
5/27/2022,23,8757,463,5209,808,0,0,15237
5/27/2022,24,8788,368,5221,656,0,0,15033
5/28/2022,1,8788,369,5229,595,0,0,14981
5/28/2022,2,8794,369,4730,849,0,0,14742
5/28/2022,3,8801,370,4655,998,0,0,14824
5/28/2022,4,8812,369,4637,938,0,0,14756
5/28/2022,5,8827,369,4778,847,0,0,14821
5/28/2022,6,8839,369,4794,714,5,0,14721
5/28/2022,7,8832,372,4836,537,49,0,14626
5/28/2022,8,8828,386,5362,398,141,0,15115
5/28/2022,9,8828,374,5394,293,224,0,15113
5/28/2022,10,8834,379,5592,270,258,2,15335
5/28/2022,11,9037,416,5685,309,225,2,15674
5/28/2022,12,9070,792,5628,293,270,0,16053
5/28/2022,13,9075,868,4870,220,319,0,15352
5/28/2022,14,9234,763,4914,310,308,0,15529
5/28/2022,15,9243,731,5203,451,332,0,15960
5/28/2022,16,9277,733,5115,523,313,0,15961
5/28/2022,17,9418,749,5905,490,206,0,16768
5/28/2022,18,9437,745,6130,399,103,0,16814
5/28/2022,19,9441,736,5789,366,32,0,16364
5/28/2022,20,9445,727,5436,382,6,0,15996
5/28/2022,21,9440,722,5623,412,0,0,16197
5/28/2022,22,9435,519,5807,403,0,0,16164
5/28/2022,23,9446,371,5229,393,0,0,15439
5/28/2022,24,9459,371,4804,490,0,0,15124
5/29/2022,1,9463,373,4299,362,0,0,14497
5/29/2022,2,9473,372,4182,672,0,0,14699
5/29/2022,3,9468,370,3998,623,0,0,14459
5/29/2022,4,9511,372,3990,568,1,0,14442
5/29/2022,5,9621,367,3945,417,2,0,14352
5/29/2022,6,9645,368,3950,564,18,0,14545
5/29/2022,7,9649,369,4165,623,65,0,14871
5/29/2022,8,9651,371,4728,447,170,0,15367
5/29/2022,9,9644,377,5348,390,229,1,15989
5/29/2022,10,9642,372,5196,463,276,0,15949
5/29/2022,11,9640,453,5331,634,365,0,16423
5/29/2022,12,9640,522,5327,786,382,0,16657
5/29/2022,13,9641,663,5201,1006,386,0,16897
5/29/2022,14,9635,719,5101,1166,393,0,17014
5/29/2022,15,9627,724,5388,1203,381,0,17323
5/29/2022,16,9620,730,5477,1191,322,0,17340
5/29/2022,17,9630,733,6069,1146,218,0,17796
5/29/2022,18,9637,734,5993,1157,109,0,17630
5/29/2022,19,9628,736,5699,1110,31,0,17204
5/29/2022,20,9644,755,5807,1249,5,1,17461
5/29/2022,21,9666,735,5252,1502,0,1,17156
5/29/2022,22,9669,634,5148,1500,0,0,16951
5/29/2022,23,9666,464,4642,1564,0,0,16336
5/29/2022,24,9671,370,4281,1641,0,0,15963
5/30/2022,1,9673,372,3957,1305,0,0,15307
5/30/2022,2,9666,372,3954,956,0,0,14948
5/30/2022,3,9673,372,3932,775,0,0,14752
5/30/2022,4,9666,372,3942,785,0,0,14765
5/30/2022,5,9673,372,3942,1217,1,0,15205
5/30/2022,6,9681,489,4311,1505,6,0,15992
5/30/2022,7,9682,625,4950,1883,50,0,17190
5/30/2022,8,9674,772,5225,1670,141,0,17482
5/30/2022,9,9660,832,4928,1737,265,0,17422
5/30/2022,10,9661,1113,5038,1650,347,0,17809
5/30/2022,11,9666,1224,5122,1700,394,0,18106
5/30/2022,12,9669,1524,5017,1808,407,0,18425
5/30/2022,13,9666,1844,5070,1835,406,0,18821
5/30/2022,14,9664,1908,5075,2041,389,0,19077
5/30/2022,15,9664,2045,5351,2595,364,0,20019
5/30/2022,16,9648,2310,5307,2515,292,6,20078
5/30/2022,17,9645,2436,6058,2294,195,10,20638
5/30/2022,18,9650,2372,6131,2048,101,10,20312
5/30/2022,19,9654,2495,6225,1927,36,10,20347
5/30/2022,20,9638,2440,6116,1964,6,10,20174
5/30/2022,21,9634,1936,5856,2224,0,10,19660
5/30/2022,22,9642,1575,5260,2155,0,10,18642
5/30/2022,23,9657,671,4753,2478,0,11,17570
5/30/2022,24,9657,374,4304,2343,0,10,16688
5/31/2022,1,9666,375,4003,2548,0,11,16603
5/31/2022,2,9666,372,3869,2570,0,10,16487
5/31/2022,3,9671,373,3848,2166,0,10,16068
5/31/2022,4,9672,384,3878,2027,0,11,15972
5/31/2022,5,9692,385,3856,2217,1,11,16162
5/31/2022,6,9699,591,4287,1755,11,10,16353
5/31/2022,7,9695,1114,5083,1284,58,10,17244
5/31/2022,8,9691,1802,4986,1202,170,10,17861
5/31/2022,9,9689,2229,5250,1335,283,10,18796
5/31/2022,10,9680,2405,5520,1091,338,10,19044
5/31/2022,11,9680,2668,5443,1098,361,10,19260
5/31/2022,12,9667,2730,5469,1637,395,10,19908
5/31/2022,13,9645,2780,5326,2120,329,11,20211
5/31/2022,14,9642,2760,5532,2582,315,21,20852
5/31/2022,15,9638,2763,5498,2608,287,22,20816
5/31/2022,16,9630,2798,5413,2740,268,22,20871
5/31/2022,17,9638,2894,5912,2603,194,22,21263
5/31/2022,18,9646,3093,6005,2158,100,21,21023
5/31/2022,19,9650,3512,5970,1627,32,21,20812
5/31/2022,20,9642,3633,5942,1342,3,21,20583
5/31/2022,21,9641,3738,6012,1098,0,20,20509
5/31/2022,22,9630,3002,5721,1135,0,14,19502
5/31/2022,23,9640,1619,5137,1315,0,10,17721
5/31/2022,24,9655,786,4595,1597,0,10,16643
6/1/2022,1,9661,462,4549,1867,0,10,16549
6/1/2022,2,9658,370,4407,2048,0,10,16493
6/1/2022,3,9649,377,4555,2018,0,10,16609
6/1/2022,4,9651,490,4811,1937,0,10,16899
6/1/2022,5,9654,699,4891,1864,0,10,17118
6/1/2022,6,9665,982,4488,1968,3,10,17116
6/1/2022,7,9657,1130,5322,1862,32,10,18013
6/1/2022,8,9657,1282,5915,1515,85,10,18464
6/1/2022,9,9649,1652,5967,1191,127,10,18596
6/1/2022,10,9644,2078,5405,1053,174,10,18364
6/1/2022,11,9642,2423,5311,845,210,10,18441
6/1/2022,12,9642,2382,5432,1341,169,10,18976
6/1/2022,13,9638,2292,5085,1607,80,11,18713
6/1/2022,14,9625,2243,5256,1298,168,11,18601
6/1/2022,15,9613,2244,5227,1613,116,17,18830
6/1/2022,16,9619,2246,5417,1699,85,23,19089
6/1/2022,17,9630,2242,5494,1328,130,23,18847
6/1/2022,18,9637,2248,5672,1097,52,23,18729
6/1/2022,19,9636,2249,5445,1022,21,23,18396
6/1/2022,20,9636,1666,5616,946,5,23,17892
6/1/2022,21,9645,1402,5797,1009,0,24,17877
6/1/2022,22,9659,1051,5725,1049,0,16,17500
6/1/2022,23,9657,540,5157,1215,0,11,16580
6/1/2022,24,9657,373,4823,1182,0,11,16046
6/2/2022,1,9656,374,4298,944,0,11,15283
6/2/2022,2,9658,394,4237,1042,0,11,15342
6/2/2022,3,9666,401,4272,798,0,11,15148
6/2/2022,4,9661,410,4181,734,1,11,14998
6/2/2022,5,9658,668,4156,591,2,11,15086
6/2/2022,6,9653,792,4445,681,15,11,15597
6/2/2022,7,9660,932,4980,471,57,11,16111
6/2/2022,8,9650,948,5521,239,131,11,16500
6/2/2022,9,9652,1087,5646,159,172,10,16726
6/2/2022,10,9649,1228,5611,191,194,10,16883
6/2/2022,11,9649,1223,5701,252,233,10,17068
6/2/2022,12,9646,1249,5552,312,211,10,16980
6/2/2022,13,9643,1246,5555,337,209,10,17000
6/2/2022,14,9626,1249,5525,301,239,10,16950
6/2/2022,15,9630,1252,5465,240,212,19,16818
6/2/2022,16,9627,1252,5240,290,195,23,16627
6/2/2022,17,9623,1308,5292,319,177,23,16742
6/2/2022,18,9626,1444,5307,204,96,23,16700
6/2/2022,19,9628,1098,5870,381,33,23,17033
6/2/2022,20,9636,1114,6208,316,7,23,17304
6/2/2022,21,9646,1060,6111,436,0,23,17276
6/2/2022,22,9646,573,5913,471,0,16,16619
6/2/2022,23,9648,389,5542,514,0,10,16103
6/2/2022,24,9638,375,4868,628,0,10,15519
6/3/2022,1,9646,373,4149,693,0,10,14871
6/3/2022,2,9647,371,4096,618,0,10,14742
6/3/2022,3,9649,372,4025,509,0,10,14565
6/3/2022,4,9659,371,4098,404,0,10,14542
6/3/2022,5,9658,372,4345,366,1,10,14752
6/3/2022,6,9645,370,4558,300,12,10,14895
6/3/2022,7,9640,371,5181,327,70,10,15599
6/3/2022,8,9639,372,5603,142,173,10,15939
6/3/2022,9,9618,380,5753,125,282,10,16168
6/3/2022,10,9615,373,5510,287,345,10,16140
6/3/2022,11,9593,483,5468,599,355,10,16508
6/3/2022,12,9440,597,5260,634,319,10,16260
6/3/2022,13,9534,714,5422,1044,237,11,16962
6/3/2022,14,9599,717,5300,1753,239,11,17619
6/3/2022,15,9603,717,5198,1905,205,17,17645
6/3/2022,16,9615,721,5317,1849,181,23,17706
6/3/2022,17,9627,730,5304,1931,147,24,17763
6/3/2022,18,9628,729,5319,1511,90,24,17301
6/3/2022,19,9631,736,5119,1830,28,24,17368
6/3/2022,20,9629,719,5088,1960,6,24,17426
6/3/2022,21,9632,512,5054,2398,0,23,17619
6/3/2022,22,9626,369,4662,2314,0,13,16984
6/3/2022,23,9630,368,3967,2209,0,11,16185
6/3/2022,24,9631,368,3878,1266,0,10,15153
6/4/2022,1,9637,209,3812,817,0,1,14476
6/4/2022,2,9640,131,3796,554,0,0,14121
6/4/2022,3,9417,132,3810,353,0,0,13712
6/4/2022,4,9354,131,3806,608,0,0,13899
6/4/2022,5,9357,130,3849,495,1,0,13832
6/4/2022,6,9343,131,4014,523,13,0,14024
6/4/2022,7,9384,131,4504,472,69,0,14560
6/4/2022,8,9614,131,4419,423,186,0,14773
6/4/2022,9,9622,132,4482,504,306,0,15046
6/4/2022,10,9647,131,4343,617,379,0,15117
6/4/2022,11,9647,132,4568,802,402,0,15551
6/4/2022,12,9635,134,4405,1039,403,0,15616
6/4/2022,13,9628,247,4241,960,386,0,15462
6/4/2022,14,9625,359,4149,868,373,0,15374
6/4/2022,15,9626,483,4216,760,382,0,15467
6/4/2022,16,9623,483,4562,915,327,0,15910
6/4/2022,17,9621,487,4973,1166,233,0,16480
6/4/2022,18,9627,489,4994,1129,116,0,16355
6/4/2022,19,9629,484,5106,945,31,0,16195
6/4/2022,20,9611,483,5156,668,8,0,15926
6/4/2022,21,9616,416,5140,680,0,0,15852
6/4/2022,22,9621,376,5215,714,0,0,15926
6/4/2022,23,9630,240,4752,866,0,0,15488
6/4/2022,24,9637,141,4064,746,0,0,14588
6/5/2022,1,9643,141,3883,433,0,0,14100
6/5/2022,2,9405,140,3869,313,0,0,13727
6/5/2022,3,9112,138,3811,361,0,0,13422
6/5/2022,4,8810,140,3903,501,1,0,13355
6/5/2022,5,8743,137,3885,592,3,0,13360
6/5/2022,6,8754,136,3946,550,15,0,13401
6/5/2022,7,8752,137,4240,549,66,0,13744
6/5/2022,8,8753,137,4798,389,177,0,14254
6/5/2022,9,9152,137,4679,521,277,0,14766
6/5/2022,10,9462,138,4558,521,368,0,15047
6/5/2022,11,9627,138,4732,449,386,0,15332
6/5/2022,12,9618,234,5112,495,360,0,15819
6/5/2022,13,9624,431,5237,438,314,0,16044
6/5/2022,14,9617,688,4974,389,319,0,15987
6/5/2022,15,9614,686,4480,471,262,0,15513
6/5/2022,16,9611,482,4693,789,199,0,15774
6/5/2022,17,9609,484,4895,828,147,0,15963
6/5/2022,18,9611,485,5073,914,72,0,16155
6/5/2022,19,9614,484,5067,1020,27,0,16212
6/5/2022,20,9614,484,5007,741,5,0,15851
6/5/2022,21,9611,288,5464,1110,0,0,16473
6/5/2022,22,9621,134,4932,1253,0,6,15946
6/5/2022,23,9619,133,4508,1310,0,11,15581
6/5/2022,24,9617,133,3979,994,0,11,14734
6/6/2022,1,9624,131,3889,750,0,14,14408
6/6/2022,2,9631,131,3844,633,0,11,14250
6/6/2022,3,9569,131,3835,310,0,11,13856
6/6/2022,4,9341,131,3891,540,0,11,13914
6/6/2022,5,9339,131,3945,1051,2,11,14479
6/6/2022,6,9554,232,4043,1450,10,11,15300
6/6/2022,7,9627,350,4579,1617,49,11,16233
6/6/2022,8,9614,474,4766,1547,102,11,16514
6/6/2022,9,9627,477,4923,1467,146,11,16651
6/6/2022,10,9624,478,5602,1363,158,11,17236
6/6/2022,11,9630,480,5594,1491,210,11,17416
6/6/2022,12,9629,480,5134,1710,199,11,17163
6/6/2022,13,9632,480,5068,1824,225,9,17238
6/6/2022,14,9630,500,5118,1712,238,13,17211
6/6/2022,15,9622,529,5549,1335,143,13,17191
6/6/2022,16,9638,617,5817,1106,99,16,17293
6/6/2022,17,9636,719,5627,1090,83,37,17192
6/6/2022,18,9640,697,5110,1265,41,37,16790
6/6/2022,19,9641,697,4910,1296,12,34,16590
6/6/2022,20,9643,479,5000,1235,0,27,16384
6/6/2022,21,9637,166,5175,1804,0,25,16807
6/6/2022,22,9633,134,4791,1846,0,16,16420
6/6/2022,23,9635,136,4239,1962,0,11,15983
6/6/2022,24,9640,135,3866,1640,0,11,15292
6/7/2022,1,9631,137,3758,1251,0,11,14788
6/7/2022,2,9636,142,3734,1030,0,11,14553
6/7/2022,3,9649,159,3728,767,0,11,14314
6/7/2022,4,9652,164,3710,903,0,11,14440
6/7/2022,5,9647,232,3739,1104,0,11,14733
6/7/2022,6,9646,320,3866,1515,6,11,15364
6/7/2022,7,9642,415,4585,1498,26,11,16177
6/7/2022,8,9638,439,4903,1887,40,11,16918
6/7/2022,9,9634,449,5018,1719,53,11,16884
6/7/2022,10,9626,488,5442,1880,62,11,17509
6/7/2022,11,9617,512,5369,2003,78,11,17590
6/7/2022,12,9630,512,5286,1917,94,11,17450
6/7/2022,13,9622,588,4964,1709,82,11,16976
6/7/2022,14,9620,573,5230,1610,104,11,17148
6/7/2022,15,9623,594,5198,1461,98,18,16992
6/7/2022,16,9637,630,5010,1313,144,23,16757
6/7/2022,17,9631,632,5096,1426,117,23,16925
6/7/2022,18,9641,632,5260,1214,68,23,16838
6/7/2022,19,9641,645,5473,951,28,23,16761
6/7/2022,20,9632,799,5854,663,8,23,16979
6/7/2022,21,9633,659,5641,624,0,23,16580
6/7/2022,22,9643,297,5086,626,0,17,15669
6/7/2022,23,9659,139,4465,615,0,11,14889
6/7/2022,24,9667,160,4133,678,0,11,14649
6/8/2022,1,9668,164,4323,702,0,11,14868
6/8/2022,2,9670,164,3915,697,0,11,14457
6/8/2022,3,9672,229,3940,606,0,11,14458
6/8/2022,4,9674,318,3728,613,0,11,14344
6/8/2022,5,9673,400,4149,502,2,11,14737
6/8/2022,6,9674,405,4401,346,9,11,14846
6/8/2022,7,9671,424,5077,218,67,11,15468
6/8/2022,8,9668,496,5485,108,187,11,15955
6/8/2022,9,9664,648,5466,87,305,11,16181
6/8/2022,10,9661,623,5241,84,348,10,15967
6/8/2022,11,9666,511,5053,171,353,10,15764
6/8/2022,12,9655,429,4996,427,342,11,15860
6/8/2022,13,9648,336,5142,360,330,11,15827
6/8/2022,14,9654,376,5163,239,316,11,15759
6/8/2022,15,9664,455,5312,285,284,20,16020
6/8/2022,16,9664,477,5553,276,213,23,16206
6/8/2022,17,9670,486,5561,320,141,23,16201
6/8/2022,18,9681,502,5181,314,71,23,15772
6/8/2022,19,9683,627,5012,227,23,23,15595
6/8/2022,20,9687,613,5645,323,4,23,16295
6/8/2022,21,9687,601,5414,478,0,23,16203
6/8/2022,22,9700,419,5183,613,0,16,15931
6/8/2022,23,9713,173,4511,751,0,10,15158
6/8/2022,24,9716,143,4080,843,0,10,14792
6/9/2022,1,9716,143,3920,743,0,10,14532
6/9/2022,2,9713,142,3880,792,0,10,14537
6/9/2022,3,9700,141,3645,910,0,10,14406
6/9/2022,4,9705,144,3657,842,0,10,14358
6/9/2022,5,9705,141,3729,977,1,10,14563
6/9/2022,6,9701,141,3874,841,3,10,14570
6/9/2022,7,9695,141,4462,521,25,11,14855
6/9/2022,8,9696,141,4547,579,58,22,15043
6/9/2022,9,9688,161,4319,849,126,17,15160
6/9/2022,10,9684,165,4380,703,161,11,15104
6/9/2022,11,9694,167,4413,793,230,11,15308
6/9/2022,12,9693,169,4347,613,272,11,15105
6/9/2022,13,9693,255,4415,1166,273,11,15813
6/9/2022,14,9697,280,4314,991,238,11,15531
6/9/2022,15,9697,302,4240,1123,238,21,15621
6/9/2022,16,9699,361,4246,1385,237,20,15948
6/9/2022,17,9701,366,4409,1675,196,21,16368
6/9/2022,18,9698,377,4697,1686,110,23,16591
6/9/2022,19,9699,696,5143,1544,30,22,17134
6/9/2022,20,9691,662,5498,1434,3,23,17311
6/9/2022,21,9679,710,5881,790,0,22,17082
6/9/2022,22,9673,576,5522,669,0,16,16456
6/9/2022,23,9673,146,4374,676,0,10,14879
6/9/2022,24,9668,131,3820,546,0,10,14175
6/10/2022,1,9671,132,3717,680,0,10,14210
6/10/2022,2,9675,132,3567,963,0,10,14347
6/10/2022,3,9674,133,3467,918,0,10,14202
6/10/2022,4,9688,133,3509,903,1,10,14244
6/10/2022,5,9687,232,3655,1007,1,10,14592
6/10/2022,6,9682,357,3857,749,10,10,14665
6/10/2022,7,9676,503,4909,509,61,10,15668
6/10/2022,8,9672,519,5552,332,153,10,16238
6/10/2022,9,9674,530,5506,263,253,10,16236
6/10/2022,10,9624,562,5436,299,314,10,16245
6/10/2022,11,9616,632,4928,393,379,10,15958
6/10/2022,12,9677,686,4997,527,357,10,16254
6/10/2022,13,9681,526,4841,497,378,10,15933
6/10/2022,14,9519,439,5046,869,351,10,16234
6/10/2022,15,9494,647,5093,861,341,19,16455
6/10/2022,16,9670,718,5213,662,305,23,16591
6/10/2022,17,9678,787,5337,1084,226,23,17135
6/10/2022,18,9675,631,5475,838,113,24,16756
6/10/2022,19,9670,576,5606,913,28,23,16816
6/10/2022,20,9672,395,5311,1004,6,24,16412
6/10/2022,21,9667,359,5322,951,1,23,16323
6/10/2022,22,9663,359,5297,869,0,10,16198
6/10/2022,23,9652,224,4777,766,0,11,15430
6/10/2022,24,9648,131,4118,612,0,11,14520
6/11/2022,1,9642,131,3837,546,0,1,14157
6/11/2022,2,9646,131,3654,563,0,0,13994
6/11/2022,3,9647,131,3616,340,0,0,13734
6/11/2022,4,9645,131,3568,269,1,0,13614
6/11/2022,5,9650,131,3689,446,3,0,13919
6/11/2022,6,9651,131,3688,587,14,0,14071
6/11/2022,7,9650,130,4349,255,63,0,14447
6/11/2022,8,9644,131,5032,395,156,0,15358
6/11/2022,9,9637,130,5432,328,271,0,15798
6/11/2022,10,9642,130,5093,311,357,0,15533
6/11/2022,11,9652,130,5162,375,394,0,15713
6/11/2022,12,9636,131,5461,537,381,0,16146
6/11/2022,13,9632,219,5141,833,351,0,16176
6/11/2022,14,9630,286,4965,1000,373,0,16254
6/11/2022,15,9633,357,4801,1034,368,0,16193
6/11/2022,16,9637,357,4862,1256,278,0,16390
6/11/2022,17,9644,358,5014,1449,194,0,16659
6/11/2022,18,9645,359,5249,1307,105,0,16665
6/11/2022,19,9640,360,5590,1227,30,0,16847
6/11/2022,20,9641,361,5612,1233,5,0,16852
6/11/2022,21,9636,360,5828,1103,0,0,16927
6/11/2022,22,9636,222,5539,1005,0,0,16402
6/11/2022,23,9637,130,4719,1190,0,0,15676
6/11/2022,24,9636,130,4052,1135,0,0,14953
6/12/2022,1,9631,130,3869,781,0,0,14411
6/12/2022,2,9631,130,3727,500,0,0,13988
6/12/2022,3,9634,130,3676,420,0,0,13860
6/12/2022,4,9635,130,3626,379,0,0,13770
6/12/2022,5,9396,130,3641,294,2,0,13463
6/12/2022,6,9344,129,3550,704,6,0,13733
6/12/2022,7,9346,130,3730,776,39,0,14021
6/12/2022,8,9595,130,4052,981,63,0,14821
6/12/2022,9,9619,130,4855,720,116,0,15440
6/12/2022,10,9619,131,5185,694,202,0,15831
6/12/2022,11,9624,131,5354,772,217,0,16098
6/12/2022,12,9615,131,5495,669,273,0,16183
6/12/2022,13,9617,218,5371,792,268,0,16266
6/12/2022,14,9617,285,5151,938,198,0,16189
6/12/2022,15,9622,353,5234,933,172,0,16314
6/12/2022,16,9613,354,5490,851,200,0,16508
6/12/2022,17,9608,365,5865,736,107,0,16681
6/12/2022,18,9611,359,5840,707,67,0,16584
6/12/2022,19,9606,358,5427,729,36,0,16156
6/12/2022,20,9597,357,5591,696,8,0,16249
6/12/2022,21,9608,353,5612,656,1,3,16233
6/12/2022,22,9615,214,5701,644,0,10,16184
6/12/2022,23,9621,127,5252,679,0,10,15689
6/12/2022,24,9616,130,4448,469,0,11,14674
6/13/2022,1,9622,130,3924,401,0,11,14088
6/13/2022,2,9620,142,3874,267,0,11,13914
6/13/2022,3,9380,189,3918,237,0,11,13735
6/13/2022,4,9337,242,3993,220,1,11,13804
6/13/2022,5,9337,403,4125,233,2,11,14111
6/13/2022,6,9337,700,4580,225,15,11,14868
6/13/2022,7,9485,1111,4607,229,71,11,15514
6/13/2022,8,9623,1175,4709,92,176,11,15786
6/13/2022,9,9625,1327,4683,53,274,11,15973
6/13/2022,10,9621,1606,4653,46,190,11,16127
6/13/2022,11,9622,1668,4483,68,366,10,16217
6/13/2022,12,9604,1783,4475,94,363,11,16330
6/13/2022,13,9587,1953,4496,56,63,11,16166
6/13/2022,14,9580,1620,4527,122,274,11,16134
6/13/2022,15,9586,1602,4547,300,315,19,16369
6/13/2022,16,9585,1740,4830,392,227,23,16797
6/13/2022,17,9581,1916,5052,274,155,23,17001
6/13/2022,18,9592,1904,5185,282,106,23,17092
6/13/2022,19,9607,1881,5262,353,38,23,17164
6/13/2022,20,9618,1660,4831,705,9,23,16846
6/13/2022,21,9620,1180,5213,766,1,23,16803
6/13/2022,22,9624,868,4476,989,1,15,15973
6/13/2022,23,9625,319,4325,1162,1,11,15443
6/13/2022,24,9620,150,4562,775,1,10,15118
6/14/2022,1,9624,143,4486,978,1,11,15243
6/14/2022,2,9617,135,3829,1224,1,11,14817
6/14/2022,3,9621,150,3744,1093,0,12,14620
6/14/2022,4,9624,159,4042,754,1,12,14592
6/14/2022,5,9624,269,4105,823,1,10,14832
6/14/2022,6,9625,648,4057,570,11,10,14921
6/14/2022,7,9619,1134,4543,327,67,10,15700
6/14/2022,8,9609,1305,4769,419,184,10,16296
6/14/2022,9,9599,1375,4869,356,287,11,16497
6/14/2022,10,9598,1538,4859,347,361,11,16714
6/14/2022,11,9596,1857,4529,457,393,14,16846
6/14/2022,12,9584,2208,4559,519,383,13,17266
6/14/2022,13,9584,2211,4471,223,326,10,16825
6/14/2022,14,9592,2261,4691,386,366,12,17308
6/14/2022,15,9596,2360,4628,485,314,21,17404
6/14/2022,16,9601,2424,4833,749,308,23,17938
6/14/2022,17,9590,3077,5068,788,218,23,18764
6/14/2022,18,9591,3388,4982,618,119,23,18721
6/14/2022,19,9594,3022,5295,621,33,23,18588
6/14/2022,20,9600,2387,5159,907,7,23,18083
6/14/2022,21,9597,2129,4691,1300,0,22,17739
6/14/2022,22,9594,1477,4304,1286,0,16,16677
6/14/2022,23,9570,492,4180,1613,0,11,15866
6/14/2022,24,9568,222,3993,1454,0,11,15248
6/15/2022,1,9566,187,3784,1398,0,10,14945
6/15/2022,2,9565,146,3513,1721,0,11,14956
6/15/2022,3,9585,170,3509,1634,0,11,14909
6/15/2022,4,9594,216,3482,1619,0,10,14921
6/15/2022,5,9605,564,3515,1302,2,10,14998
6/15/2022,6,9617,896,3820,1184,8,10,15535
6/15/2022,7,9621,1292,4080,1327,39,10,16369
6/15/2022,8,9624,1553,4626,1204,139,9,17155
6/15/2022,9,9622,1871,4748,788,218,9,17256
6/15/2022,10,9619,2000,4513,751,237,9,17129
6/15/2022,11,9613,2287,4638,609,229,9,17385
6/15/2022,12,9607,2420,4511,645,236,10,17429
6/15/2022,13,9604,2694,4652,779,296,9,18034
6/15/2022,14,9612,2440,4638,924,377,11,18002
6/15/2022,15,9596,2438,4790,1093,364,13,18294
6/15/2022,16,9602,2574,4922,1939,287,22,19346
6/15/2022,17,9611,2676,4898,2220,169,23,19597
6/15/2022,18,9606,2618,4969,2180,99,23,19495
6/15/2022,19,9609,2638,5283,2139,37,23,19729
6/15/2022,20,9599,2352,5158,2218,7,23,19357
6/15/2022,21,9590,1909,5168,2274,0,23,18964
6/15/2022,22,9594,1420,4868,2246,0,23,18151
6/15/2022,23,9592,1276,4241,2218,0,15,17342
6/15/2022,24,9613,669,3724,2251,0,11,16268
6/16/2022,1,9605,320,3769,2402,0,11,16107
6/16/2022,2,9607,163,3953,2371,0,11,16105
6/16/2022,3,9613,167,3625,2542,0,11,15958
6/16/2022,4,9611,208,3413,2676,1,11,15920
6/16/2022,5,9619,332,3518,2391,1,11,15872
6/16/2022,6,9626,519,3845,2190,4,11,16195
6/16/2022,7,9626,791,4658,2319,47,11,17452
6/16/2022,8,9625,1233,4835,2455,123,11,18282
6/16/2022,9,9632,1685,4844,2375,218,11,18765
6/16/2022,10,9631,1978,4758,2295,329,11,19002
6/16/2022,11,9622,2260,4942,2999,307,10,20140
6/16/2022,12,9619,2419,4935,3011,367,10,20361
6/16/2022,13,9625,2480,5030,3069,386,11,20601
6/16/2022,14,9627,2490,4541,3103,362,12,20135
6/16/2022,15,9612,2407,4809,3372,271,21,20492
6/16/2022,16,9619,2611,5147,3016,174,31,20598
6/16/2022,17,9627,2946,5228,2727,133,31,20692
6/16/2022,18,9640,2640,4794,2708,107,29,19918
6/16/2022,19,9639,2595,5105,2826,38,29,20232
6/16/2022,20,9638,2220,5565,2721,9,29,20182
6/16/2022,21,9630,2026,5158,3061,0,26,19901
6/16/2022,22,9630,1515,4477,3094,0,23,18739
6/16/2022,23,9631,909,4162,3087,0,14,17803
6/16/2022,24,9630,358,4163,2950,0,11,17112
6/17/2022,1,9629,160,4260,2626,0,11,16686
6/17/2022,2,9634,160,4104,2555,0,11,16464
6/17/2022,3,9644,160,4109,2460,0,11,16384
6/17/2022,4,9652,164,3754,2526,0,11,16107
6/17/2022,5,9655,280,3626,2603,2,10,16176
6/17/2022,6,9658,436,3991,2327,7,11,16430
6/17/2022,7,9654,597,4475,2545,50,11,17332
6/17/2022,8,9647,636,4787,2999,148,10,18227
6/17/2022,9,9649,630,4447,3143,246,10,18125
6/17/2022,10,9638,654,4352,3145,314,11,18114
6/17/2022,11,9640,597,4258,3286,322,13,18116
6/17/2022,12,9648,582,4457,3499,309,11,18506
6/17/2022,13,9658,596,4401,3711,375,11,18752
6/17/2022,14,9660,626,4417,3837,358,11,18909
6/17/2022,15,9652,688,4850,3964,332,19,19505
6/17/2022,16,9662,806,4894,3979,286,24,19651
6/17/2022,17,9665,808,5063,3820,205,23,19584
6/17/2022,18,9667,805,5102,3813,106,23,19516
6/17/2022,19,9672,806,4965,3607,30,23,19103
6/17/2022,20,9676,613,5005,3560,5,23,18882
6/17/2022,21,9676,426,4769,3671,0,23,18565
6/17/2022,22,9672,257,4564,3769,0,15,18277
6/17/2022,23,9674,140,3727,3338,0,10,16889
6/17/2022,24,9674,137,3609,2389,0,7,15816
6/18/2022,1,9686,138,3622,1493,0,0,14939
6/18/2022,2,9694,137,3554,1111,0,0,14496
6/18/2022,3,9694,137,3544,994,0,0,14369
6/18/2022,4,9703,138,3481,895,0,0,14217
6/18/2022,5,9708,138,3505,971,1,0,14323
6/18/2022,6,9724,138,3534,1095,11,0,14502
6/18/2022,7,9722,137,3599,1403,54,0,14915
6/18/2022,8,9720,137,3568,1982,158,0,15565
6/18/2022,9,9720,137,3598,2135,270,0,15860
6/18/2022,10,9717,136,3620,2185,367,0,16025
6/18/2022,11,9716,136,3664,2129,410,0,16055
6/18/2022,12,9710,134,3707,1949,424,0,15924
6/18/2022,13,9720,136,3813,1564,421,0,15654
6/18/2022,14,9723,137,3788,1333,426,0,15407
6/18/2022,15,9718,135,3748,1231,420,0,15252
6/18/2022,16,9713,138,3790,1703,373,0,15717
6/18/2022,17,9711,136,3968,2235,270,0,16320
6/18/2022,18,9715,137,4240,2635,139,0,16866
6/18/2022,19,9725,137,4471,2732,34,0,17099
6/18/2022,20,9717,135,4801,2234,7,0,16894
6/18/2022,21,9711,136,4956,2118,1,0,16922
6/18/2022,22,9716,138,4322,1999,0,0,16175
6/18/2022,23,9726,138,3864,1819,0,0,15547
6/18/2022,24,9728,138,3580,1417,0,0,14863
6/19/2022,1,9727,138,3495,1189,0,0,14549
6/19/2022,2,9677,137,3471,373,0,0,13658
6/19/2022,3,9437,137,3476,555,0,0,13605
6/19/2022,4,9127,137,3498,758,0,0,13520
6/19/2022,5,8837,136,3472,982,2,0,13429
6/19/2022,6,8847,136,3476,445,14,0,12918
6/19/2022,7,8865,134,4288,690,72,0,14049
6/19/2022,8,9287,133,4664,405,188,0,14677
6/19/2022,9,9713,133,4483,324,301,0,14954
6/19/2022,10,9729,134,4507,324,371,0,15065
6/19/2022,11,9730,221,4221,445,400,0,15017
6/19/2022,12,9731,245,3930,636,415,0,14957
6/19/2022,13,9732,294,4119,654,412,0,15211
6/19/2022,14,9733,355,4197,623,406,0,15314
6/19/2022,15,9732,360,4429,860,376,0,15757
6/19/2022,16,9734,363,4643,770,321,0,15831
6/19/2022,17,9737,363,5014,631,179,0,15924
6/19/2022,18,9737,364,4956,399,97,0,15553
6/19/2022,19,9730,367,5185,358,33,0,15673
6/19/2022,20,9728,384,5542,349,6,0,16009
6/19/2022,21,9732,257,5674,344,1,1,16009
6/19/2022,22,9729,214,5572,396,0,13,15924
6/19/2022,23,9724,160,4774,547,0,12,15217
6/19/2022,24,9730,163,4414,551,0,11,14869
6/20/2022,1,9736,164,4229,507,0,12,14648
6/20/2022,2,9734,165,3843,586,0,11,14339
6/20/2022,3,9730,165,3673,636,0,11,14215
6/20/2022,4,9733,166,3913,647,0,11,14470
6/20/2022,5,9736,262,3968,647,0,11,14624
6/20/2022,6,9734,385,3991,687,8,14,14819
6/20/2022,7,9734,511,4358,656,46,11,15316
6/20/2022,8,9734,519,4573,692,133,10,15661
6/20/2022,9,9729,579,4870,649,235,11,16073
6/20/2022,10,9729,613,4975,841,309,12,16479
6/20/2022,11,9723,681,5167,894,332,12,16809
6/20/2022,12,9720,766,4660,1076,316,10,16548
6/20/2022,13,9724,692,4290,1157,288,10,16161
6/20/2022,14,9724,764,4537,1192,234,11,16462
6/20/2022,15,9723,1044,4239,1281,231,17,16535
6/20/2022,16,9726,1108,4119,1423,211,24,16611
6/20/2022,17,9724,1187,4437,1392,187,24,16951
6/20/2022,18,9729,1192,4795,1181,112,25,17034
6/20/2022,19,9728,1193,4979,1222,37,24,17183
6/20/2022,20,9726,1193,5352,1223,9,25,17528
6/20/2022,21,9726,564,5271,1507,0,23,17091
6/20/2022,22,9717,388,4414,1864,0,15,16398
6/20/2022,23,9716,252,3829,1970,0,11,15778
6/20/2022,24,9717,162,3481,2000,0,12,15372
6/21/2022,1,9725,165,3422,2034,0,15,15361
6/21/2022,2,9728,168,3509,2086,0,11,15502
6/21/2022,3,9727,196,3489,1891,0,11,15314
6/21/2022,4,9722,198,3378,2021,0,11,15330
6/21/2022,5,9723,239,3383,1775,1,11,15132
6/21/2022,6,9725,397,3502,1465,6,11,15106
6/21/2022,7,9726,596,4206,1417,51,11,16007
6/21/2022,8,9725,1202,4809,1276,140,11,17163
6/21/2022,9,9719,1470,4824,1078,199,11,17301
6/21/2022,10,9720,2069,4886,921,236,11,17843
6/21/2022,11,9720,2516,4989,777,292,11,18305
6/21/2022,12,9717,2688,4924,943,306,11,18589
6/21/2022,13,9712,2576,4436,1577,346,11,18658
6/21/2022,14,9703,2981,4448,2283,330,12,19757
6/21/2022,15,9703,3129,4751,2472,330,18,20403
6/21/2022,16,9696,3350,5133,2535,328,25,21067
6/21/2022,17,9698,4082,5298,2194,224,33,21529
6/21/2022,18,9699,3939,5307,1770,113,36,20864
6/21/2022,19,9697,4013,5417,1500,39,34,20700
6/21/2022,20,9706,3724,5362,1470,8,24,20294
6/21/2022,21,9696,3747,5299,1571,1,24,20338
6/21/2022,22,9703,3107,4987,1829,0,13,19639
6/21/2022,23,9703,1436,4550,2211,0,11,17911
6/21/2022,24,9707,663,4150,2296,0,11,16827
6/22/2022,1,9709,259,4085,2487,0,11,16551
6/22/2022,2,9706,171,4168,2448,0,11,16504
6/22/2022,3,9702,211,4503,2225,0,11,16652
6/22/2022,4,9705,443,4545,1880,1,11,16585
6/22/2022,5,9704,1058,3890,1834,1,11,16498
6/22/2022,6,9702,1642,4019,1497,9,11,16880
6/22/2022,7,9698,2356,4449,1204,54,11,17772
6/22/2022,8,9695,2990,5204,985,144,12,19030
6/22/2022,9,9687,3321,5164,952,253,11,19388
6/22/2022,10,9685,2983,5214,1146,341,12,19381
6/22/2022,11,9690,3493,5233,1138,352,18,19924
6/22/2022,12,9687,3632,5402,1255,347,31,20354
6/22/2022,13,9680,3888,5452,1361,341,33,20755
6/22/2022,14,9679,4236,5536,1419,370,32,21272
6/22/2022,15,9673,4130,5525,1362,372,39,21101
6/22/2022,16,9680,4151,5560,1426,308,40,21165
6/22/2022,17,9314,4419,5572,1675,234,37,21251
6/22/2022,18,8792,4720,5607,1996,131,33,21279
6/22/2022,19,8797,4270,5642,2125,40,30,20904
6/22/2022,20,8803,4287,5399,1897,8,26,20420
6/22/2022,21,8807,4147,5328,2004,0,24,20310
6/22/2022,22,8804,3178,5311,2026,0,17,19336
6/22/2022,23,8808,1889,4631,2126,0,12,17466
6/22/2022,24,8805,579,4342,2248,0,11,15985
6/23/2022,1,8811,192,4144,2158,0,11,15316
6/23/2022,2,8817,166,4335,2057,0,11,15386
6/23/2022,3,8818,159,4407,1893,0,11,15288
6/23/2022,4,8819,163,4457,1716,0,11,15166
6/23/2022,5,8821,268,4114,1583,2,12,14800
6/23/2022,6,8821,751,3879,1272,8,11,14742
6/23/2022,7,8823,1809,4249,1095,53,11,16040
6/23/2022,8,8822,2524,4122,822,172,11,16473
6/23/2022,9,8816,2899,4521,506,278,11,17031
6/23/2022,10,8817,3154,4481,462,344,10,17268
6/23/2022,11,8811,3514,4436,669,349,11,17790
6/23/2022,12,8820,3521,4599,836,380,10,18166
6/23/2022,13,8818,3276,4538,1140,364,11,18147
6/23/2022,14,8818,3289,4660,1148,393,12,18320
6/23/2022,15,8804,3465,4770,1154,358,20,18571
6/23/2022,16,8801,4306,4776,1069,314,23,19289
6/23/2022,17,8801,4655,5181,954,214,24,19829
6/23/2022,18,8813,4479,5472,773,113,23,19673
6/23/2022,19,8812,4778,5442,580,37,24,19673
6/23/2022,20,8810,4556,5122,489,8,24,19009
6/23/2022,21,8809,3900,5047,462,0,24,18242
6/23/2022,22,8814,3394,4695,458,0,18,17379
6/23/2022,23,8817,2017,4471,473,0,11,15789
6/23/2022,24,8827,1237,4413,479,0,11,14967
6/24/2022,1,8822,834,4431,359,0,11,14457
6/24/2022,2,8822,941,4314,245,0,11,14333
6/24/2022,3,8827,1021,4405,132,0,11,14396
6/24/2022,4,8830,1028,4351,54,0,11,14274
6/24/2022,5,8829,1000,4182,57,1,11,14080
6/24/2022,6,8831,1301,3928,83,8,11,14162
6/24/2022,7,8826,1960,4209,57,48,11,15111
6/24/2022,8,8820,2424,4532,55,166,11,16008
6/24/2022,9,8823,2713,4784,48,271,11,16650
6/24/2022,10,8817,2697,4870,178,348,12,16922
6/24/2022,11,8810,3091,4741,260,385,11,17298
6/24/2022,12,8809,3336,4715,397,399,12,17668
6/24/2022,13,8799,3585,4608,493,397,10,17892
6/24/2022,14,8788,3933,4801,567,403,11,18503
6/24/2022,15,8787,4061,4985,608,375,17,18833
6/24/2022,16,8782,4633,5024,481,314,41,19275
6/24/2022,17,8784,5195,5342,367,238,77,20003
6/24/2022,18,8797,5077,5610,329,122,131,20066
6/24/2022,19,8806,5236,5559,291,37,160,20089
6/24/2022,20,8809,5028,5280,372,8,168,19665
6/24/2022,21,8805,4108,5154,548,1,119,18735
6/24/2022,22,8807,3854,4479,701,0,84,17925
6/24/2022,23,8816,2676,4315,747,0,74,16628
6/24/2022,24,8823,1732,3968,759,0,19,15301
6/25/2022,1,8820,990,4058,772,0,0,14640
6/25/2022,2,8826,890,3981,675,0,0,14372
6/25/2022,3,8831,1094,3928,612,0,0,14465
6/25/2022,4,8830,1157,3863,594,0,0,14444
6/25/2022,5,8834,1094,3851,539,2,0,14320
6/25/2022,6,8826,1360,3663,449,8,0,14306
6/25/2022,7,8812,1452,4008,358,59,0,14689
6/25/2022,8,8810,1758,4320,185,169,0,15242
6/25/2022,9,8805,2481,4471,153,280,0,16190
6/25/2022,10,8807,3107,4362,209,354,0,16839
6/25/2022,11,8809,3797,4458,185,396,0,17645
6/25/2022,12,8815,4260,4481,253,414,0,18223
6/25/2022,13,8820,4288,4340,365,416,12,18241
6/25/2022,14,8821,4569,4618,393,401,46,18848
6/25/2022,15,8821,4903,4873,382,366,58,19403
6/25/2022,16,8821,4788,5000,496,291,57,19453
6/25/2022,17,8823,5071,5077,520,228,61,19780
6/25/2022,18,8821,4968,5085,532,115,57,19578
6/25/2022,19,8816,4993,5134,538,45,53,19579
6/25/2022,20,8803,4569,4865,596,11,12,18856
6/25/2022,21,8805,4116,4723,889,0,0,18533
6/25/2022,22,8797,3751,4260,1298,0,0,18106
6/25/2022,23,8800,2394,4061,1422,0,0,16677
6/25/2022,24,8813,1199,4083,1634,0,0,15729
6/26/2022,1,8809,712,4050,1661,0,1,15233
6/26/2022,2,8815,582,4043,1726,0,1,15167
6/26/2022,3,8816,521,4177,1499,0,0,15013
6/26/2022,4,8811,505,4085,1356,0,0,14757
6/26/2022,5,8804,253,3962,1479,1,0,14499
6/26/2022,6,8804,216,3789,1516,5,0,14330
6/26/2022,7,8798,213,4130,1078,44,0,14263
6/26/2022,8,8782,449,4391,1009,84,0,14715
6/26/2022,9,8779,898,4380,1013,152,0,15222
6/26/2022,10,8778,1939,4427,972,247,1,16364
6/26/2022,11,8782,3202,4383,977,247,2,17593
6/26/2022,12,8779,3918,4615,1154,220,16,18702
6/26/2022,13,8786,4158,4362,1345,198,48,18897
6/26/2022,14,8785,3929,4890,1390,148,53,19195
6/26/2022,15,8779,3968,4914,1398,172,53,19284
6/26/2022,16,8782,4150,5180,1619,151,53,19935
6/26/2022,17,8779,4504,5219,1754,146,53,20455
6/26/2022,18,8778,4803,5180,1733,98,54,20646
6/26/2022,19,8776,4689,5012,1824,34,57,20392
6/26/2022,20,8763,3982,4754,2393,8,56,19956
6/26/2022,21,8755,3275,4726,2622,1,31,19410
6/26/2022,22,8733,3821,4267,2367,0,0,19188
6/26/2022,23,8746,2641,3984,2062,0,0,17433
6/26/2022,24,8745,1516,3805,2132,0,0,16198
6/27/2022,1,8749,476,3802,2124,0,6,15157
6/27/2022,2,8759,205,3849,1992,0,11,14816
6/27/2022,3,8803,208,4032,1727,0,11,14781
6/27/2022,4,8778,256,4462,1731,0,11,15238
6/27/2022,5,8782,383,3572,1954,1,11,14703
6/27/2022,6,8784,600,3556,2166,13,11,15130
6/27/2022,7,8783,664,3842,2129,62,11,15491
6/27/2022,8,8784,759,3795,2597,160,11,16106
6/27/2022,9,8777,1039,3902,2409,268,11,16406
6/27/2022,10,8780,1425,3851,2384,326,10,16776
6/27/2022,11,8783,1764,3953,2365,337,10,17212
6/27/2022,12,8774,1787,3964,2342,326,10,17203
6/27/2022,13,8776,1797,4299,2335,304,10,17521
6/27/2022,14,8770,1797,4225,2246,305,10,17353
6/27/2022,15,8779,1910,4039,2095,244,20,17087
6/27/2022,16,8778,2059,4333,1957,196,28,17351
6/27/2022,17,8783,2156,4685,1690,163,54,17531
6/27/2022,18,8783,1877,4869,1402,105,54,17090
6/27/2022,19,8780,1813,4576,1364,35,46,16614
6/27/2022,20,8794,1829,4590,1088,8,44,16353
6/27/2022,21,8792,2268,4520,1030,0,35,16645
6/27/2022,22,8789,2258,4220,900,0,30,16197
6/27/2022,23,8788,1558,3886,599,0,27,14858
6/27/2022,24,8783,784,3880,539,0,21,14007
6/28/2022,1,8788,237,3603,428,0,25,13081
6/28/2022,2,8790,175,3626,466,0,28,13085
6/28/2022,3,8788,174,3861,473,0,27,13323
6/28/2022,4,8777,311,4034,561,0,18,13701
6/28/2022,5,8786,520,3511,513,1,19,13350
6/28/2022,6,8798,1093,3553,330,12,25,13811
6/28/2022,7,8802,1388,4066,272,61,26,14615
6/28/2022,8,8852,1730,4086,184,178,25,15055
6/28/2022,9,8852,2009,4064,231,287,25,15468
6/28/2022,10,8870,2229,4115,346,315,21,15896
6/28/2022,11,9045,2406,3949,494,350,17,16261
6/28/2022,12,9035,2244,4029,638,356,17,16319
6/28/2022,13,8981,2273,3701,860,347,15,16177
6/28/2022,14,8968,2386,3656,757,369,15,16151
6/28/2022,15,8962,2417,3811,557,376,25,16148
6/28/2022,16,8961,2593,4020,1056,318,26,16974
6/28/2022,17,8941,2632,4635,1346,234,24,17812
6/28/2022,18,9050,2579,4981,1458,124,25,18217
6/28/2022,19,9165,2587,4811,1368,32,24,17987
6/28/2022,20,9172,2626,4470,1309,7,23,17607
6/28/2022,21,9173,2304,4365,1519,1,23,17385
6/28/2022,22,9319,1324,3934,1808,0,17,16402
6/28/2022,23,9367,489,4178,1730,0,11,15775
6/28/2022,24,9363,245,4145,1517,0,11,15281
6/29/2022,1,9367,199,3891,1444,0,11,14912
6/29/2022,2,9357,178,3414,1290,0,11,14250
6/29/2022,3,9360,180,3278,1212,0,11,14041
6/29/2022,4,9367,193,3338,1251,1,11,14161
6/29/2022,5,9374,249,3324,1135,2,11,14095
6/29/2022,6,9378,401,3563,764,14,11,14131
6/29/2022,7,9372,568,4083,544,60,11,14638
6/29/2022,8,9370,1013,4153,523,112,11,15182
6/29/2022,9,9377,1162,4227,237,166,11,15180
6/29/2022,10,9441,1865,4006,142,212,11,15677
6/29/2022,11,9527,2228,4062,142,179,11,16149
6/29/2022,12,9528,2218,4024,206,215,12,16203
6/29/2022,13,9528,2236,3870,351,259,11,16255
6/29/2022,14,9533,2278,4066,419,244,11,16551
6/29/2022,15,9534,2413,4017,437,253,18,16672
6/29/2022,16,9531,2665,4162,511,273,24,17166
6/29/2022,17,9546,2583,4656,482,199,24,17490
6/29/2022,18,9551,2498,4833,419,99,24,17424
6/29/2022,19,9550,2488,5069,313,30,23,17473
6/29/2022,20,9539,2508,5112,213,9,23,17404
6/29/2022,21,9531,2259,4725,256,0,23,16794
6/29/2022,22,9532,2360,4204,368,0,15,16479
6/29/2022,23,9540,1679,3871,344,0,11,15445
6/29/2022,24,9562,867,3603,598,0,11,14641
6/30/2022,1,9563,746,3349,965,0,11,14634
6/30/2022,2,9566,605,3211,1151,0,11,14544
6/30/2022,3,9575,550,3277,1163,0,11,14576
6/30/2022,4,9581,550,3368,1320,1,11,14831
6/30/2022,5,9581,552,3054,1325,2,11,14525
6/30/2022,6,9589,611,3344,1118,15,11,14688
6/30/2022,7,9591,725,4008,949,58,11,15342
6/30/2022,8,9598,1060,4831,921,124,11,16545
6/30/2022,9,9513,1200,5012,944,191,11,16871
6/30/2022,10,9501,1194,4711,1011,321,11,16749
6/30/2022,11,9494,1598,4414,1254,355,16,17131
6/30/2022,12,9535,1919,4147,1651,366,30,17648
6/30/2022,13,9567,2109,4084,1935,378,58,18131
6/30/2022,14,9582,2185,4067,2039,361,61,18295
6/30/2022,15,9550,2224,4085,2566,346,67,18838
6/30/2022,16,9552,2305,4318,2644,283,73,19175
6/30/2022,17,9544,2443,4756,2715,194,74,19726
6/30/2022,18,9554,2548,5100,2360,115,74,19751
6/30/2022,19,9562,2316,5106,2236,40,75,19335
6/30/2022,20,9566,1909,5047,2257,8,32,18819
6/30/2022,21,9547,1549,4655,2694,1,23,18469
6/30/2022,22,9545,1152,4230,3023,0,14,17964
6/30/2022,23,9548,976,3532,2966,0,11,17033
6/30/2022,24,9551,638,3057,3128,0,11,16385
7/1/2022,1,9550,399,3014,3040,0,11,16014
7/1/2022,2,9563,367,3026,2722,0,12,15690
7/1/2022,3,9563,367,2928,2410,0,18,15286
7/1/2022,4,9566,371,2910,2255,0,36,15138
7/1/2022,5,9565,393,2903,2297,1,36,15195
7/1/2022,6,9570,552,3214,2350,5,35,15726
7/1/2022,7,9569,838,3433,1806,48,27,15721
7/1/2022,8,9559,1477,3900,1334,120,30,16420
7/1/2022,9,9562,1591,4131,1206,181,68,16739
7/1/2022,10,9557,1812,4272,1066,205,76,16988
7/1/2022,11,9549,2289,4362,935,259,76,17470
7/1/2022,12,9535,2229,4291,984,223,76,17338
7/1/2022,13,9532,2191,4296,1124,189,76,17408
7/1/2022,14,9525,2389,4059,1284,305,76,17638
7/1/2022,15,9528,2633,4110,1492,234,76,18073
7/1/2022,16,9533,2744,4096,1571,181,76,18201
7/1/2022,17,9537,2816,4455,1441,126,79,18454
7/1/2022,18,9534,2725,4563,1554,63,77,18516
7/1/2022,19,9532,2696,4415,1360,25,77,18105
7/1/2022,20,9529,2533,4406,1459,5,76,18008
7/1/2022,21,9524,1840,4185,1866,0,77,17492
7/1/2022,22,9524,1239,4275,1737,0,82,16857
7/1/2022,23,9529,770,4045,1560,0,94,15998
7/1/2022,24,9526,719,3849,1341,0,91,15526
7/2/2022,1,9534,628,3634,1237,0,27,15060
7/2/2022,2,9544,585,3456,970,0,21,14576
7/2/2022,3,9551,563,3528,659,0,21,14322
7/2/2022,4,9546,429,3570,665,0,21,14231
7/2/2022,5,9545,364,3309,772,0,21,14011
7/2/2022,6,9547,399,3182,505,9,21,13663
7/2/2022,7,9550,508,3216,521,59,21,13875
7/2/2022,8,9549,763,3677,471,168,26,14654
7/2/2022,9,9539,879,3924,592,278,29,15241
7/2/2022,10,9533,1041,4241,588,361,36,15800
7/2/2022,11,9528,1326,4406,632,407,51,16350
7/2/2022,12,9528,1689,4177,836,411,84,16725
7/2/2022,13,9524,2027,3816,1164,381,85,16997
7/2/2022,14,9516,2379,3763,1497,394,85,17634
7/2/2022,15,9513,2496,3635,1158,360,85,17247
7/2/2022,16,9511,2506,3683,1554,295,85,17634
7/2/2022,17,9511,2507,4000,1539,206,85,17848
7/2/2022,18,9519,2504,4507,1330,131,86,18077
7/2/2022,19,9532,2337,4742,1069,40,86,17806
7/2/2022,20,9545,1936,4474,929,10,86,16980
7/2/2022,21,9541,1490,3947,838,0,86,15902
7/2/2022,22,9544,1204,3873,906,0,86,15613
7/2/2022,23,9550,1023,3788,832,0,86,15279
7/2/2022,24,9550,782,3726,926,0,47,15031
7/3/2022,1,9553,563,3444,1167,0,26,14753
7/3/2022,2,9556,234,3428,942,0,22,14182
7/3/2022,3,9557,153,3648,829,0,22,14209
7/3/2022,4,9569,153,3569,789,1,22,14103
7/3/2022,5,9566,165,3362,698,2,22,13815
7/3/2022,6,9567,172,3484,576,8,22,13829
7/3/2022,7,9569,271,3662,334,58,26,13920
7/3/2022,8,9568,587,3896,128,172,31,14382
7/3/2022,9,9563,796,3702,54,248,33,14396
7/3/2022,10,9560,1192,3737,18,295,33,14835
7/3/2022,11,9544,1470,4236,140,406,46,15842
7/3/2022,12,9535,1813,4031,205,415,78,16077
7/3/2022,13,9523,2189,3567,246,398,85,16008
7/3/2022,14,9524,2393,3623,147,239,85,16011
7/3/2022,15,9527,2484,3674,493,386,85,16649
7/3/2022,16,9531,2497,3841,568,325,73,16835
7/3/2022,17,9541,2341,4633,728,238,32,17513
7/3/2022,18,9552,2624,5023,644,127,33,18003
7/3/2022,19,9554,2839,5065,485,37,33,18013
7/3/2022,20,9561,2795,4656,414,9,33,17468
7/3/2022,21,9562,2430,4482,458,0,34,16966
7/3/2022,22,9569,2057,3790,590,0,35,16041
7/3/2022,23,9571,1402,3387,584,0,35,14979
7/3/2022,24,9578,649,3286,606,0,33,14152
7/4/2022,1,9585,562,3122,631,0,29,13929
7/4/2022,2,9587,561,3183,588,0,23,13942
7/4/2022,3,9584,564,3284,573,0,21,14026
7/4/2022,4,9589,617,3541,505,1,21,14274
7/4/2022,5,9581,711,3131,427,2,22,13874
7/4/2022,6,9577,994,3088,359,11,26,14055
7/4/2022,7,9578,1359,3384,96,37,40,14494
7/4/2022,8,9576,1393,4118,146,132,44,15409
7/4/2022,9,9577,1551,4031,118,229,34,15540
7/4/2022,10,9602,1836,3861,129,336,34,15798
7/4/2022,11,9587,2379,4232,195,400,55,16848
7/4/2022,12,9591,2608,4022,344,377,87,17029
7/4/2022,13,9564,2896,4311,423,348,106,17648
7/4/2022,14,9418,3335,4318,536,337,108,18052
7/4/2022,15,9385,3121,4379,547,282,106,17820
7/4/2022,16,9479,3253,4469,447,245,107,18000
7/4/2022,17,9542,3387,4858,432,183,88,18490
7/4/2022,18,9548,3357,4968,417,107,48,18445
7/4/2022,19,9555,3285,4997,452,36,34,18359
7/4/2022,20,9557,2895,4981,594,8,34,18069
7/4/2022,21,9561,2852,4697,970,0,34,18114
7/4/2022,22,9567,2532,4141,1064,0,33,17337
7/4/2022,23,9572,1823,3928,1475,0,34,16832
7/4/2022,24,9577,1208,3654,1736,0,26,16201
7/5/2022,1,9575,649,3595,1707,0,22,15548
7/5/2022,2,9565,421,3574,1955,0,24,15539
7/5/2022,3,9551,379,3466,2060,0,24,15480
7/5/2022,4,9547,379,3374,2350,0,23,15673
7/5/2022,5,9558,391,3308,2211,0,25,15493
7/5/2022,6,9557,618,3310,2174,1,47,15707
7/5/2022,7,9545,1043,3923,2372,6,78,16967
7/5/2022,8,9549,1719,4270,1956,17,85,17596
7/5/2022,9,9541,2072,4028,1989,30,85,17745
7/5/2022,10,9530,2344,3827,1806,81,84,17672
7/5/2022,11,9529,2607,3998,1875,144,84,18237
7/5/2022,12,9521,2690,4073,2036,124,84,18528
7/5/2022,13,9514,2817,3916,1764,134,84,18229
7/5/2022,14,9501,2972,3886,1562,211,84,18216
7/5/2022,15,9504,3139,3974,1425,153,84,18279
7/5/2022,16,9508,3250,4135,1559,163,84,18699
7/5/2022,17,9508,3489,4605,1437,110,84,19233
7/5/2022,18,9511,3842,4753,1197,56,85,19444
7/5/2022,19,9510,3636,4747,1049,23,85,19050
7/5/2022,20,9510,3215,4697,857,3,87,18369
7/5/2022,21,9499,3053,4695,826,0,87,18160
7/5/2022,22,9499,2595,4324,817,0,87,17322
7/5/2022,23,9505,1856,4045,696,0,43,16145
7/5/2022,24,9509,1577,4102,504,0,34,15726
7/6/2022,1,9508,1322,4188,293,0,25,15336
7/6/2022,2,9516,755,4055,221,0,18,14565
7/6/2022,3,9520,726,4063,266,0,11,14586
7/6/2022,4,9509,754,3965,284,0,13,14525
7/6/2022,5,9505,850,3831,234,1,30,14451
7/6/2022,6,9511,1311,3801,288,7,48,14966
7/6/2022,7,9512,1678,3688,220,40,106,15244
7/6/2022,8,9508,1959,4268,455,110,121,16421
7/6/2022,9,9493,2065,4281,396,166,110,16511
7/6/2022,10,9454,2296,4201,381,252,110,16694
7/6/2022,11,9334,2586,4345,299,252,111,16927
7/6/2022,12,9481,2588,4434,296,249,72,17120
7/6/2022,13,9515,2698,4288,308,284,66,17159
7/6/2022,14,9458,2773,4507,346,274,73,17431
7/6/2022,15,9468,2856,4467,372,253,68,17484
7/6/2022,16,9515,3142,4646,439,249,83,18074
7/6/2022,17,9510,3376,4681,486,227,113,18393
7/6/2022,18,9515,3075,4871,436,128,122,18147
7/6/2022,19,9518,3348,4988,403,36,121,18414
7/6/2022,20,9517,3050,4862,511,10,116,18066
7/6/2022,21,9521,2965,4733,586,0,112,17917
7/6/2022,22,9517,2871,4473,562,0,58,17481
7/6/2022,23,9530,2201,4169,528,0,56,16484
7/6/2022,24,9530,1749,4023,483,0,59,15844
7/7/2022,1,9541,1062,3717,462,0,57,14839
7/7/2022,2,9544,767,3904,411,0,51,14677
7/7/2022,3,9562,1200,3566,318,0,60,14706
7/7/2022,4,9559,1269,3551,281,0,58,14718
7/7/2022,5,9558,1318,3598,320,2,51,14847
7/7/2022,6,9562,1720,3582,90,5,67,15026
7/7/2022,7,9561,1979,3772,74,45,105,15536
7/7/2022,8,9560,2149,3917,65,154,107,15952
7/7/2022,9,9558,2535,4142,57,264,97,16653
7/7/2022,10,9546,2579,4240,66,335,99,16865
7/7/2022,11,9546,2691,4465,90,363,99,17254
7/7/2022,12,9544,2899,4522,160,361,96,17582
7/7/2022,13,9545,3195,4609,201,359,101,18010
7/7/2022,14,9545,3503,4636,218,364,100,18366
7/7/2022,15,9544,3617,4737,316,358,103,18675
7/7/2022,16,9537,3972,5018,341,286,100,19254
7/7/2022,17,9529,4336,5222,332,207,115,19741
7/7/2022,18,9532,4208,5222,349,116,115,19542
7/7/2022,19,9535,4299,5184,345,37,109,19509
7/7/2022,20,9543,4081,4964,372,8,107,19075
7/7/2022,21,9549,4037,4736,386,1,102,18811
7/7/2022,22,9553,3110,4711,444,0,87,17905
7/7/2022,23,9558,2186,4325,401,0,86,16556
7/7/2022,24,9562,1569,3954,379,0,86,15550
7/8/2022,1,9563,737,3537,327,0,77,14241
7/8/2022,2,9561,272,3484,446,0,75,13838
7/8/2022,3,9558,244,3413,526,0,75,13816
7/8/2022,4,9561,479,3193,371,0,75,13679
7/8/2022,5,9555,872,3186,385,2,53,14053
7/8/2022,6,9559,1299,3347,261,7,24,14497
7/8/2022,7,9563,1645,3623,183,43,30,15087
7/8/2022,8,9556,2124,4071,228,152,34,16165
7/8/2022,9,9557,2654,4255,201,246,36,16949
7/8/2022,10,9554,3207,4272,218,330,64,17645
7/8/2022,11,9543,3431,4484,304,310,95,18167
7/8/2022,12,9535,3779,4480,440,292,179,18705
7/8/2022,13,9539,3703,4378,531,313,129,18593
7/8/2022,14,9532,3456,4662,665,235,86,18636
7/8/2022,15,9524,3723,4734,706,201,87,18975
7/8/2022,16,9515,3757,4937,807,183,88,19287
7/8/2022,17,9528,3885,4919,1145,146,98,19721
7/8/2022,18,9539,3291,5129,1251,104,86,19400
7/8/2022,19,9543,3441,4847,1121,37,87,19076
7/8/2022,20,9550,3079,4701,1178,9,88,18605
7/8/2022,21,9547,2163,4596,1346,0,88,17740
7/8/2022,22,9555,1971,3769,1325,0,88,16708
7/8/2022,23,9555,707,3541,1143,0,88,15034
7/8/2022,24,9555,191,3373,1286,0,45,14450
7/9/2022,1,9564,141,3125,1335,0,25,14190
7/9/2022,2,9566,141,3007,1628,0,22,14364
7/9/2022,3,9570,137,2990,1763,0,22,14482
7/9/2022,4,9563,140,3005,1851,0,22,14581
7/9/2022,5,9564,140,2973,1952,1,22,14652
7/9/2022,6,9564,172,3176,1797,8,22,14739
7/9/2022,7,9560,180,3436,1361,55,32,14624
7/9/2022,8,9558,245,4041,1011,170,35,15060
7/9/2022,9,9557,345,3631,866,298,34,14731
7/9/2022,10,9557,493,3828,680,388,41,14987
7/9/2022,11,9549,775,4219,567,422,74,15606
7/9/2022,12,9543,862,4239,652,427,82,15805
7/9/2022,13,9547,1027,3905,744,420,82,15725
7/9/2022,14,9538,1632,3723,771,423,109,16196
7/9/2022,15,9532,1792,3705,483,403,115,16030
7/9/2022,16,9528,1910,3729,739,357,89,16352
7/9/2022,17,9525,1837,4195,1248,260,82,17147
7/9/2022,18,9517,1902,4522,1152,139,85,17317
7/9/2022,19,9521,2239,4558,806,38,85,17247
7/9/2022,20,9517,2048,4488,652,9,92,16806
7/9/2022,21,9525,1725,4191,739,0,87,16267
7/9/2022,22,9530,1678,3729,852,0,86,15875
7/9/2022,23,9534,594,3754,784,0,45,14711
7/9/2022,24,9538,195,3379,682,0,34,13828
7/10/2022,1,9542,141,3270,644,0,24,13621
7/10/2022,2,9540,140,3502,570,0,22,13774
7/10/2022,3,9535,139,3729,570,0,22,13995
7/10/2022,4,9539,138,3493,596,1,22,13789
7/10/2022,5,9539,154,3539,587,2,23,13844
7/10/2022,6,9538,159,3637,449,11,23,13817
7/10/2022,7,9538,336,4125,385,57,29,14470
7/10/2022,8,9536,529,3691,295,161,33,14245
7/10/2022,9,9534,639,4191,290,273,34,14961
7/10/2022,10,9534,824,3999,457,364,34,15212
7/10/2022,11,9524,1075,4205,567,401,36,15808
7/10/2022,12,9516,1569,4122,601,416,34,16258
7/10/2022,13,9498,1976,3951,522,408,33,16388
7/10/2022,14,9499,2469,4200,568,401,33,17170
7/10/2022,15,9441,2698,4036,537,380,32,17124
7/10/2022,16,9011,3069,4350,545,331,33,17339
7/10/2022,17,8677,3996,4784,466,227,33,18183
7/10/2022,18,8690,4152,4860,433,120,33,18288
7/10/2022,19,8692,4282,4721,491,33,33,18252
7/10/2022,20,8698,4032,4455,589,8,33,17815
7/10/2022,21,8694,3384,4414,717,1,33,17243
7/10/2022,22,8706,3314,3983,783,0,31,16817
7/10/2022,23,8709,2380,3770,1002,0,31,15892
7/10/2022,24,8704,1358,3590,1104,0,31,14787
7/11/2022,1,8707,807,3222,1087,0,22,13845
7/11/2022,2,8714,735,3350,1048,0,20,13867
7/11/2022,3,8694,875,3409,1087,0,20,14085
7/11/2022,4,8677,825,3392,1182,0,19,14095
7/11/2022,5,8689,832,3186,1119,1,20,13847
7/11/2022,6,8674,1023,3126,1098,6,20,13947
7/11/2022,7,8667,1367,3261,1067,55,26,14443
7/11/2022,8,8656,1816,3822,1072,120,26,15512
7/11/2022,9,8645,2120,4034,1207,184,24,16214
7/11/2022,10,8649,2396,4039,1819,299,24,17226
7/11/2022,11,8631,2635,4198,2247,375,24,18110
7/11/2022,12,8606,2727,4287,2740,356,25,18741
7/11/2022,13,8618,2871,4101,3084,378,24,19076
7/11/2022,14,8625,2993,4122,3235,383,24,19382
7/11/2022,15,8623,3173,4427,3367,342,25,19957
7/11/2022,16,8606,3603,4590,3191,303,26,20319
7/11/2022,17,8591,3894,4851,3145,187,24,20692
7/11/2022,18,8600,3930,4946,3091,102,24,20693
7/11/2022,19,8601,4031,4728,2909,37,24,20330
7/11/2022,20,8603,3833,4970,2647,5,24,20082
7/11/2022,21,8586,4054,4741,2436,0,24,19841
7/11/2022,22,8575,3437,4482,2357,0,24,18875
7/11/2022,23,8591,2465,4066,2422,0,24,17568
7/11/2022,24,8598,1172,4001,2544,0,24,16339
7/12/2022,1,8611,818,3661,2470,0,15,15575
7/12/2022,2,8624,538,3765,2257,0,11,15195
7/12/2022,3,8647,494,3504,2365,0,11,15021
7/12/2022,4,8673,417,3498,2500,0,11,15099
7/12/2022,5,8682,714,3204,2254,2,11,14867
7/12/2022,6,8693,1378,3276,1862,4,11,15224
7/12/2022,7,8695,2338,3814,1688,37,9,16581
7/12/2022,8,8697,3734,3752,1483,126,9,17801
7/12/2022,9,8689,3817,3776,1433,229,9,17953
7/12/2022,10,8664,3825,3708,1855,297,9,18358
7/12/2022,11,8652,3719,3866,2067,279,11,18594
7/12/2022,12,8630,4039,4386,1882,266,18,19221
7/12/2022,13,8630,4399,4454,1535,258,24,19300
7/12/2022,14,8616,4309,4485,1196,325,24,18955
7/12/2022,15,8618,4263,4870,1161,341,23,19276
7/12/2022,16,8617,4577,4923,1228,301,20,19666
7/12/2022,17,8638,4812,5139,1233,232,21,20075
7/12/2022,18,8667,4897,5154,1155,113,20,20006
7/12/2022,19,8690,4832,5148,1077,35,23,19805
7/12/2022,20,8706,4170,5268,697,7,24,18872
7/12/2022,21,8794,4388,4930,453,0,24,18589
7/12/2022,22,9132,3665,4498,360,0,24,17679
7/12/2022,23,9364,2735,4192,223,0,24,16538
7/12/2022,24,9404,1764,3989,236,0,24,15417
7/13/2022,1,9398,1676,3679,255,0,18,15026
7/13/2022,2,9390,1095,3527,271,0,11,14294
7/13/2022,3,9392,1031,3414,288,0,11,14136
7/13/2022,4,9399,1236,3436,232,0,11,14314
7/13/2022,5,9393,1363,3402,214,0,11,14383
7/13/2022,6,9386,1414,3332,228,10,12,14382
7/13/2022,7,9379,1810,3772,187,60,18,15226
7/13/2022,8,9373,2564,3978,77,162,24,16178
7/13/2022,9,9360,3177,4066,36,257,24,16920
7/13/2022,10,9361,3445,4386,43,321,26,17582
7/13/2022,11,9397,3724,4488,71,345,25,18050
7/13/2022,12,9429,3465,4227,110,318,25,17574
7/13/2022,13,9429,3353,4196,166,270,24,17438
7/13/2022,14,9425,3739,4232,185,265,25,17871
7/13/2022,15,9428,4086,4255,152,214,24,18159
7/13/2022,16,9430,4093,4474,108,185,24,18314
7/13/2022,17,9421,3730,4601,93,150,25,18020
7/13/2022,18,9417,3583,4622,159,77,25,17883
7/13/2022,19,9412,3839,4642,160,31,25,18109
7/13/2022,20,9408,4030,4600,114,7,48,18207
7/13/2022,21,9426,3873,4467,121,0,76,17963
7/13/2022,22,9442,3123,4117,186,0,76,16944
7/13/2022,23,9445,1935,3843,249,0,75,15547
7/13/2022,24,9439,1210,3551,248,0,83,14531
7/14/2022,1,9435,704,3543,293,0,77,14052
7/14/2022,2,9424,561,3459,306,0,62,13812
7/14/2022,3,9426,704,3571,343,0,23,14067
7/14/2022,4,9542,529,3314,421,0,11,13817
7/14/2022,5,9636,514,3093,368,2,11,13624
7/14/2022,6,9633,635,3272,353,8,14,13915
7/14/2022,7,9636,940,3818,309,53,30,14786
7/14/2022,8,9632,2010,3922,110,165,60,15899
7/14/2022,9,9637,2214,3916,35,279,91,16172
7/14/2022,10,9649,2803,3842,35,374,82,16785
7/14/2022,11,9623,2961,3952,126,407,77,17146
7/14/2022,12,9622,3336,3990,223,403,85,17659
7/14/2022,13,9635,3190,4092,322,372,89,17700
7/14/2022,14,9816,3008,4081,426,332,92,17755
7/14/2022,15,9935,3059,4131,530,354,92,18101
7/14/2022,16,10018,3202,4539,570,287,95,18711
7/14/2022,17,10003,3673,4978,477,238,83,19452
7/14/2022,18,10000,3868,5154,387,124,92,19625
7/14/2022,19,10001,4087,5164,333,31,111,19727
7/14/2022,20,9989,3873,4869,380,6,88,19205
7/14/2022,21,10002,3356,4786,378,0,73,18595
7/14/2022,22,10016,2979,4305,303,0,73,17676
7/14/2022,23,10036,1617,4051,319,0,74,16097
7/14/2022,24,10056,850,3841,296,0,74,15117
7/15/2022,1,10116,604,3579,261,0,65,14625
7/15/2022,2,10238,622,3594,195,0,20,14669
7/15/2022,3,10245,561,3491,117,0,13,14427
7/15/2022,4,10241,614,3553,78,0,14,14500
7/15/2022,5,10237,523,3281,80,1,11,14133
7/15/2022,6,10220,523,3274,67,8,14,14106
7/15/2022,7,10205,646,4037,88,55,48,15079
7/15/2022,8,10195,1086,4206,57,164,73,15781
7/15/2022,9,10179,1506,4404,23,278,92,16482
7/15/2022,10,10165,2122,4387,73,358,78,17183
7/15/2022,11,10163,2450,4322,109,381,71,17496
7/15/2022,12,10143,2553,4325,223,383,71,17698
7/15/2022,13,10137,2854,4305,324,367,71,18058
7/15/2022,14,10130,3075,4423,350,372,70,18420
7/15/2022,15,10125,3305,4521,402,348,55,18756
7/15/2022,16,10135,3656,4607,431,287,69,19185
7/15/2022,17,10172,3676,4802,395,197,96,19338
7/15/2022,18,10209,3666,4851,332,98,81,19237
7/15/2022,19,10240,3533,4806,253,36,81,18949
7/15/2022,20,10242,3237,4802,299,7,73,18660
7/15/2022,21,10243,3250,4611,459,0,96,18659
7/15/2022,22,10236,2265,4412,527,0,88,17528
7/15/2022,23,10233,1332,3780,504,0,72,15921
7/15/2022,24,10223,601,3640,452,0,72,14988
7/16/2022,1,10201,579,3619,305,0,28,14732
7/16/2022,2,10189,580,3520,344,0,11,14644
7/16/2022,3,10188,470,3270,444,0,11,14383
7/16/2022,4,10200,485,3307,289,0,11,14292
7/16/2022,5,10218,546,3430,165,1,11,14371
7/16/2022,6,10228,520,3367,136,8,11,14270
7/16/2022,7,10231,628,3503,111,52,21,14546
7/16/2022,8,10220,799,3953,69,153,24,15218
7/16/2022,9,10219,1309,3930,44,230,24,15756
7/16/2022,10,10227,2015,3979,60,352,24,16657
7/16/2022,11,10225,2565,4028,131,380,24,17353
7/16/2022,12,10213,2684,4261,188,361,24,17731
7/16/2022,13,10196,3099,4255,215,361,49,18175
7/16/2022,14,10176,3323,4220,262,388,74,18443
7/16/2022,15,10154,3244,4275,300,357,81,18411
7/16/2022,16,10143,3710,4408,233,307,156,18957
7/16/2022,17,10153,4483,4506,158,217,212,19729
7/16/2022,18,10173,4533,4494,116,120,195,19631
7/16/2022,19,10188,4456,4479,95,36,199,19453
7/16/2022,20,10206,3993,4325,122,7,187,18840
7/16/2022,21,10207,3674,4245,153,0,167,18446
7/16/2022,22,10210,3198,3830,264,0,98,17600
7/16/2022,23,10209,2202,3738,349,0,89,16587
7/16/2022,24,10205,1261,3393,352,0,53,15264
7/17/2022,1,10216,780,3326,302,0,19,14643
7/17/2022,2,10220,559,3463,229,0,11,14482
7/17/2022,3,10225,493,3257,209,0,11,14195
7/17/2022,4,10230,490,3184,173,0,24,14101
7/17/2022,5,10223,515,3281,138,0,19,14176
7/17/2022,6,10206,533,3171,211,4,11,14136
7/17/2022,7,10177,681,3145,182,39,20,14244
7/17/2022,8,10155,1029,3518,140,112,44,14998
7/17/2022,9,10144,1563,3475,118,191,73,15564
7/17/2022,10,10147,2285,3827,161,259,102,16781
7/17/2022,11,10158,2922,3848,222,279,201,17630
7/17/2022,12,10171,3364,4181,170,297,187,18370
7/17/2022,13,10180,3485,4225,242,323,158,18613
7/17/2022,14,10173,3780,4214,501,287,96,19051
7/17/2022,15,10168,4127,4424,496,235,114,19564
7/17/2022,16,10170,4442,4371,481,212,185,19861
7/17/2022,17,10173,4427,4429,531,176,186,19922
7/17/2022,18,10175,4140,4607,526,94,159,19701
7/17/2022,19,10173,3986,4668,381,36,57,19301
7/17/2022,20,10173,4382,4472,406,5,27,19465
7/17/2022,21,10161,4081,4279,635,0,56,19212
7/17/2022,22,10156,3621,3907,597,0,76,18357
7/17/2022,23,10157,2601,3711,563,0,73,17105
7/17/2022,24,10180,1922,3436,632,0,33,16203
7/18/2022,1,10175,874,3516,574,0,14,15153
7/18/2022,2,10127,764,3269,561,0,11,14732
7/18/2022,3,10117,617,3218,525,0,11,14488
7/18/2022,4,10119,761,3293,473,0,11,14657
7/18/2022,5,10122,741,3079,558,0,11,14511
7/18/2022,6,10123,1364,3263,502,4,31,15287
7/18/2022,7,10116,2029,3409,496,9,74,16133
7/18/2022,8,10109,2679,3776,535,25,118,17242
7/18/2022,9,10099,3341,3852,582,62,160,18096
7/18/2022,10,10092,3717,3895,579,103,152,18538
7/18/2022,11,10071,4001,3895,507,123,119,18716
7/18/2022,12,10073,4178,3924,659,161,98,19093
7/18/2022,13,10079,4028,4207,680,181,75,19250
7/18/2022,14,10078,4073,4276,583,155,75,19240
7/18/2022,15,10084,4309,4376,583,195,75,19622
7/18/2022,16,10096,4484,4653,703,211,76,20223
7/18/2022,17,10106,4624,4932,762,165,93,20682
7/18/2022,18,10116,4637,5152,734,79,126,20844
7/18/2022,19,10120,4939,5068,625,39,206,20997
7/18/2022,20,10127,4625,4864,720,8,202,20546
7/18/2022,21,10135,4284,4389,879,0,169,19856
7/18/2022,22,10160,3623,3964,1028,0,104,18879
7/18/2022,23,10170,2553,3336,1439,0,36,17534
7/18/2022,24,10159,1712,2964,1566,0,24,16425
7/19/2022,1,10150,686,2894,1962,0,15,15707
7/19/2022,2,10150,542,3289,1685,0,11,15677
7/19/2022,3,10134,732,3346,1444,0,12,15668
7/19/2022,4,10118,637,3167,1349,0,13,15284
7/19/2022,5,10096,758,2893,1272,2,14,15035
7/19/2022,6,10087,1364,2851,879,4,22,15207
7/19/2022,7,10080,1936,3199,934,43,64,16256
7/19/2022,8,10090,2740,3712,810,140,80,17572
7/19/2022,9,10090,3655,3838,577,253,153,18566
7/19/2022,10,10088,4007,3833,565,346,203,19042
7/19/2022,11,10084,4574,3874,697,389,202,19820
7/19/2022,12,10097,4541,4132,994,398,178,20340
7/19/2022,13,10123,4643,4148,1297,401,187,20799
7/19/2022,14,10153,4813,4309,1413,367,167,21222
7/19/2022,15,10162,4947,4565,1575,368,160,21777
7/19/2022,16,10150,4847,4921,1718,312,139,22087
7/19/2022,17,10137,4825,5150,1695,227,87,22121
7/19/2022,18,10121,5011,5160,1625,110,46,22073
7/19/2022,19,10100,5057,5165,1528,31,33,21914
7/19/2022,20,10089,5373,4856,1321,3,39,21681
7/19/2022,21,10093,5311,4606,1711,0,37,21758
7/19/2022,22,10126,4675,3761,1972,0,32,20566
7/19/2022,23,10135,4060,3428,1886,0,23,19532
7/19/2022,24,10137,3358,3108,2115,0,23,18741
7/20/2022,1,10144,2324,2879,2086,0,16,17449
7/20/2022,2,10140,2046,2780,1849,0,11,16826
7/20/2022,3,10144,2055,2873,1812,0,11,16895
7/20/2022,4,10151,2108,2806,1488,0,11,16564
7/20/2022,5,10149,2331,2833,1529,1,12,16855
7/20/2022,6,10138,2795,2889,1251,3,12,17088
7/20/2022,7,10142,3016,3227,1738,29,42,18194
7/20/2022,8,10134,3624,3746,2159,95,72,19830
7/20/2022,9,10125,4183,3741,2237,219,121,20626
7/20/2022,10,10116,4454,3732,2696,310,98,21406
7/20/2022,11,10119,4275,3750,3042,303,81,21570
7/20/2022,12,10121,4481,3846,3243,276,84,22051
7/20/2022,13,10113,4252,3894,3291,315,123,21988
7/20/2022,14,10116,4432,4390,3261,332,95,22626
7/20/2022,15,10106,4676,4422,3093,282,88,22667
7/20/2022,16,10100,4620,4844,3041,191,47,22843
7/20/2022,17,10102,4264,4873,3119,138,35,22531
7/20/2022,18,10123,3888,5003,3053,109,35,22211
7/20/2022,19,10127,4418,4952,2954,25,36,22512
7/20/2022,20,10131,4461,4969,2549,4,37,22151
7/20/2022,21,10122,4893,4465,2311,0,36,21827
7/20/2022,22,10098,3583,3996,2502,0,36,20215
7/20/2022,23,10071,2939,3294,2375,0,25,18704
7/20/2022,24,10051,1914,3049,2495,0,28,17537
7/21/2022,1,10070,1488,3168,2445,0,32,17203
7/21/2022,2,10091,1330,3243,2350,0,28,17042
7/21/2022,3,10102,1269,3242,2348,0,11,16972
7/21/2022,4,10125,1266,3150,2317,0,11,16869
7/21/2022,5,10152,1380,2977,2265,2,12,16788
7/21/2022,6,10193,1610,3098,1984,4,12,16901
7/21/2022,7,10206,1943,3529,2166,32,45,17921
7/21/2022,8,10209,2907,3769,2281,115,85,19366
7/21/2022,9,10201,3005,3804,2408,192,99,19709
7/21/2022,10,10188,3239,3878,2508,239,154,20206
7/21/2022,11,10187,3402,4139,2619,275,174,20796
7/21/2022,12,10189,3669,4326,2765,311,153,21413
7/21/2022,13,10180,3637,4159,2851,313,164,21304
7/21/2022,14,10174,3479,4251,2806,254,87,21051
7/21/2022,15,10178,3542,4372,2553,268,71,20984
7/21/2022,16,10204,3972,4549,2182,273,81,21261
7/21/2022,17,10223,4506,4596,1910,205,92,21532
7/21/2022,18,10239,4710,4744,1623,109,93,21518
7/21/2022,19,10256,4673,4717,1440,34,92,21212
7/21/2022,20,10267,4685,4532,1434,6,41,20965
7/21/2022,21,10271,4407,4372,1553,0,24,20627
7/21/2022,22,10272,3961,4119,1424,0,23,19799
7/21/2022,23,10280,3159,3564,1235,0,24,18262
7/21/2022,24,10287,1673,3706,944,0,24,16634
7/22/2022,1,10304,1290,3314,1099,0,16,16023
7/22/2022,2,10317,1181,3080,598,0,11,15187
7/22/2022,3,10319,1212,3137,658,0,11,15337
7/22/2022,4,10322,1235,3257,788,0,11,15613
7/22/2022,5,10322,1485,3028,681,1,12,15529
7/22/2022,6,10315,1833,3079,305,3,12,15547
7/22/2022,7,10310,2518,3409,351,46,27,16661
7/22/2022,8,10300,3080,4010,351,145,66,17952
7/22/2022,9,10295,3696,4255,262,270,75,18853
7/22/2022,10,10294,4270,4244,375,352,80,19615
7/22/2022,11,10294,4579,4329,504,392,94,20192
7/22/2022,12,10288,4845,4447,768,382,87,20817
7/22/2022,13,10274,4854,4384,1099,395,83,21089
7/22/2022,14,10274,4755,4423,1398,383,127,21360
7/22/2022,15,10280,4380,4428,1493,365,132,21078
7/22/2022,16,10285,4706,4511,1448,322,117,21389
7/22/2022,17,10286,4883,4585,1367,218,130,21469
7/22/2022,18,10284,4772,4836,1432,104,96,21524
7/22/2022,19,10278,4672,4919,1432,28,100,21429
7/22/2022,20,10277,4293,4631,1731,6,98,21036
7/22/2022,21,10264,3327,4558,2218,0,74,20441
7/22/2022,22,10287,2665,4099,2454,0,81,19586
7/22/2022,23,10291,1770,3555,2514,0,75,18205
7/22/2022,24,10293,862,3433,2341,0,37,16966
7/23/2022,1,10286,754,3569,1981,0,14,16604
7/23/2022,2,10276,755,3608,1473,0,11,16123
7/23/2022,3,10271,678,3464,1214,0,11,15638
7/23/2022,4,10276,737,3496,1103,0,13,15625
7/23/2022,5,10277,676,3109,1489,2,12,15565
7/23/2022,6,10292,886,3235,1196,5,14,15628
7/23/2022,7,10319,1400,3455,1297,47,29,16547
7/23/2022,8,10329,2132,3683,1219,111,65,17539
7/23/2022,9,10331,2916,3842,995,199,94,18377
7/23/2022,10,10308,3322,4097,1034,253,105,19119
7/23/2022,11,10304,3767,3951,1273,290,141,19726
7/23/2022,12,10298,4099,3943,1641,324,152,20457
7/23/2022,13,10291,3985,3918,2028,317,127,20666
7/23/2022,14,10288,4155,4049,2109,348,131,21080
7/23/2022,15,10283,4562,4268,1545,349,112,21119
7/23/2022,16,10277,4418,4575,1296,271,100,20937
7/23/2022,17,10296,4715,5046,1112,218,99,21486
7/23/2022,18,10312,5053,4915,1075,125,88,21568
7/23/2022,19,10319,4382,4755,1268,35,109,20868
7/23/2022,20,10322,3776,4630,1462,6,89,20285
7/23/2022,21,10324,4168,4265,1496,0,77,20330
7/23/2022,22,10327,3114,4037,1852,0,78,19408
7/23/2022,23,10322,2256,3605,1981,0,75,18239
7/23/2022,24,10319,1239,3443,1976,0,75,17052
7/24/2022,1,10326,581,3174,2308,0,66,16455
7/24/2022,2,10327,487,3526,1918,0,25,16283
7/24/2022,3,10319,512,3294,2219,0,11,16355
7/24/2022,4,10324,468,3166,2476,0,11,16445
7/24/2022,5,10325,469,3126,2526,1,12,16459
7/24/2022,6,10329,479,2979,2668,2,12,16469
7/24/2022,7,10330,649,3747,1642,16,21,16405
7/24/2022,8,10331,1100,3995,1299,74,29,16828
7/24/2022,9,10333,1240,3831,1358,109,24,16895
7/24/2022,10,10330,1580,3934,1576,147,40,17607
7/24/2022,11,10323,1882,3554,1811,198,72,17840
7/24/2022,12,10323,1971,3550,2131,206,76,18257
7/24/2022,13,10306,2083,3582,2332,158,75,18536
7/24/2022,14,10297,2217,3494,2782,249,75,19114
7/24/2022,15,10311,2207,3584,2861,182,75,19220
7/24/2022,16,10326,2235,3674,3482,172,75,19964
7/24/2022,17,10318,2253,4173,3576,170,75,20565
7/24/2022,18,10320,2592,4383,3229,89,80,20693
7/24/2022,19,10313,2811,4396,2935,24,88,20567
7/24/2022,20,10312,2290,4112,3119,2,81,19916
7/24/2022,21,10318,2072,3999,3006,0,81,19476
7/24/2022,22,10323,1564,3692,2888,0,76,18543
7/24/2022,23,10322,846,3720,2425,0,71,17384
7/24/2022,24,10346,839,3914,1926,0,34,17059
7/25/2022,1,10315,917,3911,1552,0,14,16709
7/25/2022,2,10302,687,3558,1451,0,11,16009
7/25/2022,3,10301,489,2994,1242,0,11,15037
7/25/2022,4,10294,477,3239,1490,0,11,15511
7/25/2022,5,10291,604,3010,1434,2,11,15352
7/25/2022,6,10287,864,3166,1531,3,14,15865
7/25/2022,7,10282,1339,3620,1572,36,37,16886
7/25/2022,8,10278,1852,3908,1623,143,74,17878
7/25/2022,9,10274,2129,3553,1608,249,78,17891
7/25/2022,10,10275,2249,3471,1220,325,77,17617
7/25/2022,11,10280,2314,3449,1201,378,77,17699
7/25/2022,12,10286,2403,3458,1252,388,75,17862
7/25/2022,13,10291,2425,3474,1101,364,76,17731
7/25/2022,14,10298,2104,3640,1230,330,76,17678
7/25/2022,15,10301,1945,3759,1289,327,76,17697
7/25/2022,16,10297,2075,3915,1026,304,76,17693
7/25/2022,17,10329,2373,4274,987,222,76,18261
7/25/2022,18,10349,2495,4619,870,119,75,18527
7/25/2022,19,10357,2760,4705,728,32,76,18658
7/25/2022,20,10359,2838,4635,547,6,85,18470
7/25/2022,21,10365,2489,4602,469,0,94,18019
7/25/2022,22,10354,2086,4391,389,0,84,17304
7/25/2022,23,10376,1269,3813,370,0,73,15901
7/25/2022,24,10383,783,3907,380,0,33,15486
7/26/2022,1,10380,560,3910,353,0,13,15216
7/26/2022,2,10378,477,3933,357,0,11,15156
7/26/2022,3,10382,513,3993,353,0,11,15252
7/26/2022,4,10381,524,3939,331,0,11,15186
7/26/2022,5,10383,561,3686,319,2,11,14962
7/26/2022,6,10382,966,3315,281,6,17,14967
7/26/2022,7,10383,1538,3339,120,44,42,15466
7/26/2022,8,10377,1843,3714,155,142,70,16301
7/26/2022,9,10379,2000,3590,85,227,73,16354
7/26/2022,10,10379,2230,3649,98,290,73,16719
7/26/2022,11,10382,2398,3737,151,319,73,17060
7/26/2022,12,10382,2487,3769,267,354,73,17332
7/26/2022,13,10376,2616,3723,395,331,65,17506
7/26/2022,14,10378,2672,3809,478,350,49,17736
7/26/2022,15,10366,2792,4096,541,303,77,18175
7/26/2022,16,10362,2874,4276,602,300,69,18483
7/26/2022,17,10359,3364,4557,475,234,107,19096
7/26/2022,18,10373,3564,4853,350,127,88,19355
7/26/2022,19,10392,3766,4833,278,36,110,19415
7/26/2022,20,10386,3214,4792,270,6,73,18741
7/26/2022,21,10375,3154,4528,272,0,98,18427
7/26/2022,22,10366,2609,4428,277,0,87,17767
7/26/2022,23,10366,1814,4145,324,0,32,16681
7/26/2022,24,10370,839,3779,352,0,24,15364
7/27/2022,1,10369,473,3820,412,0,15,15089
7/27/2022,2,10376,555,3653,518,0,11,15113
7/27/2022,3,10376,484,3551,607,0,12,15030
7/27/2022,4,10367,506,3544,613,0,14,15044
7/27/2022,5,10377,498,3525,525,2,28,14955
7/27/2022,6,10382,666,3837,481,8,59,15433
7/27/2022,7,10382,1241,3656,472,49,68,15868
7/27/2022,8,10389,1823,3714,239,126,73,16364
7/27/2022,9,10385,2151,3890,416,190,75,17107
7/27/2022,10,10371,2426,3756,459,230,75,17317
7/27/2022,11,10356,2853,3795,240,279,74,17597
7/27/2022,12,10347,3204,4017,565,255,74,18462
7/27/2022,13,10348,3398,4231,649,276,70,18972
7/27/2022,14,10342,3782,4233,597,266,73,19293
7/27/2022,15,10341,3860,4315,677,279,60,19532
7/27/2022,16,10334,4175,4408,544,249,95,19805
7/27/2022,17,10337,4046,4636,519,147,92,19777
7/27/2022,18,10345,3971,4770,590,78,107,19861
7/27/2022,19,10349,3920,4758,589,28,78,19722
7/27/2022,20,10347,3919,4781,485,4,80,19616
7/27/2022,21,10343,3675,4556,623,0,73,19270
7/27/2022,22,10329,2693,4439,705,0,73,18239
7/27/2022,23,10326,1814,4194,722,0,30,17086
7/27/2022,24,10330,850,4200,749,0,23,16152
7/28/2022,1,10332,704,4199,684,0,12,15931
7/28/2022,2,10330,567,4126,592,0,10,15625
7/28/2022,3,10342,696,3842,550,0,11,15441
7/28/2022,4,10355,1031,3911,366,0,11,15674
7/28/2022,5,10358,1253,3736,332,2,10,15691
7/28/2022,6,10357,1834,3189,369,5,11,15765
7/28/2022,7,10354,1986,3569,333,28,20,16290
7/28/2022,8,10347,2312,3884,388,86,40,17057
7/28/2022,9,10318,2665,4042,748,195,71,18039
7/28/2022,10,10290,3073,4146,1335,209,76,19129
7/28/2022,11,10294,3975,4061,1409,208,76,20023
7/28/2022,12,10324,3728,4070,1940,221,76,20359
7/28/2022,13,10320,3128,3816,2456,271,76,20067
7/28/2022,14,10319,3141,4020,2587,239,75,20381
7/28/2022,15,10314,3408,4358,2626,193,76,20975
7/28/2022,16,10319,4097,4549,2360,188,76,21589
7/28/2022,17,10312,3659,4820,2285,151,77,21304
7/28/2022,18,10293,3716,4814,2241,103,76,21243
7/28/2022,19,10296,3971,4842,1969,27,105,21210
7/28/2022,20,10311,3920,4506,1528,6,114,20385
7/28/2022,21,10317,3293,4392,1560,0,95,19657
7/28/2022,22,10332,2448,4002,1542,0,77,18401
7/28/2022,23,10340,1561,3884,1335,0,76,17196
7/28/2022,24,10351,681,4064,1171,0,73,16340
7/29/2022,1,10360,507,3944,1144,0,22,15977
7/29/2022,2,10370,501,3668,991,0,12,15542
7/29/2022,3,10369,514,3675,1009,0,11,15578
7/29/2022,4,10375,625,3572,971,0,11,15554
7/29/2022,5,10375,891,3488,853,1,11,15619
7/29/2022,6,10376,1434,3308,740,3,12,15873
7/29/2022,7,10369,1676,3820,441,38,16,16360
7/29/2022,8,10361,1729,4172,624,143,24,17053
7/29/2022,9,10360,2243,4201,648,255,24,17731
7/29/2022,10,10357,2100,4253,761,342,24,17837
7/29/2022,11,10350,2462,4344,1025,345,24,18550
7/29/2022,12,10339,2382,4186,1332,320,24,18583
7/29/2022,13,10330,2446,3983,1509,315,25,18608
7/29/2022,14,10329,2588,3922,1574,346,25,18784
7/29/2022,15,10331,2774,4104,1625,336,29,19199
7/29/2022,16,10321,2689,4323,1717,299,60,19409
7/29/2022,17,10318,3249,4962,1606,204,74,20413
7/29/2022,18,10317,3195,5031,1413,92,73,20121
7/29/2022,19,10324,2954,4761,1259,28,73,19399
7/29/2022,20,10330,2937,4573,1141,5,75,19061
7/29/2022,21,10344,2880,4643,1145,0,81,19093
7/29/2022,22,10344,2047,4085,1234,0,74,17784
7/29/2022,23,10353,937,3877,1226,0,33,16426
7/29/2022,24,10348,259,3965,1195,0,24,15791
7/30/2022,1,10346,157,3898,1088,0,14,15503
7/30/2022,2,10350,147,4012,1053,0,11,15573
7/30/2022,3,10354,180,4218,832,0,11,15595
7/30/2022,4,10361,184,4037,754,0,11,15347
7/30/2022,5,10365,148,4108,753,2,11,15387
7/30/2022,6,10367,153,4048,778,3,11,15360
7/30/2022,7,10368,165,3974,679,39,19,15244
7/30/2022,8,10372,310,4301,573,144,24,15724
7/30/2022,9,10380,703,4248,588,244,24,16187
7/30/2022,10,10380,977,4498,667,300,24,16846
7/30/2022,11,10387,1434,4401,603,320,24,17169
7/30/2022,12,10387,1820,4212,556,320,24,17319
7/30/2022,13,10391,2276,4316,457,312,24,17776
7/30/2022,14,10375,2408,4222,346,261,24,17636
7/30/2022,15,10368,2582,4131,534,286,24,17925
7/30/2022,16,10371,2711,4689,588,272,24,18655
7/30/2022,17,10381,3376,4835,621,200,23,19436
7/30/2022,18,10377,3731,4770,571,111,24,19584
7/30/2022,19,10376,3972,4616,476,28,24,19492
7/30/2022,20,10368,3490,4535,458,4,24,18879
7/30/2022,21,10375,2879,4318,613,0,24,18209
7/30/2022,22,10375,1923,4023,771,0,24,17116
7/30/2022,23,10378,546,3961,915,0,24,15824
7/30/2022,24,10375,199,3682,1123,0,24,15403
7/31/2022,1,10372,173,3414,1189,0,15,15163
7/31/2022,2,10372,174,3451,1234,0,11,15242
7/31/2022,3,10370,173,3831,1215,0,11,15600
7/31/2022,4,10374,173,4186,1028,0,11,15772
7/31/2022,5,10370,186,4313,900,1,11,15781
7/31/2022,6,10368,212,4200,698,3,11,15492
7/31/2022,7,10363,348,4144,461,46,19,15381
7/31/2022,8,10361,755,4130,180,134,24,15584
7/31/2022,9,10359,1240,3864,141,218,24,15846
7/31/2022,10,10359,1588,3897,118,329,24,16315
7/31/2022,11,10368,2092,4054,162,320,24,17020
7/31/2022,12,10365,2478,4356,260,330,26,17815
7/31/2022,13,10358,2703,4343,390,336,24,18154
7/31/2022,14,10344,2784,4398,601,352,23,18502
7/31/2022,15,10328,2872,4657,664,357,28,18906
7/31/2022,16,10322,3179,4896,744,280,32,19453
7/31/2022,17,10315,3860,5087,687,182,56,20187
7/31/2022,18,10320,4045,4922,648,118,75,20128
7/31/2022,19,10325,4181,4755,573,38,89,19961
7/31/2022,20,10324,3575,4655,623,5,75,19257
7/31/2022,21,10332,2997,4491,902,0,75,18797
7/31/2022,22,10345,2148,4068,1265,0,75,17901
7/31/2022,23,10342,871,3674,1435,0,34,16356
7/31/2022,24,10343,237,3639,1543,0,15,15777
8/1/2022,1,10345,172,3558,1596,0,11,15682
8/1/2022,2,10354,172,3493,1722,0,11,15752
8/1/2022,3,10360,172,3566,1884,0,11,15993
8/1/2022,4,10347,173,3852,1932,0,11,16315
8/1/2022,5,10336,186,4194,1845,1,11,16573
8/1/2022,6,10332,286,3774,1788,4,12,16196
8/1/2022,7,10330,487,3877,1565,35,12,16306
8/1/2022,8,10333,712,4277,1366,127,18,16833
8/1/2022,9,10328,1290,4593,1481,208,24,17924
8/1/2022,10,10327,1795,4492,1828,291,24,18757
8/1/2022,11,10327,2146,3833,2319,326,24,18975
8/1/2022,12,10320,2443,3820,2937,326,24,19870
8/1/2022,13,10313,2545,3834,2962,319,23,19996
8/1/2022,14,10308,2388,4083,3269,337,25,20410
8/1/2022,15,10297,2380,4490,3142,318,24,20651
8/1/2022,16,10284,2530,4698,2853,233,24,20622
8/1/2022,17,10279,2791,5198,2624,170,24,21086
8/1/2022,18,10286,2942,5076,2298,70,23,20695
8/1/2022,19,10295,3084,4806,1871,23,24,20103
8/1/2022,20,10306,3088,4797,1983,2,23,20199
8/1/2022,21,10303,2568,4505,2394,0,23,19793
8/1/2022,22,10306,1954,4364,2351,0,23,18998
8/1/2022,23,10266,1008,4085,2270,0,23,17652
8/1/2022,24,10214,289,4432,1972,0,13,16920
8/2/2022,1,10210,173,4286,1927,0,11,16607
8/2/2022,2,10215,181,4288,1690,0,11,16385
8/2/2022,3,10207,244,4356,1363,0,11,16181
8/2/2022,4,10211,255,4491,1283,0,11,16251
8/2/2022,5,10223,266,4013,1235,1,13,15751
8/2/2022,6,10246,601,3918,1110,3,11,15889
8/2/2022,7,10249,1294,4237,899,38,21,16738
8/2/2022,8,10250,2128,4406,773,112,47,17716
8/2/2022,9,10254,2366,4407,839,176,41,18083
8/2/2022,10,10266,3427,4507,653,245,34,19132
8/2/2022,11,10263,3690,4522,617,278,33,19403
8/2/2022,12,10263,3825,4717,732,257,29,19823
8/2/2022,13,10264,3910,4774,725,307,25,20005
8/2/2022,14,10307,3901,4885,591,289,42,20015
8/2/2022,15,10345,3954,5012,617,304,79,20311
8/2/2022,16,10349,4193,5159,509,260,106,20576
8/2/2022,17,10348,4737,5258,378,195,130,21046
8/2/2022,18,10353,4876,5211,258,114,155,20967
8/2/2022,19,10352,4645,4845,184,30,150,20206
8/2/2022,20,10350,4311,4790,228,4,102,19785
8/2/2022,21,10342,3921,4610,352,0,81,19306
8/2/2022,22,10342,3417,4430,459,0,73,18721
8/2/2022,23,10344,1971,3929,603,0,35,16882
8/2/2022,24,10337,1236,3830,751,0,15,16169
8/3/2022,1,10348,532,3620,1075,0,11,15586
8/3/2022,2,10339,208,3456,1295,0,12,15310
8/3/2022,3,10341,182,3406,1613,0,11,15553
8/3/2022,4,10340,179,3379,1943,0,11,15852
8/3/2022,5,10332,311,3478,1820,2,11,15954
8/3/2022,6,10325,638,3403,1598,3,11,15978
8/3/2022,7,10318,1330,3655,1397,44,11,16755
8/3/2022,8,10310,1923,3825,1093,122,20,17293
8/3/2022,9,10304,2523,3709,1320,186,24,18066
8/3/2022,10,10303,2634,3697,1386,251,28,18299
8/3/2022,11,10304,3003,3791,1006,294,33,18431
8/3/2022,12,10298,3203,3746,1866,328,29,19470
8/3/2022,13,10298,3351,3820,2415,376,46,20306
8/3/2022,14,10298,3373,4144,2283,299,77,20474
8/3/2022,15,10315,3646,4590,2353,219,83,21206
8/3/2022,16,10325,4322,4923,2069,205,91,21935
8/3/2022,17,10317,3982,4908,1974,153,97,21431
8/3/2022,18,10307,3789,4944,1674,50,98,20862
8/3/2022,19,10309,3543,4557,1992,17,55,20473
8/3/2022,20,10299,3618,4728,1840,0,36,20521
8/3/2022,21,10280,3666,4890,1529,0,24,20389
8/3/2022,22,10267,3260,4546,1445,0,24,19542
8/3/2022,23,10260,1721,4442,1577,0,24,18024
8/3/2022,24,10260,575,3844,2012,0,13,16704
8/4/2022,1,10259,363,3801,1965,0,11,16399
8/4/2022,2,10260,200,4098,1825,0,11,16394
8/4/2022,3,10260,182,4379,1561,0,11,16393
8/4/2022,4,10265,271,4392,1366,0,11,16305
8/4/2022,5,10273,385,4267,1214,1,11,16151
8/4/2022,6,10280,1235,4306,794,2,11,16628
8/4/2022,7,10283,2222,3814,478,3,11,16811
8/4/2022,8,10282,2228,3814,473,3,11,16811
8/4/2022,9,10282,2228,3814,473,3,11,16811
8/4/2022,10,10282,2228,3814,473,3,11,16811
8/4/2022,11,10282,2228,3814,473,3,11,16811
8/4/2022,12,10282,2228,3814,473,3,11,16811
8/4/2022,13,10282,2228,3814,473,3,11,16811
8/4/2022,14,10314,4806,4846,550,220,74,20810
8/4/2022,15,10322,4811,5041,626,250,75,21125
8/4/2022,16,10321,4849,5129,551,185,73,21108
8/4/2022,17,10319,5122,5140,400,150,85,21216
8/4/2022,18,10312,5240,5156,400,77,108,21293
8/4/2022,19,10299,4724,4876,383,24,83,20389
8/4/2022,20,10288,4690,4773,387,2,85,20225
8/4/2022,21,10277,4912,4663,311,0,106,20269
8/4/2022,22,10287,4401,4424,307,0,86,19505
8/4/2022,23,10291,3705,4269,300,0,35,18600
8/4/2022,24,10294,2483,4177,288,0,13,17255
8/5/2022,1,10302,1409,4223,252,0,12,16198
8/5/2022,2,10315,949,4188,236,0,11,15699
8/5/2022,3,10321,1211,3933,315,0,11,15791
8/5/2022,4,10321,1545,3752,445,0,11,16074
8/5/2022,5,10321,2056,3527,452,1,11,16368
8/5/2022,6,10312,2420,3387,461,3,11,16594
8/5/2022,7,10308,2652,3574,260,24,11,16829
8/5/2022,8,10304,2910,4150,231,104,17,17716
8/5/2022,9,10311,3758,4360,96,210,23,18758
8/5/2022,10,10305,4250,4583,83,227,24,19472
8/5/2022,11,10286,4625,4652,135,254,24,19976
8/5/2022,12,10260,4879,4718,204,281,32,20374
8/5/2022,13,10249,4878,4617,264,354,56,20418
8/5/2022,14,10245,5100,4639,262,289,81,20616
8/5/2022,15,10231,4838,4794,253,273,94,20483
8/5/2022,16,10219,5028,4957,173,206,109,20692
8/5/2022,17,10220,4649,5138,175,131,115,20428
8/5/2022,18,10234,4580,5124,280,101,114,20433
8/5/2022,19,10241,4795,4863,413,27,119,20458
8/5/2022,20,10243,4714,4810,400,2,118,20287
8/5/2022,21,10218,4742,4550,508,0,111,20129
8/5/2022,22,10253,3632,4514,628,0,81,19108
8/5/2022,23,10270,2799,4375,623,0,42,18109
8/5/2022,24,10281,1664,4279,693,0,21,16938
8/6/2022,1,10295,682,4059,705,0,19,15760
8/6/2022,2,10300,252,3965,729,0,19,15265
8/6/2022,3,10293,178,3702,773,0,19,14965
8/6/2022,4,10285,180,3794,730,0,19,15008
8/6/2022,5,10275,432,3895,721,0,20,15343
8/6/2022,6,10273,925,3134,696,2,20,15050
8/6/2022,7,10260,1803,3332,629,28,20,16072
8/6/2022,8,10248,2362,3765,538,119,30,17062
8/6/2022,9,10237,2684,4544,415,209,34,18123
8/6/2022,10,10224,3592,4547,392,297,36,19088
8/6/2022,11,10226,4266,4867,525,355,31,20270
8/6/2022,12,10208,4322,4736,735,365,40,20406
8/6/2022,13,10194,4238,4848,941,379,67,20667
8/6/2022,14,10193,4503,4880,1003,367,98,21044
8/6/2022,15,10191,4593,4984,994,351,110,21223
8/6/2022,16,10184,4600,4985,1050,297,97,21213
8/6/2022,17,10180,4636,5181,909,201,89,21196
8/6/2022,18,10180,4880,5198,726,97,50,21131
8/6/2022,19,10178,5200,5137,573,25,42,21155
8/6/2022,20,10175,5045,4765,665,2,41,20693
8/6/2022,21,10168,4882,4708,892,0,37,20687
8/6/2022,22,10166,4412,4587,1197,0,32,20394
8/6/2022,23,10166,3108,4359,1254,0,32,18919
8/6/2022,24,10171,2563,3909,1352,0,22,18017
8/7/2022,1,10176,1713,3737,1479,0,20,17125
8/7/2022,2,10173,1212,3566,1565,0,21,16537
8/7/2022,3,10170,749,3608,1427,0,21,15975
8/7/2022,4,10169,727,3499,1295,0,21,15711
8/7/2022,5,10175,1007,3630,1075,2,21,15910
8/7/2022,6,10179,1323,3364,917,4,21,15808
8/7/2022,7,10185,1916,3206,768,27,22,16124
8/7/2022,8,10191,2535,3886,634,103,28,17377
8/7/2022,9,10199,3517,3997,720,174,42,18649
8/7/2022,10,10200,3757,4285,998,206,72,19518
8/7/2022,11,10207,4188,4552,1235,202,75,20459
8/7/2022,12,10204,3964,4607,1483,267,71,20596
8/7/2022,13,10203,4087,4646,1673,289,78,20976
8/7/2022,14,10200,3692,4641,1939,319,87,20878
8/7/2022,15,10177,3811,4864,2005,326,93,21276
8/7/2022,16,10170,4249,5157,1701,273,93,21643
8/7/2022,17,10164,4566,5182,1506,168,89,21675
8/7/2022,18,10161,4191,5281,1300,72,91,21096
8/7/2022,19,10159,4604,5344,868,28,90,21093
8/7/2022,20,10158,5016,5195,739,6,108,21222
8/7/2022,21,10159,5138,4783,653,6,94,20833
8/7/2022,22,10173,4902,4638,820,6,78,20617
8/7/2022,23,10188,4117,4131,798,6,35,19275
8/7/2022,24,10187,3313,3966,817,6,15,18304
8/8/2022,1,10199,2506,3893,865,6,11,17480
8/8/2022,2,10203,2003,3729,818,6,11,16770
8/8/2022,3,10204,1804,3680,827,6,11,16532
8/8/2022,4,10203,1838,3421,1136,6,11,16615
8/8/2022,5,10211,2317,3323,982,7,11,16851
8/8/2022,6,10213,2873,3447,1024,1,11,17569
8/8/2022,7,10214,3138,4092,1028,6,11,18489
8/8/2022,8,10213,3913,4095,1171,35,41,19468
8/8/2022,9,10215,3971,4110,1317,76,73,19762
8/8/2022,10,10217,4683,4379,1230,117,75,20701
8/8/2022,11,10214,4754,4397,1365,144,76,20950
8/8/2022,12,10213,4617,4296,2018,235,75,21454
8/8/2022,13,10200,4257,4227,2506,193,76,21459
8/8/2022,14,10190,4443,4448,2701,166,75,22023
8/8/2022,15,10189,4912,4698,2717,198,77,22791
8/8/2022,16,10202,4606,4684,2488,181,83,22244
8/8/2022,17,10194,4739,4659,2321,110,85,22108
8/8/2022,18,10192,4759,4911,1882,56,84,21884
8/8/2022,19,10211,4651,4683,2091,30,80,21746
8/8/2022,20,10221,3791,4666,2172,24,75,20949
8/8/2022,21,10216,4160,4383,1857,24,75,20715
8/8/2022,22,10207,3342,4231,1957,24,75,19836
8/8/2022,23,10214,2043,4002,1810,24,36,18129
8/8/2022,24,10204,814,3961,1656,24,13,16672
8/9/2022,1,10219,686,3810,1366,24,12,16117
8/9/2022,2,10234,506,3787,1315,24,12,15878
8/9/2022,3,10254,528,3840,1148,24,12,15806
8/9/2022,4,10283,828,3575,994,24,11,15715
8/9/2022,5,10302,1337,3402,812,25,12,15890
8/9/2022,6,10312,1699,3327,665,26,11,16040
8/9/2022,7,10322,1795,3530,455,47,11,16160
8/9/2022,8,10328,2093,4093,402,99,19,17034
8/9/2022,9,10327,2514,3929,482,162,24,17438
8/9/2022,10,10332,2711,4136,495,185,24,17883
8/9/2022,11,10350,2996,4044,482,224,24,18120
8/9/2022,12,10337,3171,4071,465,243,24,18311
8/9/2022,13,10344,3296,4249,477,259,24,18649
8/9/2022,14,10344,3327,4267,459,271,24,18692
8/9/2022,15,10344,3559,4073,456,263,24,18719
8/9/2022,16,10335,3564,4442,426,225,25,19017
8/9/2022,17,10322,3738,4716,398,156,32,19362
8/9/2022,18,10325,3670,4810,399,89,59,19352
8/9/2022,19,10343,3607,4692,324,43,74,19083
8/9/2022,20,10347,3534,4683,243,7,73,18887
8/9/2022,21,10366,3443,4429,243,1,73,18555
8/9/2022,22,10374,2458,4269,260,0,76,17437
8/9/2022,23,10385,1294,4087,236,0,33,16035
8/9/2022,24,10400,484,3848,198,0,14,14944
8/10/2022,1,10412,239,3797,192,0,11,14651
8/10/2022,2,10429,281,3763,169,0,12,14654
8/10/2022,3,10428,306,3705,219,0,11,14669
8/10/2022,4,10412,407,3668,260,0,11,14758
8/10/2022,5,10397,703,3320,260,0,11,14691
8/10/2022,6,10377,1117,3575,208,8,13,15298
8/10/2022,7,10374,1449,3630,162,58,11,15684
8/10/2022,8,10373,1685,4060,121,155,18,16412
8/10/2022,9,10359,2100,4135,120,279,23,17016
8/10/2022,10,10359,2319,4130,218,343,23,17392
8/10/2022,11,10352,2700,4299,254,337,27,17969
8/10/2022,12,10341,2916,4270,304,367,30,18228
8/10/2022,13,10321,2994,4277,354,381,39,18366
8/10/2022,14,10319,3227,4445,412,371,49,18823
8/10/2022,15,10302,3349,4682,460,382,81,19256
8/10/2022,16,10301,4019,4886,541,320,95,20162
8/10/2022,17,10286,4824,4874,586,229,128,20927
8/10/2022,18,10281,4862,4794,642,120,129,20828
8/10/2022,19,10289,4469,4643,754,25,97,20277
8/10/2022,20,10314,3661,4596,931,3,96,19601
8/10/2022,21,10348,3202,4510,1033,0,90,19183
8/10/2022,22,10351,2719,4049,1187,0,81,18387
8/10/2022,23,10318,1651,3677,1242,0,76,16964
8/10/2022,24,10292,1010,3271,1375,0,22,15970
8/11/2022,1,10295,567,3373,1609,0,12,15856
8/11/2022,2,10287,256,2833,1801,0,11,15188
8/11/2022,3,10285,416,2810,1648,0,11,15170
8/11/2022,4,10293,566,2885,1572,0,11,15327
8/11/2022,5,10324,584,2908,1410,1,13,15240
8/11/2022,6,10371,640,3073,1301,2,13,15400
8/11/2022,7,10393,764,3503,918,25,17,15620
8/11/2022,8,10408,1093,3884,1075,107,28,16595
8/11/2022,9,10414,1241,3878,1009,211,30,16783
8/11/2022,10,10437,1738,3871,726,325,40,17137
8/11/2022,11,10445,1909,3928,879,340,33,17534
8/11/2022,12,10450,2179,3767,1012,308,26,17742
8/11/2022,13,10444,2224,3692,1116,309,27,17812
8/11/2022,14,10447,2264,3796,1062,341,27,17937
8/11/2022,15,10448,2528,3847,1048,351,34,18256
8/11/2022,16,10433,2310,4037,1654,333,59,18826
8/11/2022,17,10416,2561,4085,1909,229,78,19278
8/11/2022,18,10393,2346,4163,1813,117,79,18911
8/11/2022,19,10365,2245,3952,1893,29,79,18563
8/11/2022,20,10354,2047,3709,1685,1,78,17874
8/11/2022,21,10350,1194,3888,1772,0,77,17281
8/11/2022,22,10349,941,3798,1675,0,78,16841
8/11/2022,23,10353,307,3408,1718,0,75,15861
8/11/2022,24,10366,148,3342,1515,0,20,15391
8/12/2022,1,10403,145,3260,1365,0,17,15190
8/12/2022,2,10460,146,3571,1120,0,17,15314
8/12/2022,3,10477,146,3445,996,0,17,15081
8/12/2022,4,10483,144,3619,852,0,17,15115
8/12/2022,5,10482,149,3268,716,2,17,14634
8/12/2022,6,10481,258,2991,678,2,16,14426
8/12/2022,7,10479,411,3049,527,32,16,14514
8/12/2022,8,10469,764,3975,309,126,24,15667
8/12/2022,9,10465,1297,4040,103,228,29,16162
8/12/2022,10,10455,1312,4010,75,302,29,16183
8/12/2022,11,10443,1471,4232,90,335,28,16599
8/12/2022,12,10434,1590,4106,194,338,27,16689
8/12/2022,13,10400,1674,3915,365,343,28,16725
8/12/2022,14,10387,1750,3921,519,340,28,16945
8/12/2022,15,10372,1689,3998,512,327,45,16943
8/12/2022,16,10375,2259,4279,454,281,84,17732
8/12/2022,17,10378,2624,4352,435,212,105,18106
8/12/2022,18,10396,2800,4521,305,108,101,18231
8/12/2022,19,10415,2880,4392,226,21,127,18061
8/12/2022,20,10424,2733,4229,211,1,126,17724
8/12/2022,21,10435,2251,4151,200,0,83,17120
8/12/2022,22,10437,1535,3860,225,0,75,16132
8/12/2022,23,10441,877,3369,181,0,75,14943
8/12/2022,24,10442,296,3507,310,0,26,14581
8/13/2022,1,10447,192,3580,289,0,16,14524
8/13/2022,2,10430,214,3671,238,0,15,14568
8/13/2022,3,10412,187,3444,216,0,15,14274
8/13/2022,4,10389,157,3496,162,0,15,14219
8/13/2022,5,10383,144,3455,107,1,15,14105
8/13/2022,6,10381,139,3394,98,2,15,14029
8/13/2022,7,10384,139,3279,62,37,15,13916
8/13/2022,8,10402,141,3462,34,133,22,14194
8/13/2022,9,10410,162,3646,8,237,27,14490
8/13/2022,10,10412,268,3919,11,300,27,14937
8/13/2022,11,10409,491,4065,37,336,27,15365
8/13/2022,12,10395,833,3994,51,333,27,15633
8/13/2022,13,10376,945,4024,71,323,27,15766
8/13/2022,14,10357,1235,3985,138,307,46,16068
8/13/2022,15,10343,1525,4156,144,276,79,16523
8/13/2022,16,10368,1772,3901,159,246,79,16525
8/13/2022,17,10369,2064,4299,124,152,87,17095
8/13/2022,18,10371,2311,4119,89,53,96,17039
8/13/2022,19,10366,1995,4144,69,13,81,16668
8/13/2022,20,10361,1463,4231,59,2,97,16213
8/13/2022,21,10363,1164,4229,44,0,118,15918
8/13/2022,22,10376,767,4087,36,0,127,15393
8/13/2022,23,10387,277,3709,44,0,64,14481
8/13/2022,24,10395,169,3569,71,0,49,14253
8/14/2022,1,10399,141,3396,111,0,46,14093
8/14/2022,2,10398,142,3442,149,0,49,14180
8/14/2022,3,10396,196,3632,121,0,40,14385
8/14/2022,4,10389,240,3507,155,0,36,14327
8/14/2022,5,10387,149,3201,195,1,44,13977
8/14/2022,6,10376,140,2936,203,3,35,13693
8/14/2022,7,10379,145,3109,279,39,31,13982
8/14/2022,8,10386,158,3042,262,89,33,13970
8/14/2022,9,10385,284,3497,145,169,32,14512
8/14/2022,10,10395,635,3828,104,254,27,15243
8/14/2022,11,10398,1373,3749,103,251,30,15904
8/14/2022,12,10389,1567,3603,90,291,33,15973
8/14/2022,13,10352,1634,3877,79,220,28,16190
8/14/2022,14,10353,1787,3890,74,195,27,16326
8/14/2022,15,10357,1764,3903,141,173,29,16367
8/14/2022,16,10349,1892,4052,176,206,31,16706
8/14/2022,17,10348,2140,4330,158,147,49,17172
8/14/2022,18,10339,2334,4287,114,74,78,17226
8/14/2022,19,10331,2270,4158,117,28,78,16982
8/14/2022,20,10321,1978,4194,141,14,78,16726
8/14/2022,21,10303,1729,4176,169,12,78,16467
8/14/2022,22,10302,1059,3992,210,12,67,15642
8/14/2022,23,10294,768,3793,255,12,27,15149
8/14/2022,24,10316,426,3510,399,12,18,14681
8/15/2022,1,10328,324,3504,481,8,14,14659
8/15/2022,2,10343,169,3504,479,0,15,14510
8/15/2022,3,10339,200,3510,455,0,15,14519
8/15/2022,4,10341,319,3239,560,0,14,14473
8/15/2022,5,10339,463,3295,763,1,17,14878
8/15/2022,6,10333,816,2742,994,2,16,14903
8/15/2022,7,10324,1635,2970,338,38,15,15320
8/15/2022,8,10306,1776,3227,464,126,24,15923
8/15/2022,9,10295,1899,3485,487,204,28,16398
8/15/2022,10,10311,2180,3520,535,292,27,16865
8/15/2022,11,10305,2442,3593,634,350,27,17351
8/15/2022,12,10303,2513,3788,704,373,30,17711
8/15/2022,13,10269,2846,3859,708,362,37,18081
8/15/2022,14,10254,3387,3992,660,294,64,18651
8/15/2022,15,10251,3852,3930,606,318,100,19057
8/15/2022,16,10245,4169,3966,609,307,107,19403
8/15/2022,17,10251,4080,4298,652,171,136,19588
8/15/2022,18,10260,4025,4287,586,85,153,19396
8/15/2022,19,10268,3762,4191,664,33,152,19070
8/15/2022,20,10276,3402,4073,774,5,130,18660
8/15/2022,21,10282,3425,3739,906,1,166,18519
8/15/2022,22,10284,2530,3475,1028,0,102,17419
8/15/2022,23,10292,1496,3526,963,0,47,16324
8/15/2022,24,10294,802,3384,990,0,33,15503
8/16/2022,1,10294,224,3242,1146,0,27,14933
8/16/2022,2,10288,160,3169,1287,0,18,14922
8/16/2022,3,10284,169,3337,1137,0,18,14945
8/16/2022,4,10276,354,3376,1042,0,17,15065
8/16/2022,5,10263,846,2886,823,1,17,14836
8/16/2022,6,10251,1495,2989,897,3,22,15657
8/16/2022,7,10250,1937,2953,629,24,20,15813
8/16/2022,8,10249,2448,3518,573,111,27,16926
8/16/2022,9,10267,3226,3640,265,210,29,17637
8/16/2022,10,10281,3321,3634,269,280,29,17814
8/16/2022,11,10292,3489,3769,196,295,30,18071
8/16/2022,12,10289,3935,4055,188,264,27,18758
8/16/2022,13,10282,3911,3871,251,261,24,18600
8/16/2022,14,10275,4145,3886,417,251,44,19018
8/16/2022,15,10262,3937,3930,602,249,70,19050
8/16/2022,16,10238,4478,4106,537,191,96,19646
8/16/2022,17,10225,4527,4373,520,154,78,19877
8/16/2022,18,10226,4469,4414,395,76,82,19662
8/16/2022,19,10235,3880,4323,496,21,81,19036
8/16/2022,20,10245,3662,4291,506,1,81,18786
8/16/2022,21,10245,3566,4189,472,0,78,18550
8/16/2022,22,10249,3094,3737,459,0,78,17617
8/16/2022,23,10254,2192,3738,300,0,43,16527
8/16/2022,24,10263,1778,3648,253,0,24,15966
8/17/2022,1,10273,1281,3526,270,0,22,15372
8/17/2022,2,10277,673,3280,286,0,27,14543
8/17/2022,3,10280,658,3345,379,0,29,14691
8/17/2022,4,10281,947,3070,380,0,38,14716
8/17/2022,5,10277,1458,3263,322,1,37,15358
8/17/2022,6,10280,1698,3128,322,1,27,15456
8/17/2022,7,10274,2075,3028,185,19,25,15606
8/17/2022,8,10266,2304,3128,131,98,33,15960
8/17/2022,9,10266,2320,3632,70,199,38,16525
8/17/2022,10,10256,2982,3765,39,289,42,17373
8/17/2022,11,10246,3445,4004,42,374,44,18155
8/17/2022,12,10249,3961,3884,83,395,37,18609
8/17/2022,13,10249,3965,3959,165,379,38,18755
8/17/2022,14,10241,3669,4025,269,338,40,18582
8/17/2022,15,10223,3727,4050,327,308,45,18680
8/17/2022,16,10218,4165,4089,381,262,76,19191
8/17/2022,17,10218,4164,4297,350,182,87,19298
8/17/2022,18,10219,4331,4372,175,106,85,19288
8/17/2022,19,10221,4245,4140,126,32,85,18849
8/17/2022,20,10226,4232,4228,114,5,93,18898
8/17/2022,21,10233,3832,3794,92,0,101,18052
8/17/2022,22,10240,2857,3730,106,0,53,16986
8/17/2022,23,10239,1769,3573,49,0,45,15675
8/17/2022,24,10231,1062,3480,10,0,36,14819
8/18/2022,1,10232,742,3399,36,0,28,14437
8/18/2022,2,10225,615,3303,74,0,29,14246
8/18/2022,3,10222,577,3386,99,0,27,14311
8/18/2022,4,10201,740,3340,91,0,25,14397
8/18/2022,5,10205,1090,2948,125,1,28,14397
8/18/2022,6,10195,1596,2955,94,5,32,14877
8/18/2022,7,10196,1883,3045,109,40,32,15305
8/18/2022,8,10196,2211,3117,71,139,34,15768
8/18/2022,9,10198,2556,3379,30,262,38,16463
8/18/2022,10,10203,2720,3889,27,341,34,17214
8/18/2022,11,10205,3308,3931,19,381,34,17878
8/18/2022,12,10219,3732,3981,90,374,34,18430
8/18/2022,13,10224,4027,3964,184,379,43,18821
8/18/2022,14,10209,4269,4056,312,338,75,19259
8/18/2022,15,10180,4440,4041,462,298,88,19509
8/18/2022,16,10166,4619,4062,580,261,92,19780
8/18/2022,17,10166,4635,4698,620,176,96,20391
8/18/2022,18,10151,4650,4693,489,92,90,20165
8/18/2022,19,10132,4515,4601,458,27,91,19824
8/18/2022,20,10142,4109,4599,458,10,135,19453
8/18/2022,21,10154,3768,4369,422,6,149,18868
8/18/2022,22,10169,2848,3948,427,1,99,17492
8/18/2022,23,10175,1562,3847,389,0,83,16056
8/18/2022,24,10205,843,3653,395,0,35,15131
8/19/2022,1,10208,334,3579,469,0,22,14612
8/19/2022,2,10206,181,3573,543,0,22,14525
8/19/2022,3,10215,176,3366,624,0,22,14403
8/19/2022,4,10212,194,3409,612,0,22,14449
8/19/2022,5,10218,337,3334,529,0,22,14440
8/19/2022,6,10213,715,3381,471,1,22,14803
8/19/2022,7,10212,1405,3117,443,36,22,15235
8/19/2022,8,10214,2363,3226,182,128,30,16143
8/19/2022,9,10211,2803,3614,169,255,33,17085
8/19/2022,10,10196,3326,3794,304,342,34,17996
8/19/2022,11,10193,3726,4171,410,373,35,18908
8/19/2022,12,10175,4090,4361,460,291,34,19411
8/19/2022,13,10156,4233,4293,521,295,43,19541
8/19/2022,14,10150,4493,4328,541,311,70,19893
8/19/2022,15,10161,4040,4311,533,346,84,19475
8/19/2022,16,10154,4099,4471,499,298,85,19606
8/19/2022,17,10153,4275,4775,351,156,86,19796
8/19/2022,18,10163,4454,4634,278,79,85,19693
8/19/2022,19,10173,4563,4496,307,17,87,19643
8/19/2022,20,10182,4110,4312,438,0,88,19130
8/19/2022,21,10191,3365,4454,564,0,84,18658
8/19/2022,22,10196,2642,3902,634,0,84,17458
8/19/2022,23,10193,1796,3762,676,0,85,16512
8/19/2022,24,10196,958,3588,744,0,24,15510
8/20/2022,1,10195,560,3180,782,0,12,14729
8/20/2022,2,10185,431,3162,794,0,20,14592
8/20/2022,3,10173,462,3104,744,0,22,14505
8/20/2022,4,10171,534,3161,699,0,22,14587
8/20/2022,5,10189,685,3029,611,0,22,14536
8/20/2022,6,10196,947,2996,548,2,22,14711
8/20/2022,7,10202,1167,2852,573,29,22,14845
8/20/2022,8,10200,1607,3098,313,121,30,15369
8/20/2022,9,10195,2154,3549,270,224,33,16425
8/20/2022,10,10189,2687,3593,301,313,33,17116
8/20/2022,11,10183,3332,3770,357,332,38,18012
8/20/2022,12,10173,3419,4117,365,351,35,18460
8/20/2022,13,10166,3601,4136,450,352,43,18748
8/20/2022,14,10160,3977,4222,460,349,81,19249
8/20/2022,15,10147,4096,4367,516,316,104,19546
8/20/2022,16,10137,4384,4433,485,241,103,19783
8/20/2022,17,10132,4463,4510,299,141,100,19645
8/20/2022,18,10127,3567,4588,430,50,102,18864
8/20/2022,19,10132,3278,4211,721,17,58,18417
8/20/2022,20,10126,3585,4498,482,4,35,18730
8/20/2022,21,10136,4010,4395,387,4,34,18966
8/20/2022,22,10150,3246,4136,397,4,33,17966
8/20/2022,23,10145,2404,3850,204,4,33,16640
8/20/2022,24,10151,1807,3659,181,4,23,15825
8/21/2022,1,10156,983,3617,308,4,21,15089
8/21/2022,2,10170,826,3489,231,4,21,14741
8/21/2022,3,10176,502,3387,357,4,21,14447
8/21/2022,4,10171,262,3236,423,4,20,14116
8/21/2022,5,10175,274,3115,384,5,10,13963
8/21/2022,6,10169,453,3162,353,5,10,14152
8/21/2022,7,10167,753,3170,401,22,10,14523
8/21/2022,8,10169,842,3059,394,63,10,14537
8/21/2022,9,10169,1145,3430,378,116,10,15248
8/21/2022,10,10150,2081,3767,323,103,10,16434
8/21/2022,11,10160,2791,3779,303,146,15,17194
8/21/2022,12,10167,3038,4007,339,191,18,17760
8/21/2022,13,10161,2785,4111,469,195,27,17748
8/21/2022,14,10148,2740,4185,424,203,36,17736
8/21/2022,15,10135,3528,4257,339,176,42,18477
8/21/2022,16,10134,3839,4436,293,134,42,18878
8/21/2022,17,10131,3860,4557,193,107,48,18896
8/21/2022,18,10115,3414,4670,198,64,53,18514
8/21/2022,19,10101,3583,4433,166,18,55,18356
8/21/2022,20,10095,3975,4526,151,1,55,18803
8/21/2022,21,10098,3559,4348,175,0,55,18235
8/21/2022,22,10113,2956,4046,181,0,48,17344
8/21/2022,23,10118,1835,3879,170,0,43,16045
8/21/2022,24,10125,1226,3718,199,0,24,15292
8/22/2022,1,10143,786,3670,188,0,20,14807
8/22/2022,2,10159,794,3558,180,0,20,14711
8/22/2022,3,10160,568,3456,200,0,20,14404
8/22/2022,4,10170,666,3495,253,0,21,14605
8/22/2022,5,10175,841,3252,306,0,21,14595
8/22/2022,6,10170,1262,3613,369,2,26,15442
8/22/2022,7,10159,1705,3699,422,22,41,16048
8/22/2022,8,10156,2655,3792,358,55,52,17068
8/22/2022,9,10151,3052,3769,311,110,52,17445
8/22/2022,10,10152,3078,3818,382,158,46,17634
8/22/2022,11,10162,3464,3849,485,136,52,18148
8/22/2022,12,10158,3672,4216,586,102,59,18793
8/22/2022,13,10158,3939,4345,658,164,65,19329
8/22/2022,14,10157,4067,4265,794,216,64,19563
8/22/2022,15,10159,3551,4237,823,200,68,19038
8/22/2022,16,10166,3421,4407,1129,123,67,19313
8/22/2022,17,10166,3356,4373,1245,74,66,19280
8/22/2022,18,10164,3579,4469,991,52,64,19319
8/22/2022,19,10162,3759,4228,853,13,64,19079
8/22/2022,20,10166,3736,4244,773,1,64,18984
8/22/2022,21,10172,3512,4127,720,0,57,18588
8/22/2022,22,10176,2803,4139,641,0,57,17816
8/22/2022,23,10180,1934,3936,474,0,65,16589
8/22/2022,24,10185,1197,3844,327,0,58,15611
8/23/2022,1,10176,420,3446,273,0,56,14371
8/23/2022,2,10171,536,3289,261,0,58,14315
8/23/2022,3,10174,581,3262,265,0,58,14340
8/23/2022,4,10179,626,3320,342,0,59,14526
8/23/2022,5,10193,817,3222,415,0,60,14707
8/23/2022,6,10204,1464,3432,439,0,59,15598
8/23/2022,7,10208,2033,3425,450,11,61,16188
8/23/2022,8,10195,2451,3842,290,49,64,16891
8/23/2022,9,10186,3071,4052,165,117,54,17645
8/23/2022,10,10177,3812,4008,173,169,46,18385
8/23/2022,11,10169,4228,3973,250,222,51,18893
8/23/2022,12,10163,4497,4091,315,242,58,19366
8/23/2022,13,10167,4348,4013,356,217,56,19157
8/23/2022,14,10175,4429,4316,370,197,51,19538
8/23/2022,15,10183,4559,4663,461,238,52,20156
8/23/2022,16,10185,4428,4865,519,209,48,20254
8/23/2022,17,10177,4926,4930,465,148,46,20692
8/23/2022,18,10180,4911,4877,389,63,48,20468
8/23/2022,19,10176,4645,4544,329,17,51,19762
8/23/2022,20,10179,4508,4390,406,1,47,19531
8/23/2022,21,10182,4176,4226,386,0,44,19014
8/23/2022,22,10193,3446,4139,310,0,40,18128
8/23/2022,23,10210,2211,4043,224,0,43,16731
8/23/2022,24,10222,1702,3947,199,0,35,16105
8/24/2022,1,10237,1251,3429,208,0,29,15154
8/24/2022,2,10244,861,2885,168,0,22,14180
8/24/2022,3,10228,821,3204,182,0,28,14463
8/24/2022,4,10217,981,3412,191,0,38,14839
8/24/2022,5,10210,1133,3122,240,0,38,14743
8/24/2022,6,10220,1464,2877,207,1,34,14803
8/24/2022,7,10230,1932,3330,228,18,36,15774
8/24/2022,8,10236,2519,3740,187,99,39,16820
8/24/2022,9,10225,3032,4099,81,220,34,17691
8/24/2022,10,10211,3588,4109,73,336,34,18351
8/24/2022,11,10203,4052,4195,105,392,33,18980
8/24/2022,12,10192,4484,4277,128,386,33,19500
8/24/2022,13,10180,4490,4472,181,348,36,19707
8/24/2022,14,10182,4879,4549,275,359,48,20292
8/24/2022,15,10182,4955,4648,340,309,78,20512
8/24/2022,16,10190,4911,4914,432,238,86,20771
8/24/2022,17,10205,5117,5030,458,173,99,21082
8/24/2022,18,10208,4582,5091,446,69,97,20493
8/24/2022,19,10201,4519,4768,413,13,95,20009
8/24/2022,20,10201,4614,4706,422,2,89,20034
8/24/2022,21,10211,4531,4361,423,2,86,19614
8/24/2022,22,10223,4127,4217,346,2,42,18957
8/24/2022,23,10240,2762,4115,290,2,33,17442
8/24/2022,24,10249,1449,3935,333,2,25,15993
8/25/2022,1,10251,1309,3495,317,2,21,15395
8/25/2022,2,10257,869,3343,451,2,21,14943
8/25/2022,3,9930,1015,3493,454,2,21,14915
8/25/2022,4,9370,1547,3987,347,2,21,15274
8/25/2022,5,9376,1579,3491,509,4,21,14980
8/25/2022,6,9379,1554,3569,496,4,21,15023
8/25/2022,7,9368,1552,3591,609,27,22,15169
8/25/2022,8,9345,2469,3871,456,112,28,16281
8/25/2022,9,9331,2959,4026,311,209,35,16871
8/25/2022,10,9883,3228,3893,195,297,35,17531
8/25/2022,11,10206,3531,4207,228,340,34,18546
8/25/2022,12,10195,4266,4412,309,323,34,19539
8/25/2022,13,10175,4415,4438,372,318,28,19746
8/25/2022,14,10155,4519,4376,392,291,24,19757
8/25/2022,15,10150,4622,4407,377,269,29,19854
8/25/2022,16,10142,4848,4686,319,187,33,20215
8/25/2022,17,10142,4406,4960,255,112,34,19909
8/25/2022,18,10152,3887,5298,188,53,34,19612
8/25/2022,19,10154,4031,5094,245,8,34,19566
8/25/2022,20,10150,4252,4796,375,0,34,19607
8/25/2022,21,10147,4087,4619,502,0,34,19389
8/25/2022,22,10167,3321,4333,573,0,34,18428
8/25/2022,23,10174,2031,4228,551,0,33,17017
8/25/2022,24,10172,1733,3761,337,0,26,16029
8/26/2022,1,10169,1164,3550,346,0,22,15251
8/26/2022,2,10156,957,3570,342,0,22,15047
8/26/2022,3,10151,1084,3352,357,0,21,14965
8/26/2022,4,10146,1396,3339,378,0,11,15270
8/26/2022,5,10148,1630,3181,444,1,11,15415
8/26/2022,6,10145,1865,3427,451,2,11,15901
8/26/2022,7,10144,2257,3694,430,27,19,16571
8/26/2022,8,10141,2986,3930,390,68,27,17542
8/26/2022,9,10144,3465,4300,333,103,32,18377
8/26/2022,10,10143,3868,4275,463,150,32,18931
8/26/2022,11,10139,3757,4291,734,218,33,19172
8/26/2022,12,10150,3771,4266,925,199,33,19344
8/26/2022,13,10150,3984,4265,1082,275,33,19789
8/26/2022,14,10156,3503,4350,1236,279,34,19558
8/26/2022,15,10173,3446,4633,1411,245,34,19942
8/26/2022,16,10167,3391,4441,1301,205,32,19537
8/26/2022,17,10173,3273,4965,1173,143,32,19759
8/26/2022,18,10178,2931,4807,1163,57,32,19168
8/26/2022,19,10194,2598,4600,1052,16,32,18492
8/26/2022,20,10207,2484,4501,904,0,33,18129
8/26/2022,21,10221,2718,4315,831,0,34,18119
8/26/2022,22,10218,2407,4020,765,0,34,17444
8/26/2022,23,10222,1299,3634,781,0,34,15970
8/26/2022,24,10221,736,3446,747,0,24,15174
8/27/2022,1,10216,498,3248,614,0,22,14598
8/27/2022,2,10200,489,3244,494,0,22,14449
8/27/2022,3,10200,463,2980,390,0,22,14055
8/27/2022,4,10192,462,3095,344,0,22,14115
8/27/2022,5,10197,460,3033,363,1,23,14077
8/27/2022,6,10205,486,3115,403,3,23,14235
8/27/2022,7,10199,586,2994,343,38,24,14184
8/27/2022,8,10195,1036,3316,244,150,29,14970
8/27/2022,9,10197,1356,3627,132,274,34,15620
8/27/2022,10,10197,1883,3578,133,343,38,16172
8/27/2022,11,10187,1986,3606,181,405,34,16399
8/27/2022,12,10171,2144,3731,197,418,33,16694
8/27/2022,13,10167,2384,3538,214,418,39,16760
8/27/2022,14,10162,2380,3562,247,410,49,16810
8/27/2022,15,10148,2643,3487,226,387,48,16939
8/27/2022,16,10142,2623,3892,285,310,44,17296
8/27/2022,17,10137,2791,4598,273,209,33,18041
8/27/2022,18,10150,3068,4571,238,97,33,18157
8/27/2022,19,10149,3001,4288,277,34,33,17782
8/27/2022,20,10148,2583,4168,377,23,33,17332
8/27/2022,21,10158,2333,3920,545,22,34,17012
8/27/2022,22,10152,1444,3730,806,5,33,16170
8/27/2022,23,10150,527,3217,1205,0,33,15132
8/27/2022,24,10159,411,2919,1335,0,33,14857
8/28/2022,1,10163,251,2913,1529,0,25,14881
8/28/2022,2,10166,176,2882,1821,0,22,15067
8/28/2022,3,10171,177,2752,1885,0,22,15007
8/28/2022,4,10174,195,2958,1652,0,22,15001
8/28/2022,5,10180,193,3320,1351,1,22,15067
8/28/2022,6,10185,278,3522,1258,2,22,15267
8/28/2022,7,10181,511,3062,1176,36,23,14989
8/28/2022,8,10170,1017,3360,777,137,27,15488
8/28/2022,9,10148,1571,3322,489,251,33,15814
8/28/2022,10,10137,1923,3267,228,343,33,15931
8/28/2022,11,10120,2273,3386,419,387,33,16618
8/28/2022,12,10121,2348,3751,543,396,35,17194
8/28/2022,13,10118,2575,3943,619,408,34,17697
8/28/2022,14,10118,2676,4274,710,399,33,18210
8/28/2022,15,10121,3121,4419,766,364,33,18824
8/28/2022,16,10120,3718,4479,776,298,33,19424
8/28/2022,17,10119,4181,4735,871,211,33,20150
8/28/2022,18,10119,4195,4862,887,98,33,20194
8/28/2022,19,10118,4526,4536,857,38,33,20108
8/28/2022,20,10120,4553,4287,1136,1,33,20130
8/28/2022,21,10115,3731,4045,1519,0,33,19443
8/28/2022,22,10103,2820,3597,1795,0,33,18348
8/28/2022,23,10097,1757,3352,1951,0,33,17190
8/28/2022,24,10089,544,2988,2454,0,12,16087
8/29/2022,1,10095,196,2828,2701,0,22,15842
8/29/2022,2,10103,196,2855,2849,0,22,16025
8/29/2022,3,10105,253,3241,2973,0,22,16594
8/29/2022,4,10110,241,3237,3024,0,22,16634
8/29/2022,5,10109,483,2825,3088,1,22,16528
8/29/2022,6,10106,1127,2715,2849,2,22,16821
8/29/2022,7,10103,1779,3028,2522,27,22,17481
8/29/2022,8,10102,2523,3494,2480,99,27,18725
8/29/2022,9,10094,2915,3816,2487,173,34,19519
8/29/2022,10,10081,3596,4048,2685,191,33,20634
8/29/2022,11,10074,3708,4018,2775,282,35,20892
8/29/2022,12,10067,3955,4010,2897,295,35,21259
8/29/2022,13,10062,3930,4165,2856,340,43,21396
8/29/2022,14,10049,4063,4285,2987,358,56,21798
8/29/2022,15,10042,4022,4399,3029,251,88,21831
8/29/2022,16,10048,4065,4529,2842,191,103,21778
8/29/2022,17,10038,4560,4733,2665,107,103,22206
8/29/2022,18,10046,4450,4737,2669,52,101,22055
8/29/2022,19,10052,4055,4815,2512,11,101,21546
8/29/2022,20,10056,4711,4604,1993,0,143,21507
8/29/2022,21,10047,4852,4386,1985,0,188,21458
8/29/2022,22,10051,3771,3798,2361,0,140,20121
8/29/2022,23,10069,2329,3708,2361,0,46,18513
8/29/2022,24,10073,1410,3460,2540,0,26,17509
8/30/2022,1,10054,1023,3036,2453,0,21,16587
8/30/2022,2,10044,997,2959,2526,0,21,16547
8/30/2022,3,10062,1196,3127,2365,0,21,16771
8/30/2022,4,10058,1550,3216,2261,0,21,17106
8/30/2022,5,10062,1892,2956,1906,0,21,16837
8/30/2022,6,10067,2252,3172,1759,1,22,17273
8/30/2022,7,10061,2782,3567,1570,13,23,18016
8/30/2022,8,10066,3672,4238,1274,27,30,19307
8/30/2022,9,10071,4006,4192,1332,46,33,19680
8/30/2022,10,10073,4022,4152,1427,58,33,19765
8/30/2022,11,10078,4014,4200,1481,99,29,19901
8/30/2022,12,10063,4230,4148,1732,99,40,20312
8/30/2022,13,10059,3548,4214,2061,115,71,20068
8/30/2022,14,10068,3520,4254,2216,123,87,20268
8/30/2022,15,10071,3551,4332,2399,186,87,20626
8/30/2022,16,10070,3480,4906,2564,158,87,21265
8/30/2022,17,10079,3504,5036,2590,91,87,21387
8/30/2022,18,10081,3481,4859,2724,31,87,21263
8/30/2022,19,10079,3373,4546,2859,12,85,20954
8/30/2022,20,10081,2929,4439,2838,0,85,20372
8/30/2022,21,10089,2359,3754,2814,0,85,19101
8/30/2022,22,10098,1751,3345,2669,0,85,17948
8/30/2022,23,10109,486,3433,2305,0,42,16375
8/30/2022,24,10138,181,3394,2033,0,27,15773
8/31/2022,1,10158,176,3354,1809,0,21,15518
8/31/2022,2,10167,168,3173,1663,0,21,15192
8/31/2022,3,10179,167,3119,1802,0,21,15288
8/31/2022,4,10180,170,2970,1934,0,22,15276
8/31/2022,5,10186,173,2724,1859,0,22,14964
8/31/2022,6,10187,292,2863,2014,3,21,15380
8/31/2022,7,10199,444,3266,1898,28,22,15857
8/31/2022,8,10200,674,3642,2478,117,23,17134
8/31/2022,9,10198,1061,3856,2423,229,32,17799
8/31/2022,10,10202,1324,3679,2533,327,34,18099
8/31/2022,11,10207,1720,3629,2746,371,34,18707
8/31/2022,12,10205,1854,3507,2968,390,33,18957
8/31/2022,13,10207,1858,3517,3046,347,34,19009
8/31/2022,14,10194,1856,3607,3097,301,39,19094
8/31/2022,15,10192,1650,3597,3193,312,70,19014
8/31/2022,16,10193,1847,3682,3354,277,85,19438
8/31/2022,17,10198,1815,3972,3265,194,85,19529
8/31/2022,18,10197,1868,4471,3072,83,83,19774
8/31/2022,19,10205,1843,4242,2789,29,84,19192
8/31/2022,20,10225,2305,4073,2459,11,123,19196
8/31/2022,21,10243,1979,3914,2453,1,122,18712
8/31/2022,22,10266,1126,3412,2288,0,41,17133
8/31/2022,23,10262,611,3195,2314,0,33,16415
8/31/2022,24,10270,208,2806,2101,0,24,15409
9/1/2022,1,10278,132,2736,1985,0,21,15152
9/1/2022,2,10283,144,3007,1640,0,21,15095
9/1/2022,3,10278,266,3590,966,0,21,15121
9/1/2022,4,10270,404,3777,527,0,21,14999
9/1/2022,5,10279,473,3468,430,0,21,14671
9/1/2022,6,10294,907,3129,284,5,21,14640
9/1/2022,7,10308,1120,3385,276,35,21,15145
9/1/2022,8,10305,1326,3549,208,156,21,15565
9/1/2022,9,10297,1364,3620,172,279,23,15755
9/1/2022,10,10283,1539,3630,152,366,31,16001
9/1/2022,11,10292,1525,4090,161,390,33,16491
9/1/2022,12,10282,1758,4016,227,396,33,16712
9/1/2022,13,10277,1754,3750,281,398,34,16494
9/1/2022,14,10275,1782,3752,380,392,39,16620
9/1/2022,15,10273,2038,3906,471,387,60,17135
9/1/2022,16,10266,2411,4123,483,324,84,17691
9/1/2022,17,10271,2901,4485,471,219,85,18432
9/1/2022,18,10284,3433,4726,367,105,90,19005
9/1/2022,19,10290,3599,4314,277,40,138,18658
9/1/2022,20,10296,3271,4235,376,33,107,18318
9/1/2022,21,10297,2630,4190,454,33,89,17693
9/1/2022,22,10308,1842,3691,628,20,86,16575
9/1/2022,23,10306,875,3698,771,4,84,15738
9/1/2022,24,10301,663,3482,954,0,33,15433
9/2/2022,1,10297,206,3114,1283,0,23,14923
9/2/2022,2,10292,148,3008,1340,0,23,14811
9/2/2022,3,10289,188,3263,1361,0,22,15123
9/2/2022,4,10294,183,3302,1425,0,22,15226
9/2/2022,5,10288,197,3040,1538,0,22,15085
9/2/2022,6,10287,191,3117,1623,2,22,15242
9/2/2022,7,10284,211,3245,1445,21,22,15228
9/2/2022,8,10282,366,3532,1476,128,22,15806
9/2/2022,9,10276,673,4127,1225,235,23,16559
9/2/2022,10,10271,1425,4102,1310,335,29,17472
9/2/2022,11,10267,1955,3770,1433,387,33,17845
9/2/2022,12,10272,2264,3748,1485,409,35,18213
9/2/2022,13,10275,2377,4176,1493,406,41,18768
9/2/2022,14,10269,2402,4349,1490,386,64,18960
9/2/2022,15,10270,2853,4474,1516,355,84,19552
9/2/2022,16,10233,3390,4700,1402,289,84,20098
9/2/2022,17,10195,3641,4876,1239,176,84,20211
9/2/2022,18,10246,3485,4820,1092,61,83,19787
9/2/2022,19,10273,3177,4773,1103,10,95,19431
9/2/2022,20,10280,2884,4573,1387,0,89,19213
9/2/2022,21,10063,2287,4289,1722,0,86,18447
9/2/2022,22,9466,1993,3781,1953,0,42,17235
9/2/2022,23,9506,1339,3195,1985,0,33,16058
9/2/2022,24,9512,364,3609,1834,0,24,15343
9/3/2022,1,9500,282,4026,1661,0,22,15491
9/3/2022,2,9489,219,3366,1548,0,22,14644
9/3/2022,3,9482,214,3340,1484,0,22,14542
9/3/2022,4,9469,153,3221,1417,0,21,14281
9/3/2022,5,9463,369,3428,1366,0,21,14647
9/3/2022,6,9454,789,3397,1330,1,21,14992
9/3/2022,7,9449,1297,3184,1233,17,21,15201
9/3/2022,8,9482,1561,3657,970,70,21,15761
9/3/2022,9,9501,1891,4065,613,175,22,16267
9/3/2022,10,9510,2261,4099,481,319,29,16699
9/3/2022,11,9509,2766,4286,456,343,32,17392
9/3/2022,12,9507,3327,4328,423,371,32,17988
9/3/2022,13,9501,3229,4301,526,396,55,18008
9/3/2022,14,9501,3365,4230,731,394,83,18304
9/3/2022,15,9481,3240,4612,802,354,83,18572
9/3/2022,16,9459,3216,4876,796,280,83,18710
9/3/2022,17,9455,3232,4918,821,174,83,18683
9/3/2022,18,9462,3169,4907,782,71,82,18473
9/3/2022,19,9457,3411,4762,787,15,89,18521
9/3/2022,20,9446,3385,4529,908,9,89,18366
9/3/2022,21,9447,3075,4488,927,9,77,18023
9/3/2022,22,9460,2746,4300,1078,9,41,17634
9/3/2022,23,9490,2233,3788,1168,9,30,16718
9/3/2022,24,9499,1631,3629,1077,9,21,15866
9/4/2022,1,9506,1164,3653,813,9,16,15161
9/4/2022,2,9529,843,3702,735,9,16,14834
9/4/2022,3,9542,281,3432,810,9,16,14090
9/4/2022,4,9527,318,3435,813,9,16,14118
9/4/2022,5,9524,425,3307,816,6,16,14094
9/4/2022,6,9536,559,3502,844,2,15,14458
9/4/2022,7,9549,881,3602,944,7,15,14998
9/4/2022,8,9557,1428,3489,914,38,15,15441
9/4/2022,9,9554,1763,3151,921,59,15,15463
9/4/2022,10,9559,1811,3355,716,84,23,15548
9/4/2022,11,9562,1792,3637,695,115,28,15829
9/4/2022,12,9571,1804,3936,599,133,28,16071
9/4/2022,13,9573,1821,3658,656,147,28,15883
9/4/2022,14,9560,1741,3391,714,153,30,15589
9/4/2022,15,9543,1757,3469,684,130,28,15611
9/4/2022,16,9533,1849,3744,685,118,39,15968
9/4/2022,17,9520,1879,3934,768,74,70,16245
9/4/2022,18,9517,1692,4012,780,29,80,16110
9/4/2022,19,9510,1710,4280,731,3,79,16313
9/4/2022,20,9514,1710,4181,753,0,78,16236
9/4/2022,21,9533,1423,3846,721,0,78,15601
9/4/2022,22,9549,1173,3848,659,0,54,15283
9/4/2022,23,9566,728,3662,698,0,27,14681
9/4/2022,24,9585,409,3507,725,0,17,14243
9/5/2022,1,9585,242,3506,706,0,14,14053
9/5/2022,2,9574,228,3488,624,0,15,13929
9/5/2022,3,9574,229,3476,574,0,15,13868
9/5/2022,4,9561,231,3620,614,0,15,14041
9/5/2022,5,9539,235,3653,650,0,15,14092
9/5/2022,6,9529,226,3667,661,1,15,14099
9/5/2022,7,9538,287,3441,693,4,15,13978
9/5/2022,8,9550,570,3430,634,29,16,14229
9/5/2022,9,9546,994,3826,527,79,16,14988
9/5/2022,10,9545,1225,4084,624,115,23,15616
9/5/2022,11,9563,1282,3994,691,136,28,15694
9/5/2022,12,9582,1424,3590,638,154,31,15419
9/5/2022,13,9592,1532,3412,511,172,52,15271
9/5/2022,14,9595,1557,3651,740,185,79,15807
9/5/2022,15,9602,1673,4057,819,180,79,16410
9/5/2022,16,9608,1645,4012,772,151,79,16267
9/5/2022,17,9598,1962,4267,818,105,79,16829
9/5/2022,18,9597,1949,4330,816,45,80,16817
9/5/2022,19,9591,2105,4204,770,19,80,16769
9/5/2022,20,9583,2150,4126,931,5,81,16876
9/5/2022,21,9593,1723,3808,1188,0,80,16392
9/5/2022,22,9592,1166,3490,1225,0,80,15553
9/5/2022,23,9586,360,3564,1065,0,43,14618
9/5/2022,24,9540,182,3597,1018,0,20,14357
9/6/2022,1,9492,160,3432,1019,0,18,14121
9/6/2022,2,9444,160,3530,1010,0,17,14161
9/6/2022,3,9438,170,3314,1082,0,17,14021
9/6/2022,4,9422,293,3273,1017,0,16,14021
9/6/2022,5,9415,485,2956,1034,1,17,13908
9/6/2022,6,9403,763,3163,1003,6,17,14355
9/6/2022,7,9385,819,3571,1093,18,26,14912
9/6/2022,8,9378,1019,3911,930,62,30,15330
9/6/2022,9,9361,1338,4035,719,130,19,15602
9/6/2022,10,9349,1850,4045,552,201,28,16025
9/6/2022,11,9350,2421,3695,594,285,32,16377
9/6/2022,12,9330,2581,3784,673,336,34,16738
9/6/2022,13,9290,2168,3947,667,345,36,16453
9/6/2022,14,9270,2434,4131,697,298,38,16868
9/6/2022,15,9252,2803,3777,817,259,44,16952
9/6/2022,16,9253,3100,4253,945,215,76,17842
9/6/2022,17,9262,2861,4530,948,141,81,17823
9/6/2022,18,9264,3127,4448,940,61,77,17917
9/6/2022,19,9232,3204,4372,814,10,77,17709
9/6/2022,20,9240,3145,4359,817,4,76,17641
9/6/2022,21,9242,3001,3986,864,2,76,17171
9/6/2022,22,9244,2424,3806,765,0,39,16278
9/6/2022,23,9253,1608,3738,518,0,24,15141
9/6/2022,24,9275,1125,3552,424,0,15,14391
9/7/2022,1,9310,554,3471,341,0,12,13688
9/7/2022,2,9323,518,3409,332,0,12,13594
9/7/2022,3,9310,730,3198,299,0,12,13549
9/7/2022,4,9352,902,2999,278,0,12,13543
9/7/2022,5,9441,1132,3147,245,0,12,13977
9/7/2022,6,9465,1630,3518,213,1,13,14840
9/7/2022,7,9462,2553,3886,214,12,11,16138
9/7/2022,8,9455,2869,3729,168,67,11,16299
9/7/2022,9,9449,3090,3733,88,141,10,16511
9/7/2022,10,9460,3606,3872,100,164,23,17225
9/7/2022,11,9467,3591,3829,178,236,63,17364
9/7/2022,12,9452,3728,3940,266,272,74,17732
9/7/2022,13,9442,3600,4030,274,230,74,17650
9/7/2022,14,9442,3601,4241,436,210,75,18005
9/7/2022,15,9438,3569,4321,542,202,74,18146
9/7/2022,16,9436,3383,4557,573,205,74,18228
9/7/2022,17,9435,3856,4752,534,117,106,18800
9/7/2022,18,9436,4122,4785,473,59,166,19041
9/7/2022,19,9434,3469,4479,343,10,85,17820
9/7/2022,20,9428,3889,4106,545,0,75,18043
9/7/2022,21,9424,4090,3884,501,0,75,17974
9/7/2022,22,9429,3407,3809,448,0,75,17168
9/7/2022,23,9431,2836,3517,366,0,35,16185
9/7/2022,24,9459,2142,3457,345,0,17,15420
9/8/2022,1,9481,1197,3179,331,0,11,14199
9/8/2022,2,9469,1044,3151,307,0,10,13981
9/8/2022,3,9458,1234,3230,280,0,10,14212
9/8/2022,4,9450,1657,3308,259,0,10,14684
9/8/2022,5,9443,2086,2778,114,1,10,14432
9/8/2022,6,9439,2239,3364,197,2,10,15251
9/8/2022,7,9437,2592,3580,257,24,10,15900
9/8/2022,8,9443,2861,3865,236,129,10,16544
9/8/2022,9,9443,3373,3933,80,245,10,17084
9/8/2022,10,9437,3665,4119,83,332,19,17655
9/8/2022,11,9433,3868,4111,77,361,24,17874
9/8/2022,12,9422,3849,4082,99,340,40,17832
9/8/2022,13,9405,3900,4128,137,334,72,17976
9/8/2022,14,9391,4039,4158,198,322,77,18185
9/8/2022,15,9380,4102,4314,243,326,87,18452
9/8/2022,16,9380,4273,4379,254,303,113,18702
9/8/2022,17,9379,4129,4596,235,205,79,18623
9/8/2022,18,9387,4214,4751,210,96,77,18735
9/8/2022,19,9387,3651,4703,224,41,77,18083
9/8/2022,20,9382,3501,4598,245,9,80,17815
9/8/2022,21,9378,3593,4339,208,0,83,17601
9/8/2022,22,9388,3146,4129,307,0,94,17064
9/8/2022,23,9400,2292,3746,347,0,65,15850
9/8/2022,24,9405,2001,3494,359,0,59,15318
9/9/2022,1,9419,1181,3183,459,0,54,14296
9/9/2022,2,9427,1171,3294,399,0,54,14345
9/9/2022,3,9429,1273,3048,540,0,56,14346
9/9/2022,4,9415,1518,3272,486,0,56,14747
9/9/2022,5,9409,1913,2705,460,1,53,14541
9/9/2022,6,9414,2190,2814,300,1,57,14776
9/9/2022,7,9414,2332,3441,403,25,58,15673
9/9/2022,8,9412,2756,3564,367,121,59,16279
9/9/2022,9,9412,3309,3719,260,228,49,16977
9/9/2022,10,9413,3443,3831,316,307,55,17365
9/9/2022,11,9406,3476,3836,343,365,64,17490
9/9/2022,12,9393,3713,3764,444,375,60,17749
9/9/2022,13,9375,3875,3886,468,378,66,18048
9/9/2022,14,9370,4102,4189,479,365,67,18572
9/9/2022,15,9361,4230,4662,490,325,70,19138
9/9/2022,16,9356,4430,4847,501,262,90,19486
9/9/2022,17,9347,4451,5006,525,169,111,19609
9/9/2022,18,9349,4260,5106,421,67,114,19317
9/9/2022,19,9346,4337,4765,398,17,128,18991
9/9/2022,20,9337,4247,4685,534,11,117,18931
9/9/2022,21,9335,3747,4319,1006,11,85,18503
9/9/2022,22,9340,2936,3861,1308,11,85,17541
9/9/2022,23,8901,2164,3595,1399,11,44,16114
9/9/2022,24,8885,1132,3369,1304,11,27,14728
9/10/2022,1,8891,827,3425,1340,11,22,14516
9/10/2022,2,8899,456,3132,1460,5,22,13974
9/10/2022,3,8900,389,3290,1474,0,22,14075
9/10/2022,4,8904,401,3308,1325,0,22,13960
9/10/2022,5,8906,542,3385,1229,1,22,14085
9/10/2022,6,8908,987,3375,1042,2,22,14336
9/10/2022,7,8908,1804,3245,988,17,25,14987
9/10/2022,8,8911,2411,2990,587,99,30,15028
9/10/2022,9,8904,2555,3143,590,202,23,15417
9/10/2022,10,8902,2739,3641,516,294,30,16122
9/10/2022,11,8897,3451,3722,409,361,34,16874
9/10/2022,12,8895,3842,4041,400,371,34,17583
9/10/2022,13,8899,3981,4104,493,365,33,17875
9/10/2022,14,8892,4103,4374,562,324,68,18323
9/10/2022,15,8882,3852,4470,773,273,85,18335
9/10/2022,16,8871,3677,4560,974,198,87,18367
9/10/2022,17,8869,3507,4862,1025,120,87,18470
9/10/2022,18,8864,3450,4839,1140,41,73,18407
9/10/2022,19,8863,3474,4541,991,6,39,17914
9/10/2022,20,8854,3687,4179,1060,0,34,17814
9/10/2022,21,8858,3000,3881,1407,0,34,17180
9/10/2022,22,8858,1966,3473,1957,0,34,16288
9/10/2022,23,8859,1029,3521,2005,0,34,15448
9/10/2022,24,8863,614,3329,1876,0,28,14710
9/11/2022,1,8875,566,3409,1692,0,23,14565
9/11/2022,2,8881,482,3474,1403,0,23,14263
9/11/2022,3,8885,507,3550,1251,0,23,14216
9/11/2022,4,8886,484,3277,1187,0,23,13857
9/11/2022,5,8884,658,3318,1136,1,23,14020
9/11/2022,6,8888,784,3306,1014,1,23,14016
9/11/2022,7,8891,1086,3167,1003,16,23,14186
9/11/2022,8,8886,1686,2984,700,61,23,14340
9/11/2022,9,8880,2215,3207,481,104,23,14910
9/11/2022,10,8878,2584,3786,620,103,29,16000
9/11/2022,11,8881,2884,3852,661,151,34,16463
9/11/2022,12,8872,3179,3835,756,170,34,16846
9/11/2022,13,8870,2936,3954,768,170,34,16732
9/11/2022,14,8868,3131,3912,779,151,34,16875
9/11/2022,15,8868,2835,4003,749,147,48,16650
9/11/2022,16,8874,2733,3890,593,132,71,16293
9/11/2022,17,8856,3251,4045,522,90,74,16838
9/11/2022,18,8856,3185,4211,529,50,73,16904
9/11/2022,19,8867,2998,4329,505,24,74,16797
9/11/2022,20,8871,3181,4288,505,24,74,16943
9/11/2022,21,8877,2840,4033,664,24,33,16471
9/11/2022,22,8881,2642,3486,751,11,30,15801
9/11/2022,23,8880,2360,3251,770,6,26,15293
9/11/2022,24,8880,1625,2995,755,0,15,14270
9/12/2022,1,8879,1445,3143,627,0,11,14105
9/12/2022,2,8874,1708,3132,698,0,14,14426
9/12/2022,3,8880,1776,2916,647,0,31,14250
9/12/2022,4,8881,1770,3197,684,0,37,14569
9/12/2022,5,8886,1848,3050,664,1,33,14482
9/12/2022,6,8889,2215,3282,635,1,35,15057
9/12/2022,7,8890,2911,3398,710,6,48,15963
9/12/2022,8,8887,3525,3398,649,38,79,16576
9/12/2022,9,8870,3922,3392,671,113,70,17038
9/12/2022,10,8866,4133,3410,766,180,71,17426
9/12/2022,11,8863,4093,3302,974,230,102,17564
9/12/2022,12,8835,4097,3392,1282,251,83,17940
9/12/2022,13,8831,3831,3459,1428,214,53,17816
9/12/2022,14,8834,3905,3744,1609,224,67,18383
9/12/2022,15,8829,3933,4058,1393,199,66,18478
9/12/2022,16,8827,4325,4249,1429,164,77,19071
9/12/2022,17,8815,4245,4333,1431,101,77,19002
9/12/2022,18,8817,3861,4452,1307,30,79,18546
9/12/2022,19,8822,4170,4240,761,3,82,18078
9/12/2022,20,8825,4374,4087,571,0,81,17938
9/12/2022,21,8832,4118,3696,479,0,81,17206
9/12/2022,22,8837,3193,3559,528,0,79,16196
9/12/2022,23,8840,2524,3259,425,0,40,15088
9/12/2022,24,8842,2000,3182,337,0,23,14384
9/13/2022,1,8843,1653,3161,315,0,19,13991
9/13/2022,2,8844,1487,3179,258,0,19,13787
9/13/2022,3,8866,1758,3094,221,0,19,13958
9/13/2022,4,8866,1905,3119,185,0,19,14094
9/13/2022,5,8870,2008,3069,277,0,19,14243
9/13/2022,6,8871,2526,3172,336,2,19,14926
9/13/2022,7,8870,3352,3320,295,8,17,15862
9/13/2022,8,8867,4054,3331,242,39,30,16563
9/13/2022,9,8870,4007,3347,214,80,53,16571
9/13/2022,10,8880,4001,3486,186,159,76,16788
9/13/2022,11,8881,3866,3378,200,149,86,16560
9/13/2022,12,8881,3734,3442,261,117,91,16526
9/13/2022,13,8898,3095,3704,351,225,100,16373
9/13/2022,14,8884,2936,3781,531,248,113,16493
9/13/2022,15,8882,2983,4177,557,270,98,16967
9/13/2022,16,8883,3339,4507,481,252,105,17567
9/13/2022,17,8882,3763,4350,444,149,117,17705
9/13/2022,18,8889,3438,4124,453,48,111,17063
9/13/2022,19,8892,3259,4134,420,6,107,16818
9/13/2022,20,8891,3397,3782,548,2,89,16709
9/13/2022,21,8883,3192,3551,840,0,84,16550
9/13/2022,22,8886,2163,3454,1010,0,80,15593
9/13/2022,23,8887,1458,3118,1196,0,37,14696
9/13/2022,24,8890,744,3040,1225,0,25,13924
9/14/2022,1,8891,553,2953,1144,0,22,13563
9/14/2022,2,8897,554,3043,1106,0,22,13622
9/14/2022,3,8905,553,2982,1055,0,22,13517
9/14/2022,4,8904,557,3026,1085,0,22,13594
9/14/2022,5,8908,613,2822,1073,1,22,13439
9/14/2022,6,8914,919,3115,1082,2,22,14054
9/14/2022,7,8914,1461,3406,1254,19,37,15091
9/14/2022,8,8917,1842,3398,1147,109,70,15483
9/14/2022,9,8918,2017,3361,981,201,82,15560
9/14/2022,10,8917,2089,3345,995,277,89,15712
9/14/2022,11,8915,1874,3310,1087,349,93,15628
9/14/2022,12,8912,1877,3407,1131,333,93,15753
9/14/2022,13,8914,1968,3499,1106,324,93,15904
9/14/2022,14,8910,1879,3691,1235,305,108,16128
9/14/2022,15,8906,1897,3813,1301,241,119,16277
9/14/2022,16,8908,1932,4294,1346,193,117,16790
9/14/2022,17,8911,2174,4522,1179,120,130,17036
9/14/2022,18,8938,2105,4505,1083,40,141,16812
9/14/2022,19,8973,2249,4165,1052,4,161,16604
9/14/2022,20,8992,2149,3906,1193,0,177,16417
9/14/2022,21,9001,1928,3517,1215,0,163,15824
9/14/2022,22,9037,1362,3344,1158,0,107,15008
9/14/2022,23,9047,1032,3297,1094,0,40,14510
9/14/2022,24,9049,689,2803,1188,0,25,13754
9/15/2022,1,9043,735,2747,1125,0,23,13673
9/15/2022,2,9040,833,2845,1116,0,22,13856
9/15/2022,3,9030,870,3020,1031,0,22,13973
9/15/2022,4,9007,1057,3043,960,0,22,14089
9/15/2022,5,9000,1445,2573,747,1,22,13788
9/15/2022,6,8984,1533,2801,707,2,24,14051
9/15/2022,7,8981,1552,3069,790,25,31,14448
9/15/2022,8,8977,1490,3040,665,122,66,14360
9/15/2022,9,8977,1728,3313,400,237,157,14812
9/15/2022,10,8971,1723,3382,264,326,204,14870
9/15/2022,11,8968,1801,3315,167,348,162,14761
9/15/2022,12,8967,1541,3320,195,367,155,14545
9/15/2022,13,8970,1504,3244,233,384,164,14499
9/15/2022,14,8973,1661,3229,262,365,158,14648
9/15/2022,15,8968,1677,3548,256,346,134,14929
9/15/2022,16,8969,1869,3951,219,257,135,15400
9/15/2022,17,8965,1875,4081,216,136,133,15406
9/15/2022,18,8961,2108,4055,278,39,99,15540
9/15/2022,19,8961,1991,4186,408,2,95,15643
9/15/2022,20,8970,2240,3847,556,0,94,15707
9/15/2022,21,8975,1628,3488,716,0,84,14891
9/15/2022,22,8978,1082,3462,756,0,41,14319
9/15/2022,23,8977,503,3258,856,0,33,13627
9/15/2022,24,8978,219,3199,946,0,26,13368
9/16/2022,1,8969,142,2930,1034,0,24,13099
9/16/2022,2,8967,139,2975,1112,0,22,13215
9/16/2022,3,8971,258,2847,1166,0,22,13264
9/16/2022,4,8983,491,3004,1166,0,22,13666
9/16/2022,5,8988,879,2750,895,0,22,13534
9/16/2022,6,8986,988,2920,1032,1,22,13949
9/16/2022,7,8988,1389,3346,1027,10,40,14800
9/16/2022,8,8985,1388,3375,813,51,78,14690
9/16/2022,9,8981,1393,3419,532,133,96,14554
9/16/2022,10,8994,1532,3547,432,204,112,14821
9/16/2022,11,9002,1565,3781,423,246,117,15134
9/16/2022,12,9005,1565,3850,480,304,116,15320
9/16/2022,13,9021,1836,3873,485,280,116,15611
9/16/2022,14,9036,1965,3937,521,260,130,15849
9/16/2022,15,9025,2009,3974,566,237,141,15952
9/16/2022,16,8987,2115,4123,629,220,145,16219
9/16/2022,17,8956,2234,4298,632,122,113,16355
9/16/2022,18,8944,2440,4327,629,33,115,16488
9/16/2022,19,8918,2743,4329,560,2,125,16677
9/16/2022,20,8914,2567,4331,518,0,121,16451
9/16/2022,21,8913,2385,3913,605,0,159,15975
9/16/2022,22,8917,1919,3639,671,0,134,15280
9/16/2022,23,8918,1114,3331,735,0,86,14184
9/16/2022,24,8920,794,3331,820,0,39,13904
9/17/2022,1,8930,738,2958,835,0,22,13483
9/17/2022,2,8928,582,2946,785,0,22,13263
9/17/2022,3,8923,526,3155,787,0,22,13413
9/17/2022,4,8948,525,3084,788,0,22,13367
9/17/2022,5,8958,615,2914,843,0,22,13352
9/17/2022,6,8958,764,2762,847,2,23,13356
9/17/2022,7,8953,871,2843,903,8,46,13624
9/17/2022,8,8951,923,2986,780,62,74,13776
9/17/2022,9,8948,1113,3456,591,133,77,14318
9/17/2022,10,8948,1563,3430,580,228,85,14834
9/17/2022,11,8940,1737,3403,757,349,87,15273
9/17/2022,12,8933,1774,3354,751,371,87,15270
9/17/2022,13,8934,1934,3286,911,366,100,15531
9/17/2022,14,8930,1934,3600,1383,342,116,16305
9/17/2022,15,8940,1916,3696,1515,302,116,16485
9/17/2022,16,8939,1904,3788,1485,222,116,16454
9/17/2022,17,8934,2124,4085,1387,115,114,16759
9/17/2022,18,8929,2280,4108,1262,30,115,16724
9/17/2022,19,8930,1893,4072,1358,1,115,16369
9/17/2022,20,8926,1708,3463,1581,0,107,15785
9/17/2022,21,8924,1222,3332,1773,0,113,15364
9/17/2022,22,8921,991,3356,1867,0,112,15247
9/17/2022,23,8918,595,2871,2086,0,105,14575
9/17/2022,24,8927,240,2752,2075,0,77,14071
9/18/2022,1,8931,172,2726,2383,0,22,14234
9/18/2022,2,8927,172,2610,2375,0,22,14106
9/18/2022,3,8929,172,2579,2102,0,22,13804
9/18/2022,4,8944,172,2602,2012,0,22,13752
9/18/2022,5,8946,177,2853,2315,0,22,14313
9/18/2022,6,8950,296,2747,2144,0,22,14159
9/18/2022,7,8945,560,2770,1769,7,22,14073
9/18/2022,8,8940,818,3005,1772,52,22,14609
9/18/2022,9,8937,940,3397,1780,101,42,15197
9/18/2022,10,8940,1158,3546,1698,146,86,15574
9/18/2022,11,8942,1401,3587,1663,196,111,15900
9/18/2022,12,8946,1533,3706,1692,205,112,16194
9/18/2022,13,8948,1788,3420,1961,211,112,16440
9/18/2022,14,8939,1938,3404,1899,147,95,16422
9/18/2022,15,8940,1934,3577,1625,89,87,16252
9/18/2022,16,8941,1941,3782,2122,113,105,17004
9/18/2022,17,8947,2010,4056,2143,92,105,17353
9/18/2022,18,8947,2090,4259,1875,24,110,17305
9/18/2022,19,8952,2082,4366,1884,0,111,17395
9/18/2022,20,8953,2145,4081,1955,0,111,17245
9/18/2022,21,8958,1995,3571,1800,0,111,16435
9/18/2022,22,8954,1223,3752,1889,0,112,15930
9/18/2022,23,8953,600,3264,1881,0,86,14784
9/18/2022,24,8953,360,3298,1882,0,38,14531
9/19/2022,1,8956,338,2743,1880,0,22,13939
9/19/2022,2,8954,344,2889,1895,0,22,14104
9/19/2022,3,8942,488,2957,1739,0,23,14149
9/19/2022,4,8941,884,3126,1593,0,23,14567
9/19/2022,5,8942,1553,2702,1237,0,27,14461
9/19/2022,6,8948,1890,2897,1441,2,27,15205
9/19/2022,7,8955,1935,3198,1499,3,22,15612
9/19/2022,8,8954,2420,3527,1063,31,22,16017
9/19/2022,9,8952,2802,3535,1148,47,22,16506
9/19/2022,10,8954,2577,3515,1282,91,29,16448
9/19/2022,11,8957,2335,3498,1420,124,34,16368
9/19/2022,12,8958,2458,3868,1758,192,34,17268
9/19/2022,13,8959,2328,4028,2096,230,33,17674
9/19/2022,14,8957,2319,3719,2235,233,33,17496
9/19/2022,15,8948,2336,3889,2053,240,34,17500
9/19/2022,16,8959,2367,4581,1883,144,36,17970
9/19/2022,17,8963,2450,4814,1742,103,34,18106
9/19/2022,18,8972,2385,4617,1492,38,34,17538
9/19/2022,19,8975,2369,4699,1163,0,34,17240
9/19/2022,20,8982,2374,4747,917,0,34,17054
9/19/2022,21,8977,2014,4445,822,0,35,16293
9/19/2022,22,8978,1491,3865,844,0,35,15213
9/19/2022,23,8987,698,3669,854,0,34,14242
9/19/2022,24,8985,581,3302,797,0,25,13690
9/20/2022,1,8994,447,3371,992,0,21,13825
9/20/2022,2,8999,471,3610,936,0,21,14037
9/20/2022,3,8995,706,3494,1020,0,21,14236
9/20/2022,4,8989,1131,3560,1007,0,21,14708
9/20/2022,5,8989,1629,3306,527,0,21,14472
9/20/2022,6,8994,1647,3569,670,1,21,14902
9/20/2022,7,9003,1779,4102,589,9,21,15503
9/20/2022,8,9004,1920,4245,494,71,21,15755
9/20/2022,9,9013,2018,4278,314,159,22,15804
9/20/2022,10,9027,2082,4280,267,255,30,15941
9/20/2022,11,9042,2203,4309,337,266,33,16190
9/20/2022,12,9044,2175,4354,472,286,33,16364
9/20/2022,13,9036,2551,4400,420,287,33,16727
9/20/2022,14,9018,3077,4537,410,231,33,17306
9/20/2022,15,9023,2891,4686,566,198,33,17397
9/20/2022,16,9019,2503,4802,754,180,33,17291
9/20/2022,17,9027,2741,5046,611,92,34,17551
9/20/2022,18,9033,2851,5093,460,19,33,17489
9/20/2022,19,9034,2834,4762,855,0,33,17518
9/20/2022,20,9028,2270,4794,1081,0,32,17205
9/20/2022,21,9029,1966,4692,959,0,32,16678
9/20/2022,22,9015,1110,4547,997,0,32,15701
9/20/2022,23,9006,635,4337,876,0,32,14886
9/20/2022,24,9002,477,3969,903,0,24,14375
9/21/2022,1,8996,249,4017,1042,0,20,14324
9/21/2022,2,8986,165,3952,1004,0,20,14127
9/21/2022,3,8980,167,4134,916,0,19,14216
9/21/2022,4,8979,165,3932,1202,0,12,14290
9/21/2022,5,8999,223,3714,1244,0,11,14191
9/21/2022,6,9018,360,3565,1808,1,11,14763
9/21/2022,7,9029,398,3711,2361,9,15,15523
9/21/2022,8,9030,441,3850,2582,60,21,15984
9/21/2022,9,9028,549,4020,2944,151,17,16709
9/21/2022,10,9026,1008,4321,2973,161,21,17510
9/21/2022,11,9018,1579,4530,2588,145,25,17885
9/21/2022,12,9011,2492,4723,1908,189,30,18353
9/21/2022,13,8994,2185,4513,1899,192,33,17816
9/21/2022,14,8980,1912,4194,1632,150,32,16900
9/21/2022,15,8971,1972,4397,2136,153,33,17662
9/21/2022,16,8956,2325,4792,2555,148,33,18809
9/21/2022,17,8944,2365,4799,2359,93,33,18593
9/21/2022,18,8945,2345,4764,2326,17,33,18430
9/21/2022,19,8943,2106,4864,2479,0,48,18440
9/21/2022,20,8954,1792,4505,2879,0,60,18190
9/21/2022,21,8960,1480,4195,3106,0,50,17791
9/21/2022,22,8972,769,4340,3045,0,54,17180
9/21/2022,23,8977,260,4062,3024,0,60,16383
9/21/2022,24,8989,166,3936,2639,0,53,15783
9/22/2022,1,9034,142,3276,2943,0,47,15442
9/22/2022,2,9068,142,3206,2557,0,48,15021
9/22/2022,3,9089,142,3080,2440,0,48,14799
9/22/2022,4,9104,143,2982,2535,0,44,14808
9/22/2022,5,9103,144,2971,2274,0,44,14536
9/22/2022,6,9109,173,3428,2703,2,45,15460
9/22/2022,7,9111,276,3738,2979,15,45,16164
9/22/2022,8,9111,529,3875,2822,108,41,16486
9/22/2022,9,9103,545,3900,3300,218,25,17091
9/22/2022,10,9102,668,3987,3037,232,30,17056
9/22/2022,11,9103,886,3989,3020,231,34,17263
9/22/2022,12,9098,1154,3996,2986,232,34,17500
9/22/2022,13,9102,1247,3838,2907,279,34,17407
9/22/2022,14,9095,1078,3888,2746,255,35,17097
9/22/2022,15,9083,1389,3909,2712,243,34,17370
9/22/2022,16,9077,1599,4092,2511,204,34,17517
9/22/2022,17,9081,1597,4232,2700,99,34,17743
9/22/2022,18,9091,1309,4485,2606,30,34,17555
9/22/2022,19,9100,974,4570,3012,0,34,17690
9/22/2022,20,9102,835,4535,3115,0,34,17621
9/22/2022,21,9100,642,4514,2737,0,34,17027
9/22/2022,22,9107,427,4586,2381,0,34,16535
9/22/2022,23,9111,145,4284,2369,0,34,15943
9/22/2022,24,9113,144,3995,2250,0,25,15527
9/23/2022,1,9114,144,3256,2070,0,21,14605
9/23/2022,2,9126,144,3241,1768,0,20,14299
9/23/2022,3,9136,150,3311,1594,0,20,14211
9/23/2022,4,9141,304,3619,1278,0,20,14362
9/23/2022,5,9181,621,3743,910,0,20,14475
9/23/2022,6,9205,1104,4019,765,1,20,15114
9/23/2022,7,9208,1351,4278,670,16,20,15543
9/23/2022,8,9211,1486,4264,532,123,21,15637
9/23/2022,9,9120,1327,4384,532,232,22,15617
9/23/2022,10,9113,1106,4376,666,339,29,15629
9/23/2022,11,9112,1095,4422,646,380,33,15688
9/23/2022,12,9108,876,4364,530,392,34,15304
9/23/2022,13,9108,790,4417,528,395,34,15272
9/23/2022,14,9111,1022,4188,357,366,34,15078
9/23/2022,15,9148,1092,4091,235,310,33,14909
9/23/2022,16,9198,1335,4304,278,255,33,15403
9/23/2022,17,9194,1468,4452,317,142,33,15606
9/23/2022,18,9187,1618,4507,256,38,34,15640
9/23/2022,19,9185,1603,4795,273,1,34,15891
9/23/2022,20,9184,1596,4770,260,0,34,15844
9/23/2022,21,9186,1387,4491,300,0,34,15398
9/23/2022,22,9195,967,4308,288,0,34,14792
9/23/2022,23,9210,696,4245,290,0,34,14475
9/23/2022,24,9216,250,4380,240,0,24,14110
9/24/2022,1,9211,145,4502,220,0,23,14101
9/24/2022,2,9205,145,4427,244,0,23,14044
9/24/2022,3,9207,148,4338,281,0,23,13997
9/24/2022,4,9205,236,4180,340,0,23,13984
9/24/2022,5,9196,377,4223,410,0,23,14229
9/24/2022,6,9192,565,4283,528,2,23,14593
9/24/2022,7,9191,570,4131,610,16,23,14541
9/24/2022,8,9192,570,4103,634,100,22,14621
9/24/2022,9,9152,619,4492,438,196,22,14919
9/24/2022,10,9084,875,4754,351,328,29,15421
9/24/2022,11,9082,924,4746,414,367,33,15566
9/24/2022,12,9084,647,4700,398,308,33,15170
9/24/2022,13,9083,579,4724,440,253,33,15112
9/24/2022,14,9086,714,4774,464,223,34,15295
9/24/2022,15,9093,948,4609,529,185,33,15397
9/24/2022,16,9162,908,4727,590,139,33,15559
9/24/2022,17,9152,1158,4768,610,83,33,15804
9/24/2022,18,9157,1209,4872,510,14,34,15796
9/24/2022,19,9153,1243,5092,435,2,34,15959
9/24/2022,20,9153,1231,4808,619,0,34,15845
9/24/2022,21,9151,1226,4410,826,0,34,15647
9/24/2022,22,9159,751,4220,850,0,34,15014
9/24/2022,23,9171,326,4257,818,0,34,14606
9/24/2022,24,9182,147,4179,843,0,14,14365
9/25/2022,1,9178,147,3808,816,0,12,13961
9/25/2022,2,9165,147,3629,637,0,11,13589
9/25/2022,3,9160,144,3708,529,0,10,13551
9/25/2022,4,9160,245,3638,460,0,2,13505
9/25/2022,5,9159,358,3728,351,0,0,13596
9/25/2022,6,9158,477,3907,386,2,0,13930
9/25/2022,7,9160,481,4047,511,3,0,14202
9/25/2022,8,9155,531,4329,523,36,0,14574
9/25/2022,9,9160,783,4496,309,70,0,14818
9/25/2022,10,9156,932,4403,357,79,0,14927
9/25/2022,11,9139,964,4379,571,94,0,15147
9/25/2022,12,9136,901,4151,680,121,0,14989
9/25/2022,13,9145,862,4144,859,170,0,15180
9/25/2022,14,9150,989,4199,1054,138,0,15530
9/25/2022,15,9156,1082,4084,1398,80,0,15800
9/25/2022,16,9150,952,4441,1508,66,0,16117
9/25/2022,17,9150,1152,4489,1611,55,0,16457
9/25/2022,18,9152,1197,4662,1708,11,0,16730
9/25/2022,19,9151,1211,4840,1803,0,0,17005
9/25/2022,20,9145,1209,4618,1775,0,0,16747
9/25/2022,21,9143,966,4238,1916,0,0,16263
9/25/2022,22,9132,673,3984,1977,0,0,15766
9/25/2022,23,9117,321,3695,1830,0,0,14963
9/25/2022,24,9112,166,3587,1995,0,1,14861
9/26/2022,1,9119,167,3375,1934,0,4,14599
9/26/2022,2,9125,167,3147,1946,0,16,14401
9/26/2022,3,9126,167,3191,1716,0,22,14222
9/26/2022,4,9129,168,3162,1925,0,22,14406
9/26/2022,5,9128,328,3148,1906,0,22,14532
9/26/2022,6,9128,689,3180,2102,1,23,15123
9/26/2022,7,9135,1105,3686,2299,6,22,16253
9/26/2022,8,9136,1126,3665,2751,41,22,16741
9/26/2022,9,9139,1124,3719,2719,111,23,16835
9/26/2022,10,9137,1122,3741,2787,213,30,17030
9/26/2022,11,9140,1192,3771,2610,171,33,16917
9/26/2022,12,9137,1224,3757,3300,150,35,17603
9/26/2022,13,9141,982,3763,3284,179,34,17383
9/26/2022,14,9142,1030,3928,3433,218,37,17788
9/26/2022,15,9142,923,3832,3372,200,44,17513
9/26/2022,16,9147,909,4250,2701,114,51,17172
9/26/2022,17,9143,901,4379,3050,57,57,17587
9/26/2022,18,9152,806,4432,3134,23,54,17601
9/26/2022,19,9155,780,4493,3395,0,36,17859
9/26/2022,20,9156,781,4561,3226,0,34,17758
9/26/2022,21,9148,613,4646,2980,0,34,17421
9/26/2022,22,9142,346,4371,2906,0,34,16799
9/26/2022,23,9146,165,3643,2730,0,34,15718
9/26/2022,24,9153,166,3224,2520,0,26,15089
9/27/2022,1,9157,136,2830,2554,0,22,14699
9/27/2022,2,9166,134,2694,2350,0,22,14366
9/27/2022,3,9163,137,2746,2192,0,22,14260
9/27/2022,4,9155,279,2963,2052,0,22,14471
9/27/2022,5,9155,629,2825,1902,0,22,14533
9/27/2022,6,9155,1194,3211,1702,2,22,15286
9/27/2022,7,9156,1297,4073,1778,8,22,16334
9/27/2022,8,9152,1383,4331,1734,38,22,16660
9/27/2022,9,9151,1405,4306,1804,81,23,16770
9/27/2022,10,9157,1418,4147,1792,110,29,16653
9/27/2022,11,9112,1454,4106,1835,165,33,16705
9/27/2022,12,9158,1193,4010,1813,208,39,16421
9/27/2022,13,9156,975,4155,1891,216,34,16427
9/27/2022,14,9160,1338,3808,1827,167,35,16335
9/27/2022,15,9161,1549,3862,2093,160,34,16859
9/27/2022,16,9177,1552,4186,2438,82,33,17468
9/27/2022,17,9177,1623,4280,2480,30,34,17624
9/27/2022,18,9181,1685,4608,2255,11,34,17774
9/27/2022,19,9181,1683,4621,2101,0,34,17620
9/27/2022,20,9181,1683,4655,1845,0,34,17398
9/27/2022,21,9171,1281,4616,1721,0,34,16823
9/27/2022,22,9172,803,4430,1630,0,33,16068
9/27/2022,23,9180,466,4394,1459,0,33,15532
9/27/2022,24,9187,257,4305,1454,0,27,15230
9/28/2022,1,9183,167,3818,1491,0,22,14681
9/28/2022,2,9187,167,3877,1381,0,21,14633
9/28/2022,3,9189,174,3802,1307,0,21,14493
9/28/2022,4,9199,439,3413,1335,0,21,14407
9/28/2022,5,9204,933,3202,959,0,21,14319
9/28/2022,6,9203,1593,3334,1255,1,21,15407
9/28/2022,7,9204,1829,3635,1361,3,26,16058
9/28/2022,8,9205,1897,3733,1311,41,30,16217
9/28/2022,9,9204,1851,3685,1465,111,19,16335
9/28/2022,10,9204,1740,3376,1598,142,32,16092
9/28/2022,11,9211,1720,3449,1481,157,44,16062
9/28/2022,12,9216,1728,3629,1465,140,42,16220
9/28/2022,13,9216,1359,3835,1525,120,34,16089
9/28/2022,14,9214,1303,3741,1512,74,32,15876
9/28/2022,15,9215,1492,3645,1495,78,32,15957
9/28/2022,16,9214,1617,3820,1408,90,32,16181
9/28/2022,17,9211,1715,4047,1346,59,32,16410
9/28/2022,18,9215,1733,3945,1250,9,32,16184
9/28/2022,19,9212,1798,4159,949,0,33,16151
9/28/2022,20,9212,1867,4189,800,0,33,16101
9/28/2022,21,9206,1881,4218,670,0,32,16007
9/28/2022,22,9206,1594,4271,523,0,32,15626
9/28/2022,23,9205,883,4000,493,0,33,14614
9/28/2022,24,9205,276,4225,303,0,23,14032
9/29/2022,1,9203,182,4016,247,0,21,13669
9/29/2022,2,9202,273,4058,236,0,20,13789
9/29/2022,3,9192,432,3859,268,0,20,13771
9/29/2022,4,9200,724,3567,278,0,20,13789
9/29/2022,5,9204,1175,3584,310,0,20,14293
9/29/2022,6,9205,1603,4008,316,2,20,15154
9/29/2022,7,9205,1749,4328,315,12,20,15629
9/29/2022,8,9205,1817,4126,288,86,21,15543
9/29/2022,9,9207,1935,4145,250,211,21,15769
9/29/2022,10,9197,1710,4080,223,262,29,15501
9/29/2022,11,9195,1645,4040,170,364,34,15448
9/29/2022,12,9200,1642,3943,128,390,34,15337
9/29/2022,13,9193,1614,4094,130,385,34,15450
9/29/2022,14,9193,1628,4001,148,390,34,15394
9/29/2022,15,9194,1652,4055,136,362,35,15434
9/29/2022,16,9194,1684,3904,119,259,34,15194
9/29/2022,17,9200,1695,4449,105,141,33,15623
9/29/2022,18,9204,1695,4640,112,28,25,15704
9/29/2022,19,9202,1701,4780,167,0,23,15873
9/29/2022,20,9202,1649,4839,211,0,25,15926
9/29/2022,21,9205,1782,4633,235,0,29,15884
9/29/2022,22,9205,1743,4414,216,0,27,15605
9/29/2022,23,9202,1025,4210,236,0,27,14700
9/29/2022,24,9211,522,4162,309,0,18,14222
9/30/2022,1,9212,137,4033,324,0,18,13724
9/30/2022,2,9209,137,3913,302,0,17,13578
9/30/2022,3,9210,175,3955,269,0,17,13626
9/30/2022,4,9212,383,3682,251,0,19,13547
9/30/2022,5,9200,836,3379,317,0,17,13749
9/30/2022,6,9205,1538,3613,414,1,19,14790
9/30/2022,7,9204,1631,4147,508,18,20,15528
9/30/2022,8,9193,1773,4181,557,121,17,15842
9/30/2022,9,9183,1582,4121,322,259,18,15485
9/30/2022,10,9176,1596,4236,266,334,24,15632
9/30/2022,11,9172,1617,4253,281,374,29,15726
9/30/2022,12,9177,1598,4054,245,381,29,15484
9/30/2022,13,9179,1475,3876,273,367,29,15199
9/30/2022,14,8807,1506,4160,290,343,29,15135
9/30/2022,15,8651,1753,4620,256,273,30,15583
9/30/2022,16,8647,2026,4796,254,238,29,15990
9/30/2022,17,8646,2202,4767,276,139,29,16059
9/30/2022,18,8647,1880,4852,387,28,29,15823
9/30/2022,19,8646,1936,4753,478,1,29,15843
9/30/2022,20,8649,1922,4949,531,0,29,16080
9/30/2022,21,8645,2107,4584,690,0,29,16055
9/30/2022,22,8646,1684,4155,923,0,30,15438
9/30/2022,23,8624,1392,3503,966,0,30,14515
9/30/2022,24,8643,500,3472,823,0,17,13455
10/1/2022,1,8642,369,3633,798,0,0,13442
10/1/2022,2,8639,174,3281,905,0,0,12999
10/1/2022,3,8644,134,3311,1014,0,0,13103
10/1/2022,4,8640,133,3412,1039,0,0,13224
10/1/2022,5,8637,139,3353,1152,0,0,13281
10/1/2022,6,8639,287,3434,1294,2,0,13656
10/1/2022,7,8637,419,3687,1503,4,0,14250
10/1/2022,8,8640,575,3692,1602,31,0,14540
10/1/2022,9,8637,773,4281,1092,86,0,14869
10/1/2022,10,8636,1180,4410,838,148,0,15212
10/1/2022,11,8633,853,3755,842,222,0,14305
10/1/2022,12,8638,617,3621,1014,290,0,14180
10/1/2022,13,8638,678,3666,1109,279,0,14370
10/1/2022,14,8633,715,3662,1570,245,0,14825
10/1/2022,15,8629,855,3795,1097,198,0,14574
10/1/2022,16,8626,1089,3797,1591,167,0,15270
10/1/2022,17,8617,1087,3849,2114,98,0,15765
10/1/2022,18,8620,1087,4035,2276,28,0,16046
10/1/2022,19,8621,1092,4578,2386,10,0,16687
10/1/2022,20,8607,1080,4056,2505,10,0,16258
10/1/2022,21,8606,751,3927,2757,10,0,16051
10/1/2022,22,8605,282,3964,3059,10,0,15920
10/1/2022,23,8610,152,3357,3054,9,0,15182
10/1/2022,24,8605,153,2923,2944,0,0,14625
10/2/2022,1,8602,153,2847,2435,0,0,14037
10/2/2022,2,8603,153,2717,2447,0,0,13920
10/2/2022,3,8608,154,2763,2310,0,0,13835
10/2/2022,4,8611,154,2728,2454,0,0,13947
10/2/2022,5,8623,152,2700,2569,0,0,14044
10/2/2022,6,8626,152,2768,2791,1,0,14338
10/2/2022,7,8625,154,2837,2748,9,0,14373
10/2/2022,8,8627,155,3119,2587,78,0,14566
10/2/2022,9,8625,270,3234,1536,237,2,13904
10/2/2022,10,8625,371,3175,1252,375,3,13801
10/2/2022,11,8622,629,3189,1284,418,0,14142
10/2/2022,12,8625,845,3268,1706,428,1,14873
10/2/2022,13,8623,1087,3241,1851,425,1,15228
10/2/2022,14,8624,1476,3105,1583,417,0,15205
10/2/2022,15,8627,1509,3089,1490,397,0,15112
10/2/2022,16,8627,1561,3190,1367,314,0,15059
10/2/2022,17,8628,1617,3480,1567,185,0,15477
10/2/2022,18,8622,1626,3903,1412,39,0,15602
10/2/2022,19,8622,1619,4459,1300,5,0,16005
10/2/2022,20,8625,1449,4367,1315,5,0,15761
10/2/2022,21,8622,1503,4355,1316,3,0,15799
10/2/2022,22,8625,1360,4260,1131,1,0,15377
10/2/2022,23,8627,486,4155,1056,0,0,14324
10/2/2022,24,8633,210,3669,1126,0,0,13638
10/3/2022,1,8630,358,3537,1094,0,0,13619
10/3/2022,2,8632,497,3616,1082,0,0,13827
10/3/2022,3,8644,614,3678,1086,0,0,14022
10/3/2022,4,8641,978,3615,867,0,0,14101
10/3/2022,5,8632,1377,3309,811,0,0,14129
10/3/2022,6,8623,1937,3845,816,2,3,15226
10/3/2022,7,8616,2458,4464,796,16,3,16353
10/3/2022,8,8612,2479,4516,572,111,0,16290
10/3/2022,9,8612,2233,4469,285,255,0,15854
10/3/2022,10,8611,2111,4429,211,363,0,15725
10/3/2022,11,8610,1811,4363,246,401,0,15431
10/3/2022,12,8608,1959,4111,262,399,0,15339
10/3/2022,13,8591,1924,4002,273,399,0,15189
10/3/2022,14,8587,1901,4010,271,403,0,15172
10/3/2022,15,8592,2139,4068,208,362,0,15369
10/3/2022,16,8583,2191,4462,180,245,1,15662
10/3/2022,17,8584,2514,4564,159,104,0,15925
10/3/2022,18,8585,2566,4690,148,16,1,16006
10/3/2022,19,8588,2425,4815,205,0,1,16034
10/3/2022,20,8584,2561,4707,266,0,0,16118
10/3/2022,21,8578,2490,4368,272,0,0,15708
10/3/2022,22,8574,2422,4203,281,0,0,15480
10/3/2022,23,8573,1900,4024,307,0,0,14804
10/3/2022,24,8572,1805,3425,293,0,0,14095
10/4/2022,1,8577,1610,3425,193,0,0,13805
10/4/2022,2,8572,1503,3210,154,0,0,13439
10/4/2022,3,8578,1579,3032,115,0,0,13304
10/4/2022,4,8576,1825,3188,78,0,0,13667
10/4/2022,5,8569,2196,3309,56,0,0,14130
10/4/2022,6,8575,2759,3642,55,1,0,15032
10/4/2022,7,8571,2794,4057,44,13,0,15479
10/4/2022,8,8566,3032,4315,50,93,0,16056
10/4/2022,9,8562,3109,4316,87,205,0,16279
10/4/2022,10,8564,2630,4360,76,325,1,15956
10/4/2022,11,8575,2653,4301,124,356,1,16010
10/4/2022,12,8594,2607,3903,93,388,0,15585
10/4/2022,13,8589,2331,3836,82,411,0,15249
10/4/2022,14,8583,2382,3895,60,392,0,15312
10/4/2022,15,8582,2274,4011,82,319,2,15270
10/4/2022,16,8560,2258,4364,97,226,0,15505
10/4/2022,17,8567,2405,4574,86,118,0,15750
10/4/2022,18,8566,2600,4591,77,33,0,15867
10/4/2022,19,8564,2536,4635,119,1,0,15855
10/4/2022,20,8564,2800,4544,152,1,0,16061
10/4/2022,21,8573,2824,4188,136,0,0,15721
10/4/2022,22,8571,2716,3923,110,0,0,15320
10/4/2022,23,8577,2480,3517,93,0,0,14667
10/4/2022,24,8579,2048,3362,103,0,0,14092
10/5/2022,1,8584,1273,3146,79,0,0,13082
10/5/2022,2,8590,1099,3216,96,0,0,13001
10/5/2022,3,8596,1366,3187,109,0,0,13258
10/5/2022,4,8608,1646,3022,138,0,0,13414
10/5/2022,5,8609,1706,2886,179,0,0,13380
10/5/2022,6,8607,2166,3612,109,2,1,14497
10/5/2022,7,8607,2745,4249,78,12,19,15710
10/5/2022,8,8607,2798,4276,62,98,24,15865
10/5/2022,9,8597,2781,4372,57,219,13,16039
10/5/2022,10,8598,2674,4302,39,308,18,15939
10/5/2022,11,8606,2778,4192,57,367,23,16023
10/5/2022,12,8606,2646,3926,134,386,26,15724
10/5/2022,13,8600,2790,3891,233,391,25,15930
10/5/2022,14,8586,2706,3964,303,389,24,15972
10/5/2022,15,8586,3151,3995,324,322,7,16385
10/5/2022,16,8585,3033,4294,331,228,1,16472
10/5/2022,17,8588,3086,4732,286,102,0,16794
10/5/2022,18,8590,3103,4772,370,14,0,16849
10/5/2022,19,8588,2602,4892,480,0,0,16562
10/5/2022,20,8589,2362,4875,540,0,0,16366
10/5/2022,21,8587,2241,4562,709,0,0,16099
10/5/2022,22,8589,1582,3893,708,0,0,14772
10/5/2022,23,8236,1191,3638,668,0,0,13733
10/5/2022,24,7596,1437,3399,665,0,0,13097
10/6/2022,1,7579,1157,3372,650,0,0,12758
10/6/2022,2,7585,1394,3373,602,0,0,12954
10/6/2022,3,7589,1353,3353,615,0,0,12910
10/6/2022,4,7592,1432,3284,647,0,0,12955
10/6/2022,5,6859,1844,3281,710,0,0,12694
10/6/2022,6,6571,2234,3893,739,1,0,13438
10/6/2022,7,6573,3108,4364,799,5,0,14849
10/6/2022,8,6566,2986,4443,962,42,0,14999
10/6/2022,9,6564,2904,4504,898,108,1,14979
10/6/2022,10,6568,3108,4434,791,189,1,15091
10/6/2022,11,6572,3147,4072,925,224,0,14940
10/6/2022,12,6566,2821,4039,1049,263,0,14738
10/6/2022,13,6569,2753,3902,1172,252,0,14648
10/6/2022,14,6540,2587,3824,1380,251,0,14582
10/6/2022,15,6572,2314,4027,1489,165,1,14568
10/6/2022,16,6571,2445,4144,1686,76,0,14922
10/6/2022,17,6575,2076,4189,1705,45,0,14590
10/6/2022,18,6575,2143,4682,1580,10,0,14990
10/6/2022,19,6574,2768,4674,1496,5,2,15519
10/6/2022,20,6574,2215,4505,2106,5,1,15406
10/6/2022,21,6569,2045,3881,2413,0,0,14908
10/6/2022,22,6566,1581,3540,2846,0,0,14533
10/6/2022,23,6569,813,3443,2785,0,0,13610
10/6/2022,24,6571,673,3418,2543,0,0,13205
10/7/2022,1,6559,250,3182,2685,0,0,12676
10/7/2022,2,6557,220,3152,2793,0,0,12722
10/7/2022,3,6565,467,3143,2675,0,0,12850
10/7/2022,4,6566,807,3313,2568,0,0,13254
10/7/2022,5,6564,1053,2916,2525,0,1,13059
10/7/2022,6,6564,1447,3238,2599,1,4,13853
10/7/2022,7,6563,1690,4199,2411,2,4,14869
10/7/2022,8,6560,2304,4464,2428,52,0,15808
10/7/2022,9,6559,2707,4369,2487,134,0,16256
10/7/2022,10,6561,2073,3968,2658,226,0,15486
10/7/2022,11,6563,1998,3981,2564,260,6,15372
10/7/2022,12,6570,1979,3961,2346,247,1,15104
10/7/2022,13,6576,1826,4004,2243,216,0,14865
10/7/2022,14,6581,1606,4100,2190,185,2,14664
10/7/2022,15,6531,1577,4038,2218,112,0,14476
10/7/2022,16,6584,1864,4525,2150,64,2,15189
10/7/2022,17,6585,1838,4745,2091,29,0,15288
10/7/2022,18,6588,1912,4817,1794,5,0,15116
10/7/2022,19,6585,2028,4822,1599,0,0,15034
10/7/2022,20,6583,2090,4966,1570,0,0,15209
10/7/2022,21,6583,1902,4894,1613,0,0,14992
10/7/2022,22,6587,1904,4337,1368,0,0,14196
10/7/2022,23,6589,1692,4048,1219,0,0,13548
10/7/2022,24,6590,1243,3783,1179,0,0,12795
10/8/2022,1,6587,1122,3681,1327,0,0,12717
10/8/2022,2,6586,1239,3721,1370,0,0,12916
10/8/2022,3,6584,1412,3701,1508,0,0,13205
10/8/2022,4,6585,1358,3757,1489,0,0,13189
10/8/2022,5,6591,1477,3734,1300,0,0,13102
10/8/2022,6,6592,1915,3760,1202,2,0,13471
10/8/2022,7,6593,1964,4078,1390,15,4,14044
10/8/2022,8,6588,1890,4302,1470,69,2,14321
10/8/2022,9,6593,2383,4533,1371,174,1,15055
10/8/2022,10,6591,2360,4284,1630,290,1,15156
10/8/2022,11,6593,2319,4174,2073,256,0,15415
10/8/2022,12,6591,1810,3990,2532,220,0,15143
10/8/2022,13,6592,1275,3487,2703,226,0,14283
10/8/2022,14,6598,1108,3285,3076,179,0,14246
10/8/2022,15,6597,1289,3313,3144,165,0,14508
10/8/2022,16,6597,1515,3545,3238,127,0,15022
10/8/2022,17,6595,1805,3664,3446,78,1,15589
10/8/2022,18,6590,1808,4017,3103,12,2,15532
10/8/2022,19,6583,2112,4738,2913,3,0,16349
10/8/2022,20,6587,1848,4271,3158,1,0,15865
10/8/2022,21,6586,1441,4049,3326,0,0,15402
10/8/2022,22,6586,1209,3861,3289,0,0,14945
10/8/2022,23,6587,513,3899,3096,0,0,14095
10/8/2022,24,6584,242,3868,3027,0,0,13721
10/9/2022,1,6588,151,3474,2998,0,0,13211
10/9/2022,2,6591,144,3259,3135,0,0,13129
10/9/2022,3,6594,144,3194,3156,0,0,13088
10/9/2022,4,6597,246,3341,3055,0,0,13239
10/9/2022,5,6598,547,3500,2740,0,0,13385
10/9/2022,6,6601,960,3585,2351,0,0,13497
10/9/2022,7,6602,1317,3875,2025,6,0,13825
10/9/2022,8,6602,1897,4474,1572,60,0,14605
10/9/2022,9,6608,2450,4484,1183,151,3,14879
10/9/2022,10,6608,2477,4403,1019,252,3,14762
10/9/2022,11,6609,1824,4337,1023,298,0,14091
10/9/2022,12,6613,1479,4101,982,314,0,13489
10/9/2022,13,6613,1440,3665,1491,298,0,13507
10/9/2022,14,6615,1272,3703,1523,253,0,13366
10/9/2022,15,6618,1284,3794,1836,211,0,13743
10/9/2022,16,6618,1437,4109,1676,129,0,13969
10/9/2022,17,6617,1869,4689,1427,50,0,14652
10/9/2022,18,6620,1702,4752,1203,4,0,14281
10/9/2022,19,6620,1714,4880,1030,0,0,14244
10/9/2022,20,6619,1612,4646,1016,0,0,13893
10/9/2022,21,6618,1847,4526,1052,0,0,14043
10/9/2022,22,6621,1867,4431,863,0,1,13783
10/9/2022,23,6625,1744,4149,625,0,0,13143
10/9/2022,24,6626,1338,3934,609,0,0,12507
10/10/2022,1,6627,1143,3824,526,0,0,12120
10/10/2022,2,6626,1297,3559,522,0,0,12004
10/10/2022,3,6628,1413,3681,514,0,0,12236
10/10/2022,4,6628,1414,3686,450,0,0,12178
10/10/2022,5,6627,1429,3913,334,0,0,12303
10/10/2022,6,6629,1720,3961,287,2,0,12599
10/10/2022,7,6633,1991,4280,301,4,0,13209
10/10/2022,8,6629,2119,4269,231,92,0,13340
10/10/2022,9,6626,2017,4391,190,212,0,13436
10/10/2022,10,6629,1611,4070,166,332,0,12808
10/10/2022,11,6626,1775,3805,236,351,0,12793
10/10/2022,12,6628,1783,4046,266,358,0,13081
10/10/2022,13,6634,1460,4125,281,407,0,12907
10/10/2022,14,6633,1515,3968,322,381,0,12819
10/10/2022,15,6632,1783,3861,118,271,0,12665
10/10/2022,16,6632,2163,3890,276,207,0,13168
10/10/2022,17,6627,2323,4643,390,123,0,14106
10/10/2022,18,6626,2610,4969,336,13,0,14554
10/10/2022,19,6626,2910,4960,369,0,1,14866
10/10/2022,20,6629,2236,4898,437,0,0,14200
10/10/2022,21,6631,1999,4537,539,0,0,13706
10/10/2022,22,6633,1392,4160,646,0,5,12836
10/10/2022,23,6632,1098,3395,876,0,2,12003
10/10/2022,24,6635,1017,3127,875,0,0,11654
10/11/2022,1,6633,767,3157,1529,0,0,12086
10/11/2022,2,6633,565,3314,1864,0,0,12376
10/11/2022,3,6631,603,3336,2133,0,0,12703
10/11/2022,4,6631,773,3268,2244,0,0,12916
10/11/2022,5,6629,999,3034,2236,0,4,12902
10/11/2022,6,6630,1324,3437,2223,0,4,13618
10/11/2022,7,6626,1859,4226,2370,7,11,15099
10/11/2022,8,6623,1898,4300,2249,103,20,15193
10/11/2022,9,6627,2066,4395,1749,226,10,15073
10/11/2022,10,6628,2014,4264,1690,321,6,14923
10/11/2022,11,6626,1622,4094,1767,374,7,14490
10/11/2022,12,6623,1630,4006,1803,390,12,14464
10/11/2022,13,6625,1627,3882,1956,389,16,14495
10/11/2022,14,6628,1613,3788,2149,376,1,14555
10/11/2022,15,6626,1616,3954,2387,329,0,14912
10/11/2022,16,6628,1609,3823,2380,215,0,14655
10/11/2022,17,6629,1607,3991,2402,106,0,14735
10/11/2022,18,6625,1655,4790,2412,9,0,15491
10/11/2022,19,6623,1603,4554,2783,0,0,15563
10/11/2022,20,6627,1384,4185,2903,0,0,15099
10/11/2022,21,6625,1200,4150,3154,0,0,15129
10/11/2022,22,6625,714,3738,3387,0,0,14464
10/11/2022,23,6624,224,3640,3435,0,0,13923
10/11/2022,24,6621,147,3614,3427,0,0,13809
10/12/2022,1,6625,147,3682,3073,0,0,13527
10/12/2022,2,6625,147,3644,2876,0,0,13292
10/12/2022,3,6626,168,3522,2668,0,0,12984
10/12/2022,4,6630,370,3743,2458,0,0,13201
10/12/2022,5,6633,639,3389,2491,0,0,13152
10/12/2022,6,6633,997,3574,2441,2,0,13647
10/12/2022,7,6631,1288,3946,2959,4,0,14828
10/12/2022,8,6632,1309,4019,2983,29,1,14973
10/12/2022,9,6635,1312,4125,2981,85,0,15138
10/12/2022,10,6633,1305,4161,2935,153,0,15187
10/12/2022,11,6634,1342,4045,2895,204,1,15121
10/12/2022,12,6631,1303,3577,2986,236,1,14734
10/12/2022,13,6631,1302,3510,3226,207,0,14876
10/12/2022,14,6631,1114,3394,3561,136,2,14838
10/12/2022,15,6632,988,3722,3505,90,1,14938
10/12/2022,16,6631,970,3892,3856,84,2,15435
10/12/2022,17,6627,1006,4109,3955,37,1,15735
10/12/2022,18,6628,1001,4321,3939,2,0,15891
10/12/2022,19,6628,1003,4404,3907,0,0,15942
10/12/2022,20,6627,1002,4353,3843,0,2,15827
10/12/2022,21,6631,972,3837,3405,0,2,14847
10/12/2022,22,5817,875,4031,2987,0,0,13710
10/12/2022,23,5817,866,4014,2367,0,0,13064
10/12/2022,24,5814,589,4187,2070,0,0,12660
10/13/2022,1,5818,576,3751,1894,0,0,12039
10/13/2022,2,5824,623,3741,1715,0,0,11903
10/13/2022,3,5824,748,3839,1365,0,0,11776
10/13/2022,4,5821,1142,3828,1221,0,0,12012
10/13/2022,5,5821,1444,3446,1173,0,6,11890
10/13/2022,6,5822,1717,3914,969,0,2,12424
10/13/2022,7,5822,2040,4622,1094,0,0,13578
10/13/2022,8,5820,2497,4660,1067,5,0,14049
10/13/2022,9,5821,2265,4416,1424,17,0,13943
10/13/2022,10,5819,2341,4149,1620,35,0,13964
10/13/2022,11,5820,2226,4003,1797,70,0,13916
10/13/2022,12,5821,1765,3875,1986,118,0,13565
10/13/2022,13,5822,1767,3568,2408,134,0,13699
10/13/2022,14,5822,2009,3453,2403,132,10,13829
10/13/2022,15,5820,2142,3865,2467,182,2,14478
10/13/2022,16,5824,2354,3849,2250,116,0,14393
10/13/2022,17,5823,2486,4220,2160,54,0,14743
10/13/2022,18,5821,2394,4265,2216,4,0,14700
10/13/2022,19,5820,2453,4724,2051,0,0,15048
10/13/2022,20,5822,2661,4690,1670,0,0,14843
10/13/2022,21,5822,2280,4493,1613,0,0,14208
10/13/2022,22,5821,1836,4055,1786,0,0,13498
10/13/2022,23,5824,1406,3457,1863,0,0,12550
10/13/2022,24,5823,989,3240,1941,0,0,11993
10/14/2022,1,5821,982,3481,1857,0,0,12141
10/14/2022,2,5822,1259,3447,1993,0,0,12521
10/14/2022,3,5824,1396,3458,1808,0,0,12486
10/14/2022,4,5828,1400,3517,1655,0,0,12400
10/14/2022,5,5825,1400,3252,1888,0,0,12365
10/14/2022,6,5827,1403,3778,2057,1,0,13066
10/14/2022,7,5827,1443,4160,2190,6,0,13626
10/14/2022,8,5830,1479,4230,2412,75,6,14032
10/14/2022,9,5827,1552,4601,2252,158,3,14393
10/14/2022,10,5823,1589,4418,2300,175,0,14305
10/14/2022,11,5826,1394,4035,2277,172,0,13704
10/14/2022,12,5823,1529,3684,2306,251,0,13593
10/14/2022,13,5826,1298,3356,2249,295,0,13024
10/14/2022,14,5827,1297,3408,2167,345,0,13044
10/14/2022,15,5828,1293,3381,1957,305,0,12764
10/14/2022,16,5830,1297,3428,2435,199,0,13189
10/14/2022,17,5830,1297,3758,2417,77,0,13379
10/14/2022,18,5827,1297,4286,1958,4,0,13372
10/14/2022,19,5830,1294,4650,2491,0,0,14265
10/14/2022,20,5828,1294,4391,2559,0,0,14072
10/14/2022,21,5827,1298,4203,2665,0,0,13993
10/14/2022,22,5825,1090,3811,2928,0,1,13655
10/14/2022,23,5824,471,3623,3141,0,0,13059
10/14/2022,24,5819,182,3558,3342,0,0,12901
10/15/2022,1,5820,140,3344,3476,0,0,12780
10/15/2022,2,5820,140,3736,3505,0,0,13201
10/15/2022,3,5821,140,3699,3637,0,3,13300
10/15/2022,4,5822,140,3465,3731,0,2,13160
10/15/2022,5,5823,139,3278,3747,0,0,12987
10/15/2022,6,5822,138,3687,3611,0,0,13258
10/15/2022,7,5824,139,3945,3642,3,0,13553
10/15/2022,8,5822,140,3929,3728,39,0,13658
10/15/2022,9,5829,140,3731,3831,90,1,13622
10/15/2022,10,5832,140,3562,3918,107,1,13560
10/15/2022,11,5828,142,3861,3939,136,0,13906
10/15/2022,12,5829,142,3925,3998,180,0,14074
10/15/2022,13,5827,152,4063,3950,165,0,14157
10/15/2022,14,5822,252,3930,3943,217,0,14164
10/15/2022,15,5823,479,3630,3880,221,0,14033
10/15/2022,16,5824,548,3691,3468,152,0,13683
10/15/2022,17,5826,566,4131,3509,39,0,14071
10/15/2022,18,5829,555,4264,3094,5,0,13747
10/15/2022,19,5829,542,4682,2776,0,0,13829
10/15/2022,20,5826,561,4570,2829,0,0,13786
10/15/2022,21,5826,565,4498,2665,0,0,13554
10/15/2022,22,5825,382,4466,2527,0,0,13200
10/15/2022,23,5829,334,4253,2361,0,0,12777
10/15/2022,24,5831,331,4040,2315,0,0,12517
10/16/2022,1,5831,331,4188,1953,0,0,12303
10/16/2022,2,5831,389,4041,1557,0,0,11818
10/16/2022,3,5829,472,4116,1338,0,0,11755
10/16/2022,4,5828,502,3948,1332,0,0,11610
10/16/2022,5,5831,404,3955,1294,0,0,11484
10/16/2022,6,5831,356,3992,1470,0,0,11649
10/16/2022,7,5832,339,4291,1782,3,0,12247
10/16/2022,8,5832,357,4434,1855,36,0,12514
10/16/2022,9,5830,585,4893,1629,72,0,13009
10/16/2022,10,5830,1065,4683,1542,127,0,13247
10/16/2022,11,5831,1040,4134,1531,179,0,12715
10/16/2022,12,5830,889,4426,1320,245,0,12710
10/16/2022,13,5832,1084,4365,1168,300,0,12749
10/16/2022,14,5834,1395,4314,1055,289,0,12887
10/16/2022,15,5835,1766,4192,885,198,0,12876
10/16/2022,16,5830,2786,4530,498,118,0,13762
10/16/2022,17,5832,3440,4807,246,31,0,14356
10/16/2022,18,5837,2996,5107,307,2,0,14249
10/16/2022,19,5838,2801,5075,348,0,0,14062
10/16/2022,20,5840,2739,5121,303,0,0,14003
10/16/2022,21,5843,2830,4744,329,0,0,13746
10/16/2022,22,5841,2411,4256,521,0,0,13029
10/16/2022,23,5837,1950,4002,665,0,0,12454
10/16/2022,24,5838,1712,3800,710,0,0,12060
10/17/2022,1,5836,1381,3937,867,0,0,12021
10/17/2022,2,5831,1362,3799,1023,0,1,12016
10/17/2022,3,5826,1491,3840,1211,0,0,12368
10/17/2022,4,5826,1668,3514,1414,0,0,12422
10/17/2022,5,5826,1737,3532,1369,0,0,12464
10/17/2022,6,5830,2045,4158,1714,0,0,13747
10/17/2022,7,5832,2578,4443,1870,0,4,14727
10/17/2022,8,5830,2655,4418,2159,9,3,15074
10/17/2022,9,5829,2544,4519,2430,19,1,15342
10/17/2022,10,5831,2515,4049,2591,54,1,15041
10/17/2022,11,5830,2173,4066,2964,58,3,15094
10/17/2022,12,5830,2413,4014,3092,59,1,15409
10/17/2022,13,5831,2054,3936,3217,61,1,15100
10/17/2022,14,5827,1855,4015,3235,79,0,15011
10/17/2022,15,5823,1755,4046,3339,76,0,15039
10/17/2022,16,5820,1926,4383,3407,54,0,15590
10/17/2022,17,5821,2129,4876,3149,11,0,15986
10/17/2022,18,5824,2277,5060,2862,1,0,16024
10/17/2022,19,5825,2231,4937,2817,0,0,15810
10/17/2022,20,5822,1992,4539,2821,0,0,15174
10/17/2022,21,5819,2096,4421,2773,0,0,15109
10/17/2022,22,5817,1592,4182,2790,0,0,14381
10/17/2022,23,5817,858,3846,2973,0,0,13494
10/17/2022,24,5820,429,3809,2963,0,0,13021
10/18/2022,1,5823,380,3781,3002,0,0,12986
10/18/2022,2,5824,532,3614,3121,0,0,13091
10/18/2022,3,5825,650,3979,3033,0,0,13487
10/18/2022,4,5828,777,3889,3020,0,0,13514
10/18/2022,5,5833,1057,3516,3053,0,0,13459
10/18/2022,6,5833,1440,3655,2974,0,0,13902
10/18/2022,7,5834,1885,4180,3076,1,1,14977
10/18/2022,8,5834,2128,4326,2931,12,1,15232
10/18/2022,9,5836,1906,4316,2915,36,1,15010
10/18/2022,10,5836,2114,4478,2856,61,0,15345
10/18/2022,11,5836,1865,4395,2892,84,1,15073
10/18/2022,12,5835,1798,4397,2907,111,7,15055
10/18/2022,13,5834,1705,4346,2844,169,16,14914
10/18/2022,14,5831,1713,4354,2842,150,25,14915
10/18/2022,15,5829,1772,4269,2779,109,29,14787
10/18/2022,16,5830,2410,4431,2579,54,20,15324
10/18/2022,17,5827,2386,4682,2514,17,19,15445
10/18/2022,18,5830,2473,5000,2357,1,4,15665
10/18/2022,19,5832,2590,4981,2289,0,0,15692
10/18/2022,20,5829,2427,4917,2107,0,0,15280
10/18/2022,21,5829,2596,4775,1763,0,0,14963
10/18/2022,22,5831,2093,4426,1825,0,0,14175
10/18/2022,23,5835,1358,4150,1919,0,0,13262
10/18/2022,24,5836,930,3858,1882,0,0,12506
10/19/2022,1,5834,920,3855,1716,0,0,12325
10/19/2022,2,5833,1086,3879,1649,0,0,12447
10/19/2022,3,5834,1202,3891,1586,0,0,12513
10/19/2022,4,5837,1349,3721,1436,0,0,12343
10/19/2022,5,5838,1565,3645,1552,0,0,12600
10/19/2022,6,5838,1947,4049,1755,0,0,13589
10/19/2022,7,5839,2847,4502,1817,1,0,15006
10/19/2022,8,5841,2720,4671,1926,33,0,15191
10/19/2022,9,5842,2585,4624,1978,97,0,15126
10/19/2022,10,5841,2516,4467,1976,145,0,14945
10/19/2022,11,5843,2391,4235,2384,135,0,14988
10/19/2022,12,5840,2085,4313,2740,113,1,15092
10/19/2022,13,5841,2141,4158,3023,92,1,15256
10/19/2022,14,5838,2199,4106,3002,81,1,15227
10/19/2022,15,5837,2507,4182,2924,58,0,15508
10/19/2022,16,5837,2431,4298,3056,42,0,15664
10/19/2022,17,5838,2728,4775,2695,23,0,16059
10/19/2022,18,5842,3562,5049,2270,2,1,16726
10/19/2022,19,5843,3039,4938,2376,0,0,16196
10/19/2022,20,5843,2083,4736,3003,0,0,15665
10/19/2022,21,5970,1889,4317,3166,0,0,15342
10/19/2022,22,6032,1123,4071,3220,0,0,14446
10/19/2022,23,6035,527,4027,3237,0,0,13826
10/19/2022,24,6038,245,4357,2930,0,0,13570
10/20/2022,1,6039,226,4421,2825,0,0,13511
10/20/2022,2,6038,424,4160,2867,0,0,13489
10/20/2022,3,6041,737,4241,2670,0,0,13689
10/20/2022,4,6206,908,4136,2518,0,0,13768
10/20/2022,5,6378,1185,3872,2681,0,0,14116
10/20/2022,6,6503,1547,4003,2650,0,0,14703
10/20/2022,7,6504,2178,4477,2789,2,1,15951
10/20/2022,8,6504,2554,4600,2651,8,0,16317
10/20/2022,9,6501,2954,4639,2609,38,1,16742
10/20/2022,10,6512,2554,4455,2875,83,0,16479
10/20/2022,11,6515,2020,4293,2931,70,1,15830
10/20/2022,12,6521,2646,4476,2630,58,0,16331
10/20/2022,13,6528,2747,4287,2635,45,0,16242
10/20/2022,14,6526,2838,4339,2363,53,0,16119
10/20/2022,15,6530,2391,4510,2301,57,0,15789
10/20/2022,16,6535,1959,4639,2470,45,1,15649
10/20/2022,17,6624,2076,4866,2245,11,0,15822
10/20/2022,18,6625,2776,4999,1854,0,0,16254
10/20/2022,19,6624,2924,5012,1642,0,0,16202
10/20/2022,20,6623,2776,4887,1552,0,4,15842
10/20/2022,21,6617,2424,4557,1596,0,0,15194
10/20/2022,22,6615,1863,4213,1687,0,0,14378
10/20/2022,23,6615,1301,4166,2009,0,0,14091
10/20/2022,24,6617,685,3872,2242,0,0,13416
10/21/2022,1,6631,621,3912,2502,0,0,13666
10/21/2022,2,6638,773,3653,2811,0,0,13875
10/21/2022,3,6641,1010,3587,2837,0,7,14082
10/21/2022,4,6641,1250,3523,2932,0,4,14350
10/21/2022,5,6641,1439,3626,2788,0,0,14494
10/21/2022,6,6643,1613,4059,3290,2,0,15607
10/21/2022,7,6645,1668,4478,3374,5,0,16170
10/21/2022,8,6639,1706,4594,3348,69,0,16356
10/21/2022,9,6643,1739,4403,3315,195,1,16296
10/21/2022,10,6646,1385,4073,3409,291,0,15804
10/21/2022,11,6649,853,4083,3408,337,0,15330
10/21/2022,12,6644,694,3928,3581,323,0,15170
10/21/2022,13,6641,436,4169,3545,364,1,15156
10/21/2022,14,6636,374,4321,3428,371,0,15130
10/21/2022,15,6640,495,4088,3563,298,0,15084
10/21/2022,16,6637,713,4137,3465,200,0,15152
10/21/2022,17,6638,809,4714,3595,73,1,15830
10/21/2022,18,6637,885,4609,3774,4,0,15909
10/21/2022,19,6637,883,4300,4011,0,0,15831
10/21/2022,20,6637,886,4215,4192,0,0,15930
10/21/2022,21,6636,729,4185,4344,0,0,15894
10/21/2022,22,6632,489,4193,4268,0,0,15582
10/21/2022,23,6637,371,3779,4092,0,0,14879
10/21/2022,24,6636,234,3236,3724,0,0,13830
10/22/2022,1,6635,142,2894,3723,0,0,13394
10/22/2022,2,6637,141,2842,3683,0,0,13303
10/22/2022,3,6638,142,2838,3358,0,0,12976
10/22/2022,4,6631,143,2759,3459,0,0,12992
10/22/2022,5,6638,142,2785,3703,0,0,13268
10/22/2022,6,6646,142,3084,3757,0,0,13629
10/22/2022,7,6643,143,3814,3749,2,0,14351
10/22/2022,8,6640,141,4118,3639,69,4,14611
10/22/2022,9,6633,145,4382,3218,198,1,14577
10/22/2022,10,6635,166,4556,2894,304,0,14555
10/22/2022,11,6637,264,4247,2785,374,0,14307
10/22/2022,12,6634,310,4154,2750,389,0,14237
10/22/2022,13,6641,437,3911,2645,394,3,14031
10/22/2022,14,6641,643,3977,2641,370,0,14272
10/22/2022,15,6642,772,4043,2664,293,1,14415
10/22/2022,16,6645,880,4137,2433,207,1,14303
10/22/2022,17,6645,893,4859,2663,75,0,15135
10/22/2022,18,6645,892,4782,3037,3,0,15359
10/22/2022,19,6645,871,4222,3538,0,0,15276
10/22/2022,20,6643,537,4114,3874,0,0,15168
10/22/2022,21,6635,455,4147,3903,0,0,15140
10/22/2022,22,6630,455,3754,3742,0,0,14581
10/22/2022,23,6632,227,3641,3668,0,0,14168
10/22/2022,24,6633,148,3371,3576,0,0,13728
10/23/2022,1,6638,149,3259,3268,0,0,13314
10/23/2022,2,6637,149,3246,3093,0,0,13125
10/23/2022,3,6633,157,3226,2808,0,0,12824
10/23/2022,4,6636,157,3580,2657,0,0,13030
10/23/2022,5,6638,181,4248,2300,0,0,13367
10/23/2022,6,6639,315,4339,2109,1,0,13403
10/23/2022,7,6639,451,4298,2197,3,0,13588
10/23/2022,8,6638,617,3932,2099,65,0,13351
10/23/2022,9,6635,764,4225,1505,190,0,13319
10/23/2022,10,6633,1193,4616,759,294,0,13495
10/23/2022,11,6637,1330,4732,401,328,0,13428
10/23/2022,12,6640,1450,4718,309,358,0,13475
10/23/2022,13,6639,1541,4429,505,364,0,13478
10/23/2022,14,6637,1254,4434,789,333,0,13447
10/23/2022,15,6635,1090,3996,1100,283,0,13104
10/23/2022,16,6635,1290,4187,1256,164,0,13532
10/23/2022,17,6632,1687,4771,1348,55,0,14493
10/23/2022,18,6634,1996,4726,1730,3,0,15089
10/23/2022,19,6637,1506,4460,2372,0,0,14975
10/23/2022,20,6637,1424,4197,2412,0,0,14670
10/23/2022,21,6641,1018,4103,2583,0,0,14345
10/23/2022,22,6640,628,4391,2491,0,0,14150
10/23/2022,23,6636,226,4234,2600,0,0,13696
10/23/2022,24,6638,147,3814,2662,0,0,13261
10/24/2022,1,6638,169,3528,2831,0,0,13166
10/24/2022,2,6639,181,3609,2733,0,2,13164
10/24/2022,3,6639,379,3909,2577,0,0,13504
10/24/2022,4,6640,917,3754,2317,0,0,13628
10/24/2022,5,6642,1400,3695,2147,0,0,13884
10/24/2022,6,6646,1705,3932,2003,0,0,14286
10/24/2022,7,6647,2079,4312,1963,0,0,15001
10/24/2022,8,6644,2250,4352,1886,53,0,15185
10/24/2022,9,6639,1988,4399,1502,168,0,14696
10/24/2022,10,6638,2515,4444,1016,298,0,14911
10/24/2022,11,6641,2214,4401,914,361,0,14531
10/24/2022,12,6641,2111,4393,1144,379,0,14668
10/24/2022,13,6641,2124,4354,1481,378,1,14979
10/24/2022,14,6640,2318,4335,1648,353,0,15294
10/24/2022,15,6640,2261,4360,1549,285,0,15095
10/24/2022,16,6631,2529,4523,1459,181,13,15336
10/24/2022,17,6633,2763,4783,1536,56,43,15814
10/24/2022,18,6634,2125,4696,2150,0,53,15658
10/24/2022,19,6632,1930,4341,2289,0,53,15245
10/24/2022,20,6628,1929,4337,2294,0,53,15241
10/24/2022,21,6632,1927,4180,2401,0,53,15193
10/24/2022,22,6627,1497,4235,2634,0,16,15009
10/24/2022,23,6628,775,4132,2574,0,0,14109
10/24/2022,24,6628,249,4111,2697,0,0,13685
10/25/2022,1,6634,184,3908,2850,0,0,13576
10/25/2022,2,6631,330,3458,2863,0,0,13282
10/25/2022,3,6630,469,3399,2682,0,0,13180
10/25/2022,4,6630,596,3458,2465,0,0,13149
10/25/2022,5,6631,955,3584,2754,0,0,13924
10/25/2022,6,6631,1483,3811,2590,1,0,14516
10/25/2022,7,6632,1698,4373,2762,2,2,15469
10/25/2022,8,6628,1825,4251,2719,35,2,15460
10/25/2022,9,6629,1673,4326,2510,96,0,15234
10/25/2022,10,6628,1806,4399,2190,116,0,15139
10/25/2022,11,6630,2139,4358,1811,226,0,15164
10/25/2022,12,6630,2394,4428,1556,249,2,15259
10/25/2022,13,6632,2282,4344,1431,250,19,14958
10/25/2022,14,6628,2001,4490,1476,240,49,14884
10/25/2022,15,6604,1673,4672,1815,134,52,14950
10/25/2022,16,6598,1622,4890,1989,88,51,15238
10/25/2022,17,6600,1704,5123,2096,35,51,15609
10/25/2022,18,6605,1705,5034,2358,1,51,15754
10/25/2022,19,6603,1686,5068,2703,0,52,16112
10/25/2022,20,6600,1605,4784,2966,0,53,16008
10/25/2022,21,6600,1191,4509,3139,0,56,15495
10/25/2022,22,6601,711,4130,3378,0,53,14873
10/25/2022,23,6601,228,3965,3102,0,11,13907
10/25/2022,24,6604,139,4227,2804,0,0,13774
10/26/2022,1,6610,140,4000,2382,0,0,13132
10/26/2022,2,6610,141,4194,2054,0,0,12999
10/26/2022,3,6607,207,4160,1894,0,0,12868
10/26/2022,4,6607,339,3830,1834,0,2,12612
10/26/2022,5,6612,596,3558,1979,0,1,12746
10/26/2022,6,6524,925,3820,1914,0,0,13183
10/26/2022,7,6514,1152,4366,1965,0,7,14004
10/26/2022,8,6517,1184,4665,1934,27,43,14370
10/26/2022,9,6596,1116,4638,1895,96,52,14393
10/26/2022,10,6613,1069,4356,2058,97,56,14249
10/26/2022,11,6615,1097,4405,2256,68,67,14508
10/26/2022,12,6618,888,4418,2110,105,84,14223
10/26/2022,13,6617,511,4301,2590,84,89,14192
10/26/2022,14,6617,490,4212,2807,114,95,14335
10/26/2022,15,6613,563,4221,3438,61,93,14989
10/26/2022,16,6606,561,4289,3878,68,117,15519
10/26/2022,17,6604,561,4341,4109,13,91,15719
10/26/2022,18,6605,563,4412,3994,0,92,15666
10/26/2022,19,6613,561,4457,4177,0,93,15901
10/26/2022,20,6617,563,4261,4013,0,93,15547
10/26/2022,21,6614,561,4219,3778,0,78,15250
10/26/2022,22,6617,424,3954,3549,0,39,14583
10/26/2022,23,6621,173,3798,3315,0,40,13947
10/26/2022,24,6627,140,3867,2969,0,40,13643
10/27/2022,1,6635,145,3681,2766,0,44,13271
10/27/2022,2,6629,170,3702,2524,0,43,13068
10/27/2022,3,6630,357,3820,2012,0,44,12863
10/27/2022,4,6632,716,3836,1460,0,43,12687
10/27/2022,5,6628,1259,4051,980,0,42,12960
10/27/2022,6,6633,2049,4360,722,1,50,13815
10/27/2022,7,6635,2547,4903,484,1,83,14653
10/27/2022,8,6632,2673,4846,302,60,87,14600
10/27/2022,9,6632,2209,4676,202,193,79,13991
10/27/2022,10,6632,1925,4698,169,261,72,13757
10/27/2022,11,6630,1852,4498,182,304,84,13550
10/27/2022,12,6629,1766,4425,125,311,81,13337
10/27/2022,13,6631,1819,4165,80,327,80,13102
10/27/2022,14,6612,1874,4041,106,332,84,13049
10/27/2022,15,6628,1910,4007,45,171,80,12841
10/27/2022,16,6642,1970,4581,111,204,79,13587
10/27/2022,17,6643,2370,4845,165,62,81,14166
10/27/2022,18,6643,2685,5050,241,0,76,14695
10/27/2022,19,6642,2604,4983,279,0,78,14586
10/27/2022,20,6642,2887,4878,386,0,80,14873
10/27/2022,21,6636,2422,4508,688,0,66,14320
10/27/2022,22,6635,2022,4082,888,0,79,13706
10/27/2022,23,6639,1526,3752,1100,0,82,13099
10/27/2022,24,6642,941,4103,1167,0,53,12906
10/28/2022,1,6641,952,4191,1246,0,42,13072
10/28/2022,2,6644,1097,4046,1450,0,42,13279
10/28/2022,3,6646,1449,3822,1663,0,39,13619
10/28/2022,4,6644,1557,3456,1711,0,42,13410
10/28/2022,5,6642,1684,3637,1785,0,41,13789
10/28/2022,6,6644,1718,4097,1856,0,41,14356
10/28/2022,7,6645,2075,4762,1838,1,70,15391
10/28/2022,8,6645,2293,4759,1673,38,88,15496
10/28/2022,9,6643,1960,4698,1387,157,73,14918
10/28/2022,10,6647,1895,4611,1133,217,71,14574
10/28/2022,11,6648,1766,4249,927,277,66,13933
10/28/2022,12,6648,1937,4275,672,354,55,13941
10/28/2022,13,6644,1838,4157,523,345,60,13567
10/28/2022,14,6641,1691,4312,485,304,59,13492
10/28/2022,15,6636,1670,4372,468,241,61,13448
10/28/2022,16,6631,1829,4519,510,162,64,13715
10/28/2022,17,6636,1942,5026,603,61,60,14328
10/28/2022,18,6642,2053,5130,593,2,59,14479
10/28/2022,19,6642,1983,5140,712,0,60,14537
10/28/2022,20,6641,1846,5020,1035,0,60,14602
10/28/2022,21,6637,1777,4816,1211,0,55,14496
10/28/2022,22,6637,1600,4409,1344,0,64,14054
10/28/2022,23,6621,1437,4133,1398,0,32,13621
10/28/2022,24,6636,1253,4153,1493,0,24,13559
10/29/2022,1,6636,1040,4174,1456,0,26,13332
10/29/2022,2,6636,1133,4140,1308,0,26,13243
10/29/2022,3,6637,1389,4201,1214,0,29,13470
10/29/2022,4,6633,1612,4241,967,0,29,13482
10/29/2022,5,6634,1823,4224,694,0,28,13403
10/29/2022,6,6636,1930,4518,571,0,28,13683
10/29/2022,7,6636,2099,4774,556,3,25,14093
10/29/2022,8,6635,1889,5136,576,57,27,14320
10/29/2022,9,6630,1749,5083,519,177,19,14177
10/29/2022,10,6632,1700,5002,398,284,28,14044
10/29/2022,11,6634,1716,4918,290,351,27,13936
10/29/2022,12,6634,2011,4739,204,403,29,14020
10/29/2022,13,6640,2036,4581,170,405,27,13859
10/29/2022,14,6640,2029,4500,188,366,26,13749
10/29/2022,15,6637,1878,4401,224,313,33,13486
10/29/2022,16,6633,1912,4344,247,205,63,13404
10/29/2022,17,6639,1934,4671,275,60,75,13654
10/29/2022,18,6641,2158,5135,384,2,61,14381
10/29/2022,19,6639,1991,5209,574,0,52,14465
10/29/2022,20,6634,1870,5085,827,0,52,14468
10/29/2022,21,6631,1796,4735,1118,0,52,14332
10/29/2022,22,6633,1421,4748,1181,0,11,13994
10/29/2022,23,6637,1277,4407,1080,0,2,13403
10/29/2022,24,6637,1236,4319,971,0,5,13168
10/30/2022,1,6638,995,4305,903,0,7,12848
10/30/2022,2,6639,1071,4310,778,0,10,12808
10/30/2022,3,6639,1081,4209,802,0,8,12739
10/30/2022,4,6638,1195,4266,708,0,2,12809
10/30/2022,5,6641,1450,4195,716,0,1,13003
10/30/2022,6,6641,1708,4239,777,1,0,13366
10/30/2022,7,6642,2024,4359,750,2,0,13777
10/30/2022,8,6641,2110,4647,843,56,0,14297
10/30/2022,9,6642,1862,4607,792,200,0,14103
10/30/2022,10,6641,1919,4817,440,302,0,14119
10/30/2022,11,6641,2206,4543,235,331,0,13956
10/30/2022,12,6637,2260,4474,142,358,0,13871
10/30/2022,13,6634,1869,4391,105,334,0,13333
10/30/2022,14,6636,2029,4371,87,321,0,13444
10/30/2022,15,6636,2245,4272,81,203,7,13444
10/30/2022,16,6637,2625,4437,84,91,33,13907
10/30/2022,17,6639,2812,4668,79,21,51,14270
10/30/2022,18,6640,2904,4946,181,0,71,14742
10/30/2022,19,6641,2730,4972,251,0,58,14652
10/30/2022,20,6638,2428,5076,344,0,53,14539
10/30/2022,21,6635,2239,4538,523,0,31,13966
10/30/2022,22,6632,2054,4447,634,0,0,13767
10/30/2022,23,6633,1831,4281,718,0,0,13463
10/30/2022,24,6109,1711,4220,734,0,0,12774
10/31/2022,1,5792,1998,4132,680,0,0,12602
10/31/2022,2,5756,2267,4083,579,0,0,12685
10/31/2022,3,5757,2240,4093,558,0,0,12648
10/31/2022,4,5758,2424,4152,431,0,2,12767
10/31/2022,5,5755,2827,4237,472,0,12,13303
10/31/2022,6,5754,3113,4460,443,0,44,13814
10/31/2022,7,5753,3470,4838,530,0,60,14651
10/31/2022,8,5754,3676,4709,602,14,60,14815
10/31/2022,9,5752,3761,4611,640,30,54,14848
10/31/2022,10,5752,3903,4494,665,57,51,14922
10/31/2022,11,5753,3958,4277,615,100,57,14760
10/31/2022,12,5754,4050,4223,599,88,71,14785
10/31/2022,13,5754,4221,3934,647,68,57,14681
10/31/2022,14,5755,4218,4167,549,57,51,14797
10/31/2022,15,5754,4238,4224,589,36,51,14892
10/31/2022,16,5753,3909,4503,704,17,51,14937
10/31/2022,17,5756,4017,4727,573,6,51,15130
10/31/2022,18,5756,3694,4982,473,0,51,14956
10/31/2022,19,5757,3250,5020,601,0,51,14679
10/31/2022,20,5756,2985,5159,627,0,51,14578
10/31/2022,21,5756,2941,4928,588,0,51,14264
10/31/2022,22,5755,2902,4575,688,0,7,13927
10/31/2022,23,5750,2790,4355,771,0,0,13666
10/31/2022,24,5754,2298,4208,782,0,0,13042
11/1/2022,1,5759,1926,3997,705,0,0,12387
11/1/2022,2,5761,1819,4078,649,0,0,12307
11/1/2022,3,5761,1992,4109,539,0,0,12401
11/1/2022,4,5760,1953,4118,427,0,0,12258
11/1/2022,5,5758,1909,4149,464,0,4,12284
11/1/2022,6,5760,2742,4423,463,0,5,13393
11/1/2022,7,5757,3610,4873,327,1,19,14587
11/1/2022,8,5757,3846,4804,246,3,56,14712
11/1/2022,9,5754,3577,4918,396,26,68,14739
11/1/2022,10,5752,3863,4902,211,66,68,14862
11/1/2022,11,5752,3771,4561,122,115,68,14389
11/1/2022,12,5754,3217,4381,101,158,71,13682
11/1/2022,13,5755,3315,4399,205,232,70,13976
11/1/2022,14,5754,3292,4375,340,232,68,14061
11/1/2022,15,5752,3299,4481,408,187,63,14190
11/1/2022,16,5747,3013,4633,466,152,70,14081
11/1/2022,17,5748,3227,4966,438,42,68,14489
11/1/2022,18,5750,3426,5007,618,1,59,14861
11/1/2022,19,5748,3314,4965,737,0,59,14823
11/1/2022,20,5750,3015,4881,862,0,52,14560
11/1/2022,21,5768,2594,4523,774,0,48,13707
11/1/2022,22,4940,3473,4554,541,0,8,13516
11/1/2022,23,4934,3286,4305,357,0,0,12882
11/1/2022,24,4934,2611,4195,288,0,0,12028
11/2/2022,1,4939,2644,4103,222,0,0,11908
11/2/2022,2,4935,2522,4096,244,0,0,11797
11/2/2022,3,4934,2709,4110,193,0,1,11947
11/2/2022,4,4936,2757,4069,182,0,1,11945
11/2/2022,5,4937,3190,4118,267,0,0,12512
11/2/2022,6,4936,3915,4410,340,0,3,13604
11/2/2022,7,4933,4340,4630,301,1,35,14240
11/2/2022,8,4932,4348,4706,350,31,69,14436
11/2/2022,9,4931,4103,4454,393,123,97,14101
11/2/2022,10,4931,4000,4503,362,196,96,14088
11/2/2022,11,4932,3831,4409,284,239,95,13790
11/2/2022,12,4934,3784,4405,265,261,97,13746
11/2/2022,13,4938,3811,4396,284,284,95,13808
11/2/2022,14,4955,3794,4426,285,309,96,13865
11/2/2022,15,4962,3623,4520,268,261,96,13730
11/2/2022,16,4984,3510,4736,290,156,105,13781
11/2/2022,17,5029,3984,5009,260,40,152,14474
11/2/2022,18,5033,4086,4994,390,0,181,14684
11/2/2022,19,5033,3797,4885,668,0,141,14524
11/2/2022,20,5032,3790,4826,923,0,32,14603
11/2/2022,21,5035,3505,4681,1137,0,9,14367
11/2/2022,22,5036,3202,4338,1225,0,10,13811
11/2/2022,23,5046,2342,4367,1236,0,15,13006
11/2/2022,24,5105,2437,4280,1184,0,24,13030
11/3/2022,1,5148,2660,4176,1075,0,20,13079
11/3/2022,2,5142,2521,4082,1187,0,17,12949
11/3/2022,3,5183,2238,4092,1234,0,24,12771
11/3/2022,4,5197,2247,4208,1131,0,25,12808
11/3/2022,5,5200,2538,4200,1032,0,28,12998
11/3/2022,6,5203,3082,4405,961,0,27,13678
11/3/2022,7,5202,3373,4700,1114,1,31,14421
11/3/2022,8,5200,3317,4759,1071,18,51,14416
11/3/2022,9,5201,3421,4737,1027,86,82,14554
11/3/2022,10,5210,3752,4842,795,142,103,14844
11/3/2022,11,5258,3562,4452,747,195,109,14323
11/3/2022,12,5398,3225,4289,1009,217,131,14269
11/3/2022,13,5460,2879,4297,1245,240,127,14248
11/3/2022,14,5469,2824,4451,1289,291,125,14449
11/3/2022,15,5532,2507,4552,1234,264,116,14205
11/3/2022,16,5572,2687,4773,1329,165,37,14563
11/3/2022,17,5603,3108,4940,1346,38,26,15061
11/3/2022,18,5612,3180,5037,1531,0,26,15386
11/3/2022,19,5612,2872,4936,2028,0,31,15479
11/3/2022,20,5612,2319,4783,2507,0,31,15252
11/3/2022,21,5613,2374,4568,2781,0,16,15352
11/3/2022,22,5612,1699,4290,2899,0,23,14523
11/3/2022,23,5629,1116,3987,3034,0,29,13795
11/3/2022,24,5719,611,3895,3255,0,28,13508
11/4/2022,1,5949,394,3667,3272,0,30,13312
11/4/2022,2,5960,326,4033,3298,0,29,13646
11/4/2022,3,5976,471,3843,3344,0,27,13661
11/4/2022,4,6010,588,3547,3499,0,29,13673
11/4/2022,5,6082,728,3556,3499,0,28,13893
11/4/2022,6,6126,944,4005,3542,0,24,14641
11/4/2022,7,6139,1162,4228,3617,0,24,15170
11/4/2022,8,6140,1291,4214,3666,33,20,15364
11/4/2022,9,6135,1267,4111,3699,159,10,15381
11/4/2022,10,6134,1253,4226,3577,253,21,15464
11/4/2022,11,6136,1263,4151,3616,308,21,15495
11/4/2022,12,6180,1317,3811,3759,342,26,15435
11/4/2022,13,6205,1397,3559,3801,339,25,15326
11/4/2022,14,6204,1183,3984,3744,295,25,15435
11/4/2022,15,6259,1110,4267,3876,192,25,15729
11/4/2022,16,6380,1312,4244,3957,84,49,16026
11/4/2022,17,6388,1508,4670,3908,18,76,16568
11/4/2022,18,6386,1499,4726,4024,0,76,16711
11/4/2022,19,6386,1501,4567,4092,0,78,16624
11/4/2022,20,6382,1079,4558,4079,0,83,16181
11/4/2022,21,6382,883,4196,4071,0,67,15599
11/4/2022,22,6457,622,3908,3816,0,74,14877
11/4/2022,23,6561,237,3667,3659,0,43,14167
11/4/2022,24,6578,146,3460,3666,0,33,13883
11/5/2022,1,6567,146,3136,3386,0,36,13271
11/5/2022,2,6591,145,2999,3109,0,38,12882
11/5/2022,3,6829,146,3074,2819,0,37,12905
11/5/2022,4,7074,146,3117,2755,0,35,13127
11/5/2022,5,7093,146,3100,2960,0,32,13331
11/5/2022,6,7102,146,3361,3256,0,28,13893
11/5/2022,7,7098,146,3573,4119,1,27,14964
11/5/2022,8,7096,166,4007,4195,23,26,15513
11/5/2022,9,7097,145,3866,4217,86,25,15436
11/5/2022,10,7095,150,3948,4239,150,16,15598
11/5/2022,11,7097,188,3942,4245,220,15,15707
11/5/2022,12,7095,157,3873,4019,258,16,15418
11/5/2022,13,7094,268,3991,3865,257,15,15490
11/5/2022,14,7151,377,3967,3784,217,15,15511
11/5/2022,15,7209,652,3961,4178,121,31,16152
11/5/2022,16,7209,749,4172,4294,37,36,16497
11/5/2022,17,7204,820,4446,4306,10,40,16826
11/5/2022,18,7208,821,4338,4175,0,40,16582
11/5/2022,19,7208,821,4480,4229,0,38,16776
11/5/2022,20,7226,795,4294,4153,0,37,16505
11/5/2022,21,7257,459,4158,3995,0,19,15888
11/5/2022,22,7286,375,3660,4270,0,32,15623
11/5/2022,23,7294,240,3114,4238,0,36,14922
11/5/2022,24,7305,145,2996,3457,0,36,13939
11/6/2022,1,7333,146,3141,2244,0,38,12902
11/6/2022,2,7342,144,3103,1915,0,37,12541
11/6/2022,3,7354,145,2964,2167,0,38,12668
11/6/2022,4,7360,145,3083,2190,0,39,12817
11/6/2022,5,7448,146,3068,1810,0,38,12510
11/6/2022,6,7599,146,3302,1606,0,36,12689
11/6/2022,7,7676,146,3381,1825,0,36,13064
11/6/2022,8,7679,158,4423,1736,21,38,14055
11/6/2022,9,7681,239,4626,1612,72,39,14269
11/6/2022,10,7714,237,4490,1818,226,21,14506
11/6/2022,11,7732,167,4195,2085,288,24,14491
11/6/2022,12,7742,149,3896,2384,314,36,14521
11/6/2022,13,7760,153,3823,2649,304,41,14730
11/6/2022,14,7810,314,3964,2607,232,41,14968
11/6/2022,15,7845,483,4084,2366,196,37,15011
11/6/2022,16,7871,745,4284,2118,120,36,15174
11/6/2022,17,7916,877,4519,2201,29,37,15579
11/6/2022,18,7976,871,4548,2631,0,39,16065
11/6/2022,19,7977,872,4580,2867,0,36,16332
11/6/2022,20,7980,869,4367,2941,0,34,16191
11/6/2022,21,7983,871,4170,2754,0,35,15813
11/6/2022,22,7984,538,3907,2946,0,21,15396
11/6/2022,23,7985,213,3491,2806,0,18,14513
11/6/2022,24,8002,145,3379,2373,0,28,13927
11/7/2022,1,8084,146,3113,2032,0,33,13408
11/7/2022,2,8145,146,3081,1614,0,32,13018
11/7/2022,3,8150,146,3098,1641,0,32,13067
11/7/2022,4,8155,146,3082,1757,0,33,13173
11/7/2022,5,8149,146,3114,1824,0,32,13265
11/7/2022,6,8147,146,3377,2069,0,33,13772
11/7/2022,7,8147,147,3987,2777,1,32,15091
11/7/2022,8,8147,146,4165,3559,37,34,16088
11/7/2022,9,8147,146,4048,3497,179,34,16051
11/7/2022,10,8140,146,3887,3526,300,19,16018
11/7/2022,11,8137,160,3672,3375,363,19,15726
11/7/2022,12,8151,162,4052,3197,363,31,15956
11/7/2022,13,8192,213,4446,3008,350,33,16242
11/7/2022,14,8237,425,4302,2989,323,29,16305
11/7/2022,15,8255,769,4040,2880,256,36,16236
11/7/2022,16,8260,1208,4293,2607,141,36,16545
11/7/2022,17,8262,1600,4793,2299,33,34,17021
11/7/2022,18,8267,1901,5326,2056,0,20,17570
11/7/2022,19,8269,1806,5161,2058,0,12,17306
11/7/2022,20,8273,1638,4794,2211,0,8,16924
11/7/2022,21,8273,1609,4413,2258,0,3,16556
11/7/2022,22,8266,1612,4261,2131,0,1,16271
11/7/2022,23,8268,1280,3955,1890,0,2,15395
11/7/2022,24,8262,894,4102,1852,0,6,15116
11/8/2022,1,8267,384,3951,1710,0,14,14326
11/8/2022,2,8271,237,4239,1420,0,16,14183
11/8/2022,3,8269,446,4094,1261,0,15,14085
11/8/2022,4,8270,816,3827,1107,0,13,14033
11/8/2022,5,8275,833,3919,1116,0,10,14153
11/8/2022,6,8274,865,4051,1035,0,9,14234
11/8/2022,7,8282,982,4490,1185,0,1,14940
11/8/2022,8,8283,1248,4776,1389,36,0,15732
11/8/2022,9,8282,1176,4783,1194,180,0,15615
11/8/2022,10,8281,1274,4506,1011,292,0,15364
11/8/2022,11,8276,1201,4260,973,352,0,15062
11/8/2022,12,8279,1354,4728,637,379,0,15377
11/8/2022,13,8288,1786,4744,530,380,0,15728
11/8/2022,14,8285,2029,4400,512,361,0,15587
11/8/2022,15,8280,1881,4502,582,295,0,15540
11/8/2022,16,8280,1768,4684,667,175,0,15574
11/8/2022,17,8277,2025,5217,712,37,0,16268
11/8/2022,18,8276,2344,5320,888,0,0,16828
11/8/2022,19,8293,2045,5057,1166,0,0,16561
11/8/2022,20,8290,1754,4662,1590,0,0,16296
11/8/2022,21,8283,1638,4482,2166,0,0,16569
11/8/2022,22,8276,1312,4134,2646,0,0,16368
11/8/2022,23,8279,798,4002,2959,0,0,16038
11/8/2022,24,8285,302,4066,3278,0,0,15931
11/9/2022,1,8274,265,4072,3367,0,0,15978
11/9/2022,2,8272,266,4111,3273,0,0,15922
11/9/2022,3,8256,266,3870,3220,0,0,15612
11/9/2022,4,8255,266,4278,2876,0,0,15675
11/9/2022,5,8259,266,3990,2735,0,0,15250
11/9/2022,6,8266,431,4099,2204,0,0,15000
11/9/2022,7,8259,827,4487,2232,1,0,15806
11/9/2022,8,8254,1121,4812,2534,27,0,16748
11/9/2022,9,8251,1099,4833,2333,158,0,16674
11/9/2022,10,8253,1256,4839,1943,286,0,16577
11/9/2022,11,8258,1383,4384,1958,346,0,16329
11/9/2022,12,8267,1137,4396,1713,351,0,15864
11/9/2022,13,8254,1103,4045,1530,333,0,15265
11/9/2022,14,8254,1103,4045,1530,333,0,15265
11/9/2022,15,8254,1103,4045,1530,333,0,15265
11/9/2022,16,8258,1377,4051,1376,134,18,15214
11/9/2022,17,8262,1577,4895,1412,23,46,16215
11/9/2022,18,8255,1921,5362,1759,0,51,17348
11/9/2022,19,8268,1570,5182,2170,0,51,17241
11/9/2022,20,8268,1490,4777,2740,0,51,17326
11/9/2022,21,8270,1002,4386,3196,0,51,16905
11/9/2022,22,8264,737,4184,3353,0,7,16545
11/9/2022,23,8264,305,4051,3383,0,0,16003
11/9/2022,24,8259,139,3803,3256,0,0,15457
11/10/2022,1,8258,139,3315,3118,0,0,14830
11/10/2022,2,8258,139,3261,2778,0,0,14436
11/10/2022,3,8260,139,3219,2662,0,0,14280
11/10/2022,4,8259,139,3229,2511,0,0,14138
11/10/2022,5,8253,139,3334,2735,0,0,14461
11/10/2022,6,8255,139,3869,2650,0,0,14913
11/10/2022,7,8264,139,4276,3121,0,0,15800
11/10/2022,8,8266,144,4390,3451,9,0,16260
11/10/2022,9,8280,143,4759,3454,76,0,16712
11/10/2022,10,8290,192,4775,3401,184,0,16842
11/10/2022,11,8288,305,4413,3268,260,0,16534
11/10/2022,12,8291,492,4400,3115,346,0,16644
11/10/2022,13,8290,778,4693,2884,352,0,16997
11/10/2022,14,8293,1174,4672,2679,323,0,17141
11/10/2022,15,8294,1375,4474,2564,251,0,16958
11/10/2022,16,8262,1650,4430,2630,136,0,17108
11/10/2022,17,8297,1590,4601,2698,24,0,17210
11/10/2022,18,8293,1594,4566,3083,0,0,17536
11/10/2022,19,8294,1603,4465,3067,0,0,17429
11/10/2022,20,8295,935,4473,3466,0,0,17169
11/10/2022,21,8292,675,4257,3831,0,0,17055
11/10/2022,22,8291,301,4241,3998,0,0,16831
11/10/2022,23,8284,137,3925,4034,0,0,16380
11/10/2022,24,8285,137,3426,3729,0,0,15577
11/11/2022,1,8297,137,3307,3253,0,0,14994
11/11/2022,2,8289,138,3321,3130,0,0,14878
11/11/2022,3,8302,137,3215,2929,0,0,14583
11/11/2022,4,8314,137,3276,2718,0,0,14445
11/11/2022,5,8297,207,3452,2392,0,0,14348
11/11/2022,6,8302,305,4399,1841,0,0,14847
11/11/2022,7,8308,506,4846,1621,0,0,15281
11/11/2022,8,8312,796,5008,1662,7,0,15785
11/11/2022,9,8314,1219,4798,1798,23,0,16152
11/11/2022,10,8312,1357,4729,1713,37,0,16148
11/11/2022,11,8319,1435,5143,1334,52,0,16283
11/11/2022,12,8307,1678,5388,859,52,0,16284
11/11/2022,13,8311,1972,5241,569,42,0,16135
11/11/2022,14,8308,1977,5166,508,24,0,15983
11/11/2022,15,8309,1766,5410,406,18,0,15909
11/11/2022,16,8308,1782,5611,280,11,0,15992
11/11/2022,17,8302,1602,5555,240,1,0,15700
11/11/2022,18,8300,1716,5616,267,0,0,15899
11/11/2022,19,8305,1780,5641,471,0,0,16197
11/11/2022,20,8310,1680,4806,1158,0,0,15954
11/11/2022,21,8305,1198,4430,1853,0,0,15786
11/11/2022,22,8300,608,4546,2368,0,0,15822
11/11/2022,23,8299,209,4093,2492,0,0,15093
11/11/2022,24,8312,137,3951,2486,0,0,14886
11/12/2022,1,8305,138,3804,2430,0,0,14677
11/12/2022,2,8294,139,3636,2487,0,0,14556
11/12/2022,3,8302,139,3700,2258,0,0,14399
11/12/2022,4,8309,139,3370,2495,0,0,14313
11/12/2022,5,8308,139,3482,2371,0,0,14300
11/12/2022,6,8306,138,3699,2102,0,0,14245
11/12/2022,7,8310,141,4474,1766,0,0,14691
11/12/2022,8,8315,142,4812,1558,4,0,14831
11/12/2022,9,8312,142,4750,1457,24,0,14685
11/12/2022,10,8309,141,4621,1526,77,0,14674
11/12/2022,11,8311,166,5236,1263,155,0,15131
11/12/2022,12,8309,313,5271,1248,126,0,15267
11/12/2022,13,8311,410,4565,1521,107,0,14914
11/12/2022,14,8305,555,4489,1427,116,0,14892
11/12/2022,15,8304,603,5102,1232,71,0,15312
11/12/2022,16,8312,818,5039,1225,15,0,15409
11/12/2022,17,8310,994,4629,1285,0,0,15218
11/12/2022,18,8298,1087,4804,1539,0,0,15728
11/12/2022,19,8299,1058,4930,1402,0,0,15689
11/12/2022,20,8301,1049,5189,1268,0,0,15807
11/12/2022,21,8301,1050,4929,1374,0,0,15654
11/12/2022,22,8297,886,4446,1224,0,0,14853
11/12/2022,23,8301,529,4566,1265,0,0,14661
11/12/2022,24,8304,204,4401,1254,0,0,14163
11/13/2022,1,8313,136,4718,1236,0,0,14403
11/13/2022,2,8313,136,4811,1167,0,0,14427
11/13/2022,3,8313,137,4419,1304,0,0,14173
11/13/2022,4,8321,137,4162,1471,0,0,14091
11/13/2022,5,8315,137,4204,1559,0,0,14215
11/13/2022,6,8311,137,4765,1460,0,0,14673
11/13/2022,7,8315,137,4870,1549,0,0,14871
11/13/2022,8,8319,137,4816,1522,6,0,14800
11/13/2022,9,8314,137,4876,1619,23,0,14969
11/13/2022,10,8314,137,4804,1847,58,0,15160
11/13/2022,11,8309,138,4734,1920,85,0,15186
11/13/2022,12,8308,235,4658,1837,122,0,15160
11/13/2022,13,8296,298,4788,2099,84,0,15565
11/13/2022,14,8288,440,4475,2505,67,0,15775
11/13/2022,15,8290,688,4648,2454,89,0,16169
11/13/2022,16,8290,859,4842,2493,47,0,16531
11/13/2022,17,8296,1056,5016,2248,6,0,16622
11/13/2022,18,8292,1058,5752,1926,0,0,17028
11/13/2022,19,8296,953,5555,1768,0,0,16572
11/13/2022,20,8306,945,5165,1587,0,0,16003
11/13/2022,21,8303,838,5271,1173,0,2,15587
11/13/2022,22,8303,738,5071,910,0,0,15022
11/13/2022,23,8306,483,5203,797,0,0,14789
11/13/2022,24,8310,190,4805,808,0,2,14115
11/14/2022,1,8307,136,4667,834,0,2,13946
11/14/2022,2,8310,202,4516,944,0,4,13976
11/14/2022,3,8307,394,4265,838,0,1,13805
11/14/2022,4,8309,514,4441,811,0,1,14076
11/14/2022,5,8312,758,4669,802,0,0,14541
11/14/2022,6,8319,1305,4342,768,0,7,14741
11/14/2022,7,8321,1472,4940,654,0,33,15420
11/14/2022,8,8324,1745,5260,528,15,62,15934
11/14/2022,9,8325,2227,5116,347,114,61,16190
11/14/2022,10,8322,2301,5071,239,224,61,16218
11/14/2022,11,8323,2269,4887,221,291,61,16052
11/14/2022,12,8327,2437,5008,177,307,61,16317
11/14/2022,13,8331,2643,5055,137,220,61,16447
11/14/2022,14,8332,2789,5079,118,184,61,16563
11/14/2022,15,8329,2905,5182,108,138,61,16723
11/14/2022,16,8332,2673,5309,83,52,61,16510
11/14/2022,17,8334,2681,5535,60,7,61,16678
11/14/2022,18,8323,3454,5426,50,0,61,17314
11/14/2022,19,8329,3117,5568,68,0,61,17143
11/14/2022,20,8335,2806,5593,199,0,61,16994
11/14/2022,21,8333,2923,5338,325,0,61,16980
11/14/2022,22,8320,2496,5190,458,0,13,16477
11/14/2022,23,8321,1793,4720,618,0,0,15452
11/14/2022,24,8322,1485,4423,795,0,0,15025
11/15/2022,1,8313,766,4282,994,0,0,14355
11/15/2022,2,8321,525,4443,1161,0,0,14450
11/15/2022,3,8332,527,4432,1357,0,0,14648
11/15/2022,4,8339,525,4291,1549,0,0,14704
11/15/2022,5,8335,669,4337,1562,0,0,14903
11/15/2022,6,8339,901,4227,1122,0,1,14590
11/15/2022,7,8340,1158,4415,1500,0,1,15414
11/15/2022,8,8340,1302,4912,1862,11,2,16429
11/15/2022,9,8340,1437,4936,2225,56,0,16994
11/15/2022,10,8340,1316,4578,2329,77,0,16640
11/15/2022,11,8337,1368,4800,2286,57,0,16848
11/15/2022,12,8340,1501,4814,2511,81,4,17251
11/15/2022,13,8329,1196,4627,2458,68,5,16683
11/15/2022,14,8327,1499,4810,2296,45,3,16980
11/15/2022,15,8325,1797,4411,2369,33,5,16940
11/15/2022,16,8309,2059,4425,2268,13,13,17087
11/15/2022,17,8294,2526,5208,2147,0,43,18218
11/15/2022,18,8281,3029,5297,1915,0,53,18575
11/15/2022,19,8257,2451,5214,1809,0,52,17783
11/15/2022,20,7923,2306,5210,1762,0,51,17252
11/15/2022,21,7751,2185,5272,1616,0,51,16875
11/15/2022,22,7748,2015,4858,1466,0,51,16138
11/15/2022,23,7753,1350,4702,1401,0,13,15219
11/15/2022,24,7764,718,4338,1436,0,0,14256
11/16/2022,1,7776,413,4609,1445,0,0,14243
11/16/2022,2,7777,469,4807,1400,0,0,14453
11/16/2022,3,7781,507,4673,1352,0,0,14313
11/16/2022,4,7783,625,4331,1384,0,0,14123
11/16/2022,5,7789,1046,4085,1395,0,0,14315
11/16/2022,6,7804,1542,4248,1358,0,0,14952
11/16/2022,7,7800,1857,4637,1237,0,0,15531
11/16/2022,8,7789,2406,5248,1258,0,0,16701
11/16/2022,9,7779,2755,5196,1374,5,0,17109
11/16/2022,10,7779,2565,5196,1361,25,0,16926
11/16/2022,11,7777,2749,5078,1296,30,0,16930
11/16/2022,12,7779,2717,5231,1189,52,0,16968
11/16/2022,13,7781,2799,5236,1095,36,3,16950
11/16/2022,14,7780,2995,5301,919,43,1,17039
11/16/2022,15,7786,3246,5194,810,47,0,17083
11/16/2022,16,7782,3235,5080,666,21,6,16790
11/16/2022,17,7771,3120,5140,718,2,38,16789
11/16/2022,18,7775,3393,5266,875,0,54,17363
11/16/2022,19,7781,3150,5374,1047,0,53,17405
11/16/2022,20,7784,2900,5308,1066,0,51,17109
11/16/2022,21,7783,3111,5321,988,0,51,17254
11/16/2022,22,7778,3063,5286,916,0,12,17055
11/16/2022,23,7782,2311,4985,882,0,0,15960
11/16/2022,24,7783,1247,4410,914,0,0,14354
11/17/2022,1,7780,671,4516,1065,0,0,14032
11/17/2022,2,7788,827,4309,1249,0,0,14173
11/17/2022,3,7796,961,4252,1486,0,0,14495
11/17/2022,4,7794,963,4235,1847,0,0,14839
11/17/2022,5,7796,965,4290,2244,0,0,15295
11/17/2022,6,7809,1032,4330,2059,0,0,15230
11/17/2022,7,7810,1298,4734,2243,0,0,16085
11/17/2022,8,7807,1654,5114,2187,3,0,16765
11/17/2022,9,7804,1822,5136,2047,38,0,16847
11/17/2022,10,7799,1687,5033,1962,124,0,16605
11/17/2022,11,7803,1315,4918,1960,124,0,16120
11/17/2022,12,7810,1295,4718,2070,141,0,16034
11/17/2022,13,7810,1554,4725,2159,121,0,16369
11/17/2022,14,7811,1672,4821,2222,117,0,16643
11/17/2022,15,7808,1517,5032,2281,86,0,16724
11/17/2022,16,7813,1626,4971,2287,57,0,16754
11/17/2022,17,7813,1805,5346,2337,10,0,17311
11/17/2022,18,7821,1795,5412,2839,0,0,17867
11/17/2022,19,7824,1681,4965,3012,0,0,17482
11/17/2022,20,7826,1585,4946,3087,0,0,17444
11/17/2022,21,7827,1244,4980,3348,0,0,17399
11/17/2022,22,7824,977,4823,3363,0,0,16987
11/17/2022,23,7827,466,4855,3432,0,0,16580
11/17/2022,24,7826,197,4894,3489,0,0,16406
11/18/2022,1,7816,136,4600,3553,0,0,16105
11/18/2022,2,7819,136,4670,3512,0,0,16137
11/18/2022,3,7822,137,4933,3332,0,0,16224
11/18/2022,4,7825,239,4898,3207,0,0,16169
11/18/2022,5,7822,476,4795,3236,0,0,16329
11/18/2022,6,7832,735,4523,3031,0,0,16121
11/18/2022,7,7860,856,4766,2858,0,0,16340
11/18/2022,8,7859,1324,5285,2732,0,0,17200
11/18/2022,9,7860,1656,5170,2921,3,0,17610
11/18/2022,10,7857,1622,5357,3185,9,0,18030
11/18/2022,11,7878,1837,5381,3199,19,0,18314
11/18/2022,12,7899,1220,5195,3235,49,0,17598
11/18/2022,13,7907,1065,5310,3246,82,0,17610
11/18/2022,14,7904,1321,5325,3293,68,0,17911
11/18/2022,15,7911,1135,5074,3300,69,0,17489
11/18/2022,16,7930,1345,5079,3376,36,0,17766
11/18/2022,17,7946,1145,5224,3456,6,0,17777
11/18/2022,18,7966,1299,5720,3524,0,0,18509
11/18/2022,19,7983,1228,5345,3585,0,0,18141
11/18/2022,20,7983,1173,5359,3693,0,0,18208
11/18/2022,21,7983,1005,5225,3628,0,0,17841
11/18/2022,22,7994,915,5138,3627,0,0,17674
11/18/2022,23,8030,554,4860,3675,0,0,17119
11/18/2022,24,8045,173,4503,3731,0,0,16452
11/19/2022,1,8044,139,4381,3752,0,0,16316
11/19/2022,2,8046,139,4191,3757,0,0,16133
11/19/2022,3,8065,139,4367,3713,0,0,16284
11/19/2022,4,8068,139,4264,3790,0,0,16261
11/19/2022,5,8070,138,4105,3853,0,0,16166
11/19/2022,6,8095,204,4528,3751,0,0,16578
11/19/2022,7,8108,366,4494,3684,0,1,16653
11/19/2022,8,8109,470,4504,3815,2,18,16918
11/19/2022,9,8111,485,4796,3801,13,49,17255
11/19/2022,10,8134,703,5029,3901,24,55,17846
11/19/2022,11,8161,778,4881,3976,33,52,17881
11/19/2022,12,8185,827,4381,4084,37,52,17566
11/19/2022,13,8199,1016,4377,3988,32,34,17646
11/19/2022,14,8207,1409,4350,4145,29,0,18140
11/19/2022,15,8243,2064,4429,3932,23,0,18691
11/19/2022,16,8256,2290,4588,4300,6,0,19440
11/19/2022,17,8256,2303,4663,4373,1,0,19596
11/19/2022,18,8261,2506,4692,4061,0,0,19520
11/19/2022,19,8269,2577,4697,3682,0,0,19225
11/19/2022,20,8270,2666,4485,3606,0,0,19027
11/19/2022,21,8270,2360,4504,3651,0,0,18785
11/19/2022,22,8265,2272,4449,3473,0,0,18459
11/19/2022,23,8260,2214,4310,3087,0,0,17871
11/19/2022,24,8259,1663,4168,3038,0,0,17128
11/20/2022,1,8253,703,4062,3846,0,0,16864
11/20/2022,2,8252,481,3875,3898,0,0,16506
11/20/2022,3,8254,456,3721,3810,0,0,16241
11/20/2022,4,8281,487,3642,3725,0,0,16135
11/20/2022,5,8321,498,3752,3885,0,0,16456
11/20/2022,6,8320,502,3711,3899,0,0,16432
11/20/2022,7,8319,502,4105,3921,0,0,16847
11/20/2022,8,8326,527,4474,3852,3,0,17182
11/20/2022,9,8325,620,4856,3725,28,0,17554
11/20/2022,10,8321,773,4911,3706,85,0,17796
11/20/2022,11,8319,840,4891,3790,139,0,17979
11/20/2022,12,8293,950,4837,3764,153,0,17997
11/20/2022,13,8299,1502,4932,3282,174,0,18189
11/20/2022,14,8301,1897,4974,2533,192,0,17897
11/20/2022,15,8306,2057,4954,2604,160,0,18081
11/20/2022,16,8305,2324,4932,2969,87,0,18617
11/20/2022,17,8300,2607,4836,2692,14,5,18454
11/20/2022,18,8305,3205,5302,2370,0,35,19217
11/20/2022,19,8319,3235,5134,2255,0,54,18997
11/20/2022,20,8315,2973,4858,2241,0,53,18440
11/20/2022,21,8316,2688,4611,2352,0,53,18020
11/20/2022,22,8310,2192,4678,2339,0,53,17572
11/20/2022,23,8315,2113,4397,2206,0,13,17044
11/20/2022,24,8315,1638,4258,2313,0,0,16524
11/21/2022,1,8324,1379,3982,2349,0,0,16034
11/21/2022,2,8326,1286,4014,2458,0,0,16084
11/21/2022,3,8324,1286,4043,2694,0,0,16347
11/21/2022,4,8328,1411,3959,3121,0,0,16819
11/21/2022,5,8316,1508,3966,3311,0,0,17101
11/21/2022,6,8323,1616,4054,3318,0,0,17311
11/21/2022,7,8327,1646,4469,3209,0,0,17651
11/21/2022,8,8327,1649,4550,3965,6,0,18497
11/21/2022,9,8329,1664,4562,4348,48,0,18951
11/21/2022,10,8333,1668,4629,4478,115,0,19223
11/21/2022,11,8332,1673,4434,4375,163,0,18977
11/21/2022,12,8331,1678,4221,4387,220,0,18837
11/21/2022,13,8327,1690,4219,4232,255,0,18723
11/21/2022,14,8327,1700,4322,3862,252,0,18463
11/21/2022,15,8327,1890,4297,3818,217,0,18549
11/21/2022,16,8326,2366,4484,3384,101,0,18661
11/21/2022,17,8326,2895,4468,3765,12,0,19466
11/21/2022,18,8324,3160,4661,3913,0,0,20058
11/21/2022,19,8318,3299,4677,2923,0,0,19217
11/21/2022,20,8322,3253,4746,2735,0,0,19056
11/21/2022,21,8321,2395,4750,2712,0,0,18178
11/21/2022,22,8319,2265,4632,2169,0,0,17385
11/21/2022,23,8314,1845,4711,1514,0,0,16384
11/21/2022,24,8300,1583,5038,921,0,0,15842
11/22/2022,1,8313,1377,4867,586,0,0,15143
11/22/2022,2,8315,1199,4798,425,0,0,14737
11/22/2022,3,8315,1257,4735,273,0,0,14580
11/22/2022,4,8318,1347,4684,230,0,0,14579
11/22/2022,5,8322,1613,4545,210,0,0,14690
11/22/2022,6,8315,2125,4300,273,0,0,15013
11/22/2022,7,8324,2770,4923,423,0,0,16440
11/22/2022,8,8321,2974,5106,703,10,0,17114
11/22/2022,9,8318,2880,5064,990,65,0,17317
11/22/2022,10,8317,2841,5023,1075,118,0,17374
11/22/2022,11,8326,2966,4753,1048,178,0,17271
11/22/2022,12,8322,2645,4784,1175,205,0,17131
11/22/2022,13,8317,2029,4657,1454,204,0,16661
11/22/2022,14,8318,1827,4631,1596,206,0,16578
11/22/2022,15,8318,2184,4430,1544,167,0,16643
11/22/2022,16,8315,2566,4813,1361,81,0,17136
11/22/2022,17,8312,2802,5182,1297,12,16,17621
11/22/2022,18,8307,2975,5267,1333,0,46,17928
11/22/2022,19,8310,2807,5214,1593,0,54,17978
11/22/2022,20,8313,2584,5172,1699,0,54,17822
11/22/2022,21,8308,2709,5219,1490,0,54,17780
11/22/2022,22,8302,2143,5159,1417,0,53,17074
11/22/2022,23,8302,1709,4808,1365,0,9,16193
11/22/2022,24,8302,1005,4566,1323,0,0,15196
11/23/2022,1,8295,891,4724,1276,0,0,15186
11/23/2022,2,8300,782,4550,871,0,0,14503
11/23/2022,3,8289,892,4619,637,0,0,14437
11/23/2022,4,8299,1026,4570,503,0,0,14398
11/23/2022,5,8297,1588,4496,313,0,0,14694
11/23/2022,6,8210,2292,4452,193,0,8,15155
11/23/2022,7,8201,2891,4899,132,0,40,16163
11/23/2022,8,8202,3540,5050,106,3,52,16953
11/23/2022,9,8199,3432,4946,167,60,51,16855
11/23/2022,10,8197,3448,4837,206,155,51,16894
11/23/2022,11,8196,3377,4736,175,212,52,16748
11/23/2022,12,8256,2772,4767,189,236,52,16272
11/23/2022,13,8285,2663,4619,238,273,52,16130
11/23/2022,14,8282,2737,4428,252,230,53,15982
11/23/2022,15,8284,2867,4523,209,155,53,16091
11/23/2022,16,8287,3097,4843,182,86,53,16548
11/23/2022,17,8283,3327,5012,221,11,53,16907
11/23/2022,18,8276,3653,5326,395,0,53,17703
11/23/2022,19,8274,3471,5292,571,0,52,17660
11/23/2022,20,8276,3604,5308,770,0,53,18011
11/23/2022,21,8273,3164,5150,878,0,50,17515
11/23/2022,22,8267,2689,4832,984,0,8,16780
11/23/2022,23,8276,1858,4636,1132,0,0,15902
11/23/2022,24,8267,1353,4452,1422,0,0,15494
11/24/2022,1,8267,905,4158,1560,0,0,14890
11/24/2022,2,8266,748,4176,1761,0,0,14951
11/24/2022,3,8260,747,4190,1744,0,7,14948
11/24/2022,4,8270,744,4167,1671,0,20,14872
11/24/2022,5,8268,810,4128,1490,0,21,14717
11/24/2022,6,8173,1030,4070,1275,0,20,14568
11/24/2022,7,8176,1425,4583,1238,0,21,15443
11/24/2022,8,8174,1964,5001,1142,8,21,16310
11/24/2022,9,8173,1876,4746,1293,67,21,16176
11/24/2022,10,8186,1830,4670,1325,187,21,16219
11/24/2022,11,8261,1638,4711,1139,265,21,16035
11/24/2022,12,8264,1748,4728,997,284,21,16042
11/24/2022,13,8258,1389,4542,1108,273,21,15591
11/24/2022,14,8260,1323,4181,1137,252,21,15174
11/24/2022,15,8265,1465,4190,988,168,21,15097
11/24/2022,16,8265,1609,4430,1371,100,21,15796
11/24/2022,17,8268,1595,4764,1515,7,21,16170
11/24/2022,18,8269,1595,4742,1837,0,15,16458
11/24/2022,19,8266,1595,4590,1901,0,11,16363
11/24/2022,20,8270,1603,4566,2263,0,8,16710
11/24/2022,21,8268,1168,4499,2871,0,8,16814
11/24/2022,22,8275,764,4748,3023,0,8,16818
11/24/2022,23,8269,270,4635,3333,0,8,16515
11/24/2022,24,8278,142,4110,3058,0,8,15596
11/25/2022,1,8278,142,3889,2826,0,11,15146
11/25/2022,2,8281,142,3591,2760,0,19,14793
11/25/2022,3,8280,142,3608,2663,0,14,14707
11/25/2022,4,8283,143,3553,2794,0,11,14784
11/25/2022,5,8285,142,3572,2822,0,11,14832
11/25/2022,6,8287,213,3853,2816,0,11,15180
11/25/2022,7,8297,293,4182,3377,0,17,16166
11/25/2022,8,8294,361,4520,3905,0,9,17089
11/25/2022,9,8291,364,4866,3857,7,19,17404
11/25/2022,10,8281,461,5327,3729,28,20,17846
11/25/2022,11,8291,491,5090,3711,111,20,17714
11/25/2022,12,8283,483,4408,3599,162,20,16955
11/25/2022,13,8291,564,4481,3454,136,20,16946
11/25/2022,14,8293,846,4300,3456,151,20,17066
11/25/2022,15,8302,1010,4226,3159,93,20,16810
11/25/2022,16,8311,1164,4459,2774,44,21,16773
11/25/2022,17,8304,1200,5001,2420,4,21,16950
11/25/2022,18,8307,1260,5260,2167,0,21,17015
11/25/2022,19,8309,1209,5236,1856,0,21,16631
11/25/2022,20,8312,1240,5298,1468,0,10,16328
11/25/2022,21,8311,1438,5259,1302,0,17,16327
11/25/2022,22,8311,852,5166,1310,0,20,15659
11/25/2022,23,8308,404,5072,1287,0,20,15091
11/25/2022,24,8302,161,5062,1260,0,21,14806
11/26/2022,1,8315,145,4999,1304,0,21,14784
11/26/2022,2,8320,142,4898,1403,0,21,14784
11/26/2022,3,8322,142,4730,1687,0,21,14902
11/26/2022,4,8324,144,3823,2367,0,21,14679
11/26/2022,5,8324,152,3575,2467,0,21,14539
11/26/2022,6,8320,151,3885,2397,0,21,14774
11/26/2022,7,8329,152,4125,2639,0,21,15266
11/26/2022,8,8328,152,4118,3055,9,21,15683
11/26/2022,9,8332,151,4108,3195,103,21,15910
11/26/2022,10,8337,145,4141,3077,235,21,15956
11/26/2022,11,8333,139,4037,2961,337,21,15828
11/26/2022,12,8343,211,3867,2564,349,21,15355
11/26/2022,13,8344,241,3855,2459,380,20,15299
11/26/2022,14,8344,250,3807,2602,348,20,15371
11/26/2022,15,8347,250,3922,2787,256,20,15582
11/26/2022,16,8346,274,4231,3408,126,20,16405
11/26/2022,17,8344,351,4238,3697,16,20,16666
11/26/2022,18,8340,355,4564,4026,0,20,17305
11/26/2022,19,8352,355,4868,4085,0,20,17680
11/26/2022,20,8355,224,4734,3995,0,20,17328
11/26/2022,21,8353,136,4398,4047,0,21,16955
11/26/2022,22,8353,136,4173,3949,0,22,16633
11/26/2022,23,8355,136,3959,3328,0,22,15800
11/26/2022,24,8354,136,3665,2961,0,22,15138
11/27/2022,1,8348,136,3564,2575,0,13,14636
11/27/2022,2,8347,136,3593,2391,0,12,14479
11/27/2022,3,8349,136,3719,2025,0,12,14241
11/27/2022,4,8350,136,3925,1634,0,12,14057
11/27/2022,5,8349,136,4445,1256,0,12,14198
11/27/2022,6,8346,221,4530,1097,0,12,14206
11/27/2022,7,8349,282,4946,872,0,12,14461
11/27/2022,8,8347,467,4983,634,2,12,14445
11/27/2022,9,8350,793,4872,587,24,12,14638
11/27/2022,10,8347,772,4670,531,38,12,14370
11/27/2022,11,8353,760,4834,647,48,12,14654
11/27/2022,12,8358,761,4948,865,50,12,14994
11/27/2022,13,8353,784,5014,1159,31,12,15353
11/27/2022,14,8351,815,5051,1027,23,18,15285
11/27/2022,15,8351,1064,5279,907,16,12,15629
11/27/2022,16,8353,1199,5370,837,4,17,15780
11/27/2022,17,8351,1072,5167,971,0,19,15580
11/27/2022,18,8348,931,5048,1512,0,17,15856
11/27/2022,19,8352,756,4509,1771,0,12,15400
11/27/2022,20,8354,435,4496,2287,0,12,15584
11/27/2022,21,8353,349,4753,2345,0,12,15812
11/27/2022,22,8350,191,4996,2121,0,12,15670
11/27/2022,23,8344,150,5205,2000,0,12,15711
11/27/2022,24,8346,150,4552,2223,0,12,15283
11/28/2022,1,8345,186,3971,2584,0,12,15098
11/28/2022,2,8347,234,3778,2636,0,12,15007
11/28/2022,3,8347,348,3925,2298,0,12,14930
11/28/2022,4,8350,396,4310,2033,0,12,15101
11/28/2022,5,8351,590,4596,1750,0,12,15299
11/28/2022,6,8354,908,4671,1187,0,12,15132
11/28/2022,7,8356,1331,4958,1036,0,12,15693
11/28/2022,8,8356,1974,5183,1058,2,12,16585
11/28/2022,9,8355,2499,5121,849,28,12,16864
11/28/2022,10,8351,2566,5110,699,63,12,16801
11/28/2022,11,8348,2862,5189,563,81,12,17055
11/28/2022,12,8354,3050,5394,378,68,12,17256
11/28/2022,13,8353,3180,5285,249,63,11,17141
11/28/2022,14,8352,3128,5188,214,62,11,16955
11/28/2022,15,8357,3084,5288,214,52,11,17006
11/28/2022,16,8357,2911,5472,209,19,11,16979
11/28/2022,17,8357,2924,5531,195,1,11,17019
11/28/2022,18,8358,3401,5583,200,0,11,17553
11/28/2022,19,8360,3252,5661,194,0,11,17478
11/28/2022,20,8364,3084,5752,246,0,11,17457
11/28/2022,21,8362,3196,5558,245,0,11,17372
11/28/2022,22,8363,2926,5031,277,0,11,16608
11/28/2022,23,8362,2094,4851,481,0,11,15799
11/28/2022,24,8360,1176,4598,591,0,11,14736
11/29/2022,1,8360,925,4634,687,0,11,14617
11/29/2022,2,8361,927,4720,671,0,11,14690
11/29/2022,3,8357,840,4807,617,0,11,14632
11/29/2022,4,8360,867,4673,681,0,11,14592
11/29/2022,5,8365,1083,4258,835,0,11,14552
11/29/2022,6,8359,1500,4105,898,0,11,14873
11/29/2022,7,8365,1932,4302,1150,0,11,15760
11/29/2022,8,8365,2360,5237,1188,0,11,17161
11/29/2022,9,8364,2626,5304,1306,9,11,17620
11/29/2022,10,8357,2751,5306,1504,30,11,17959
11/29/2022,11,8351,2276,5213,1642,58,11,17551
11/29/2022,12,8347,2232,5049,1887,68,11,17594
11/29/2022,13,8350,2049,4893,2063,66,11,17432
11/29/2022,14,8358,1961,4846,2181,69,11,17426
11/29/2022,15,8369,2180,4843,2213,40,11,17656
11/29/2022,16,8368,2298,4271,2848,29,11,17825
11/29/2022,17,8357,2296,4687,3283,3,11,18637
11/29/2022,18,8358,2300,4665,3597,0,11,18931
11/29/2022,19,8350,1758,4579,3580,0,11,18278
11/29/2022,20,8345,1330,4612,3472,0,11,17770
11/29/2022,21,8347,788,4712,3941,0,14,17802
11/29/2022,22,8340,295,4962,3925,0,18,17540
11/29/2022,23,8341,136,4505,4036,0,18,17036
11/29/2022,24,8343,135,3906,3990,0,18,16392
11/30/2022,1,8346,136,3553,3927,0,18,15980
11/30/2022,2,8351,156,3247,3650,0,18,15422
11/30/2022,3,8347,175,3297,3300,0,18,15137
11/30/2022,4,8343,195,3248,3136,0,18,14940
11/30/2022,5,8336,269,3170,3299,0,18,15092
11/30/2022,6,8333,363,3399,3447,0,18,15560
11/30/2022,7,8334,369,3751,3447,0,18,15919
11/30/2022,8,8334,429,3976,4155,0,18,16912
11/30/2022,9,8335,585,4070,4291,0,15,17296
11/30/2022,10,8333,603,4214,4300,2,10,17462
11/30/2022,11,8330,618,4665,4275,8,10,17906
11/30/2022,12,8336,622,4729,4297,20,10,18014
11/30/2022,13,8233,623,4985,4314,15,11,18181
11/30/2022,14,8229,667,4937,4431,17,10,18291
11/30/2022,15,8226,840,4926,4532,13,10,18547
11/30/2022,16,8227,958,4625,4459,8,10,18287
11/30/2022,17,8231,1005,5215,4385,0,10,18846
11/30/2022,18,8238,1124,5416,4406,0,17,19201
11/30/2022,19,8240,973,5104,4380,0,18,18715
11/30/2022,20,8237,986,4598,4355,0,18,18194
11/30/2022,21,8243,827,4947,4493,0,26,18536
11/30/2022,22,8239,342,4660,4467,0,34,17742
11/30/2022,23,8242,285,4395,4466,0,48,17436
11/30/2022,24,8248,309,4044,4478,0,53,17132
12/1/2022,1,8247,310,3802,4493,0,40,16892
12/1/2022,2,8244,311,3858,4454,0,35,16902
12/1/2022,3,8244,311,3587,4338,0,37,16517
12/1/2022,4,8240,414,3598,4266,0,25,16543
12/1/2022,5,8250,487,3680,4201,0,18,16636
12/1/2022,6,8256,702,3950,4103,0,18,17029
12/1/2022,7,8255,1002,4290,3860,0,19,17426
12/1/2022,8,8256,1328,4874,3768,0,18,18244
12/1/2022,9,8260,1443,4888,3576,12,16,18195
12/1/2022,10,8265,1441,4866,3557,42,10,18181
12/1/2022,11,8251,1472,4708,3373,92,10,17906
12/1/2022,12,8315,1486,4975,2997,128,10,17911
12/1/2022,13,8350,1676,4941,2567,142,10,17686
12/1/2022,14,8350,1848,5168,2158,137,10,17671
12/1/2022,15,8351,2177,4969,1873,97,10,17477
12/1/2022,16,8355,2495,4963,1644,50,10,17517
12/1/2022,17,8352,2560,5493,1487,6,10,17908
12/1/2022,18,8350,2852,5932,1258,0,18,18410
12/1/2022,19,8361,2849,5899,1152,0,18,18279
12/1/2022,20,8362,2582,5948,1302,0,18,18212
12/1/2022,21,8359,2448,5769,1613,0,18,18207
12/1/2022,22,8349,2121,5278,1836,0,18,17602
12/1/2022,23,8348,1418,5209,1899,0,18,16892
12/1/2022,24,8350,585,4673,2371,0,9,15988
12/2/2022,1,8362,160,4570,2481,0,1,15574
12/2/2022,2,8356,135,4978,2321,0,0,15790
12/2/2022,3,8359,135,5224,2345,0,0,16063
12/2/2022,4,8362,135,4952,2454,0,0,15903
12/2/2022,5,8361,334,4699,2573,0,0,15967
12/2/2022,6,8295,598,4253,2676,0,0,15822
12/2/2022,7,8284,906,4148,2880,0,0,16218
12/2/2022,8,8280,1087,4737,3309,1,0,17414
12/2/2022,9,8275,1065,4650,3573,20,0,17583
12/2/2022,10,8277,1065,4592,3783,51,0,17768
12/2/2022,11,8286,1054,5217,3701,118,0,18376
12/2/2022,12,8286,1191,5316,3825,154,0,18772
12/2/2022,13,8288,751,5059,3897,113,0,18108
12/2/2022,14,8283,738,5392,3818,113,0,18344
12/2/2022,15,8289,705,5415,3761,100,0,18270
12/2/2022,16,8337,748,5248,3884,27,0,18244
12/2/2022,17,8368,747,4976,4122,0,0,18213
12/2/2022,18,8367,747,4919,4352,0,0,18385
12/2/2022,19,8364,582,4762,4336,0,0,18044
12/2/2022,20,8368,567,4861,4433,0,0,18229
12/2/2022,21,8366,580,4874,4428,0,0,18248
12/2/2022,22,8360,247,4756,4442,0,0,17805
12/2/2022,23,8356,163,4355,4453,0,0,17327
12/2/2022,24,8359,136,4037,4318,0,0,16850
12/3/2022,1,8361,135,3765,4159,0,0,16420
12/3/2022,2,8357,136,3259,4184,0,0,15936
12/3/2022,3,8357,136,3186,3935,0,0,15614
12/3/2022,4,8354,136,3209,3778,0,0,15477
12/3/2022,5,8353,136,3226,3831,0,0,15546
12/3/2022,6,8354,136,3550,3769,0,0,15809
12/3/2022,7,8363,137,3604,4198,0,0,16302
12/3/2022,8,8362,137,4119,4422,0,0,17040
12/3/2022,9,8360,135,4457,4335,2,0,17289
12/3/2022,10,8359,141,5063,4312,7,0,17882
12/3/2022,11,8360,164,5059,4411,12,0,18006
12/3/2022,12,8354,163,5084,4420,76,0,18097
12/3/2022,13,8352,178,4918,4379,59,0,17886
12/3/2022,14,8344,296,5236,4330,81,0,18287
12/3/2022,15,8326,569,4990,4302,53,0,18240
12/3/2022,16,8326,754,5054,4147,15,0,18296
12/3/2022,17,8332,761,5298,3613,3,0,18007
12/3/2022,18,8325,764,5587,3410,0,0,18086
12/3/2022,19,8331,747,5166,3327,0,0,17571
12/3/2022,20,8330,738,5030,2987,0,0,17085
12/3/2022,21,8330,685,5422,2526,0,0,16963
12/3/2022,22,8328,554,5191,2510,0,0,16583
12/3/2022,23,8339,543,4238,2574,0,0,15694
12/3/2022,24,8341,210,4742,2358,0,0,15651
12/4/2022,1,8339,172,5058,2155,0,0,15724
12/4/2022,2,8352,189,4919,1841,0,0,15301
12/4/2022,3,8354,190,4870,1672,0,0,15086
12/4/2022,4,8355,151,4483,1724,0,0,14713
12/4/2022,5,8356,141,4403,1879,0,0,14779
12/4/2022,6,8283,272,4756,1738,0,0,15049
12/4/2022,7,8278,504,4959,1737,0,0,15478
12/4/2022,8,8283,904,4976,1852,2,0,16017
12/4/2022,9,8279,852,5015,1851,42,0,16039
12/4/2022,10,8275,947,5139,1784,190,0,16335
12/4/2022,11,8279,1097,5182,2357,249,0,17164
12/4/2022,12,8295,1148,4775,2885,227,0,17330
12/4/2022,13,8361,1246,4182,3110,254,0,17153
12/4/2022,14,8363,1105,4154,3453,205,0,17280
12/4/2022,15,8364,1012,4374,3519,168,0,17437
12/4/2022,16,8365,1211,4797,3497,73,0,17943
12/4/2022,17,8364,1272,5255,3561,11,0,18463
12/4/2022,18,8358,1276,5667,3783,0,0,19084
12/4/2022,19,8355,1268,5173,4051,0,0,18847
12/4/2022,20,8356,1269,4760,4175,0,0,18560
12/4/2022,21,8348,931,4955,4177,0,0,18411
12/4/2022,22,8348,595,4887,4273,0,0,18103
12/4/2022,23,8342,207,4496,4247,0,0,17292
12/4/2022,24,8341,134,4421,4201,0,0,17097
12/5/2022,1,8346,135,4347,4227,0,0,17055
12/5/2022,2,8351,133,4207,4224,0,12,16927
12/5/2022,3,8350,135,4120,4149,0,16,16770
12/5/2022,4,8354,212,4096,4072,0,16,16750
12/5/2022,5,8351,453,4287,3807,0,16,16914
12/5/2022,6,8360,787,4028,3777,0,16,16968
12/5/2022,7,8368,1143,4167,3604,0,17,17299
12/5/2022,8,8361,1324,5030,3625,2,17,18359
12/5/2022,9,8359,1393,4995,3524,52,17,18340
12/5/2022,10,8358,1429,4973,3429,127,17,18333
12/5/2022,11,8354,1522,4729,3451,221,17,18294
12/5/2022,12,8347,1535,4913,3278,170,18,18261
12/5/2022,13,8354,2040,4848,2970,153,18,18383
12/5/2022,14,8357,1884,4755,2667,132,18,17813
12/5/2022,15,8352,2263,5069,2284,87,18,18073
12/5/2022,16,8356,2568,5393,1935,39,18,18309
12/5/2022,17,8355,2642,5711,1725,3,20,18456
12/5/2022,18,8352,2639,5728,1670,0,18,18407
12/5/2022,19,8358,2398,5683,1873,0,18,18330
12/5/2022,20,8356,2254,5375,2106,0,18,18109
12/5/2022,21,8354,2559,5140,2004,0,18,18075
12/5/2022,22,8352,2180,4727,2112,0,18,17389
12/5/2022,23,8355,1541,4202,2006,0,18,16122
12/5/2022,24,8357,1122,4370,1723,0,18,15590
12/6/2022,1,8359,894,4252,1534,0,18,15057
12/6/2022,2,8359,1092,4284,1359,0,18,15112
12/6/2022,3,8360,1440,3956,1119,0,18,14893
12/6/2022,4,8355,1506,4010,944,0,18,14833
12/6/2022,5,8356,1686,3626,810,0,18,14496
12/6/2022,6,8355,1950,3627,654,0,18,14604
12/6/2022,7,8274,2155,4065,761,0,18,15273
12/6/2022,8,8268,2852,4848,684,0,18,16670
12/6/2022,9,8270,3482,5007,515,4,19,17297
12/6/2022,10,8268,3766,5007,430,17,40,17528
12/6/2022,11,8271,3737,4976,360,40,70,17454
12/6/2022,12,8337,3439,4915,337,51,69,17148
12/6/2022,13,8362,3296,4918,487,43,69,17175
12/6/2022,14,8360,3550,5159,170,44,91,17374
12/6/2022,15,8360,3648,5105,229,36,96,17474
12/6/2022,16,8354,3025,5292,247,12,69,16999
12/6/2022,17,8353,3044,5383,291,0,69,17140
12/6/2022,18,8353,3113,5375,330,0,70,17241
12/6/2022,19,8355,2904,5458,479,0,71,17267
12/6/2022,20,8360,3014,5563,495,0,71,17503
12/6/2022,21,8358,3040,5287,382,0,71,17138
12/6/2022,22,8352,3153,4740,325,0,69,16639
12/6/2022,23,8354,2538,4340,281,0,32,15545
12/6/2022,24,8354,1728,4150,251,0,19,14502
12/7/2022,1,8354,1790,3829,277,0,19,14269
12/7/2022,2,8351,1789,3848,323,0,19,14330
12/7/2022,3,8352,1877,4165,254,0,19,14667
12/7/2022,4,8349,2034,4342,138,0,19,14882
12/7/2022,5,8343,2175,4236,138,0,19,14911
12/7/2022,6,8351,2336,6091,256,0,19,17053
12/7/2022,7,8358,2422,6325,325,0,19,17449
12/7/2022,8,8359,2684,7005,427,0,18,18493
12/7/2022,9,8354,3067,7218,399,3,18,19059
12/7/2022,10,8357,3299,7337,283,15,18,19309
12/7/2022,11,8360,3438,7286,151,28,27,19290
12/7/2022,12,8356,3723,7220,114,38,68,19519
12/7/2022,13,8361,3641,7336,100,36,69,19543
12/7/2022,14,8363,3704,6482,141,26,69,18785
12/7/2022,15,8360,3420,6402,196,16,70,18464
12/7/2022,16,8370,3050,6511,179,18,70,18198
12/7/2022,17,8354,3014,6829,223,1,70,18491
12/7/2022,18,8357,3399,6942,292,0,70,19060
12/7/2022,19,8361,2968,6879,404,0,71,18683
12/7/2022,20,8363,2994,6902,409,0,71,18739
12/7/2022,21,8357,3049,7245,513,0,71,19235
12/7/2022,22,8358,2869,7009,350,0,70,18656
12/7/2022,23,8358,2506,6551,345,0,29,17789
12/7/2022,24,8356,1566,6216,525,0,19,16682
12/8/2022,1,8353,1351,6253,599,0,19,16575
12/8/2022,2,8353,1445,6164,633,0,19,16614
12/8/2022,3,8348,1507,6339,558,0,19,16771
12/8/2022,4,8343,1681,6167,556,0,19,16766
12/8/2022,5,8340,1852,5727,732,0,19,16670
12/8/2022,6,8339,2012,6092,614,0,18,17075
12/8/2022,7,8345,2063,6597,628,0,18,17651
12/8/2022,8,8345,2678,6926,545,0,19,18513
12/8/2022,9,8345,3116,7165,539,13,21,19199
12/8/2022,10,8338,3140,7171,434,54,18,19155
12/8/2022,11,8340,3112,7159,370,105,20,19106
12/8/2022,12,8342,3384,7188,310,123,16,19363
12/8/2022,13,8345,3353,7163,295,96,18,19270
12/8/2022,14,8342,3309,7134,301,110,20,19216
12/8/2022,15,8351,3290,7214,372,66,23,19316
12/8/2022,16,8353,3440,7410,417,16,28,19664
12/8/2022,17,8355,3407,7634,445,0,59,19900
12/8/2022,18,8352,3522,7858,512,0,72,20316
12/8/2022,19,8353,3370,7956,585,0,73,20337
12/8/2022,20,8356,3206,7999,709,0,74,20344
12/8/2022,21,8351,3542,7526,741,0,73,20233
12/8/2022,22,8348,3219,7130,757,0,70,19524
12/8/2022,23,8348,2143,6807,737,0,30,18065
12/8/2022,24,8350,1866,6256,762,0,17,17251
12/9/2022,1,8354,1646,3837,756,0,17,14610
12/9/2022,2,8356,1590,3737,705,0,17,14405
12/9/2022,3,8352,1616,3763,706,0,17,14454
12/9/2022,4,8357,1595,3822,638,0,17,14429
12/9/2022,5,8351,1720,3643,643,0,17,14374
12/9/2022,6,8348,1873,3577,643,0,17,14458
12/9/2022,7,8351,2161,4475,728,0,17,15732
12/9/2022,8,8349,2981,4978,820,0,17,17145
12/9/2022,9,8347,3119,4953,928,5,17,17369
12/9/2022,10,8346,2784,4925,1107,57,17,17236
12/9/2022,11,8344,2681,4834,1202,150,23,17234
12/9/2022,12,8346,2978,4557,1165,164,56,17266
12/9/2022,13,8347,2897,4445,1273,158,70,17190
12/9/2022,14,8379,2552,4340,1709,154,70,17204
12/9/2022,15,8455,2234,4188,2097,106,70,17150
12/9/2022,16,8580,2229,4097,2416,45,70,17437
12/9/2022,17,8556,2321,4833,2431,2,70,18213
12/9/2022,18,7789,2695,5484,2726,0,69,18763
12/9/2022,19,7788,2622,5361,2721,0,70,18562
12/9/2022,20,7787,2411,5344,2583,0,69,18194
12/9/2022,21,7787,2651,4884,2589,0,68,17979
12/9/2022,22,7791,2258,4408,2890,0,68,17415
12/9/2022,23,7775,1390,4236,2927,0,31,16359
12/9/2022,24,7733,841,3974,2880,0,17,15445
12/10/2022,1,7737,376,4228,2740,0,17,15098
12/10/2022,2,7730,334,4297,2418,0,17,14796
12/10/2022,3,7729,341,4395,2122,0,17,14604
12/10/2022,4,7732,345,3736,2085,0,17,13915
12/10/2022,5,7747,308,3383,2268,0,17,13723
12/10/2022,6,7895,352,3546,2313,0,17,14123
12/10/2022,7,7938,777,3983,2387,0,17,15102
12/10/2022,8,7946,1236,4125,2611,2,17,15937
12/10/2022,9,7946,1933,4339,2486,65,17,16786
12/10/2022,10,7946,2418,4454,2380,191,17,17406
12/10/2022,11,7950,2471,4323,2169,303,28,17244
12/10/2022,12,7528,3101,4783,1617,331,69,17429
12/10/2022,13,7063,3527,4766,1296,298,80,17030
12/10/2022,14,7067,3269,4776,1456,204,72,16844
12/10/2022,15,7182,3132,4920,1430,115,71,16850
12/10/2022,16,7220,3683,5035,1170,38,73,17219
12/10/2022,17,7213,4190,5220,1185,0,71,17879
12/10/2022,18,7200,4612,5336,1382,0,73,18603
12/10/2022,19,7203,4318,5403,1376,0,71,18371
12/10/2022,20,7206,4567,5146,997,0,73,17989
12/10/2022,21,7208,4599,4772,986,0,73,17638
12/10/2022,22,7212,4069,4686,936,0,31,16934
12/10/2022,23,7213,3496,4590,739,0,19,16057
12/10/2022,24,7214,2942,4555,716,0,19,15446
12/11/2022,1,7213,2268,4519,613,0,19,14632
12/11/2022,2,7210,2064,4348,539,0,19,14180
12/11/2022,3,7213,1945,4182,563,0,19,13922
12/11/2022,4,7210,1581,4242,450,0,19,13502
12/11/2022,5,7213,1835,4295,362,0,19,13724
12/11/2022,6,7215,1970,4487,385,0,19,14076
12/11/2022,7,7219,2361,4444,489,0,19,14532
12/11/2022,8,7226,3017,4542,576,0,19,15380
12/11/2022,9,7234,3352,4866,664,1,19,16136
12/11/2022,10,7238,3602,4949,734,11,19,16553
12/11/2022,11,7240,4132,5004,670,34,19,17099
12/11/2022,12,7243,4425,5091,491,46,19,17315
12/11/2022,13,7248,4201,5028,607,59,19,17162
12/11/2022,14,7249,3585,5196,769,42,19,16860
12/11/2022,15,7250,4168,5202,702,39,19,17380
12/11/2022,16,7263,4298,5375,682,12,37,17667
12/11/2022,17,7261,4671,5782,596,0,69,18379
12/11/2022,18,7261,5036,5629,680,0,74,18680
12/11/2022,19,7263,4684,5526,739,0,72,18284
12/11/2022,20,7261,4519,5607,651,0,72,18110
12/11/2022,21,7262,4525,5378,628,0,63,17856
12/11/2022,22,7255,4147,5151,617,0,18,17188
12/11/2022,23,7257,3227,5054,498,0,18,16054
12/11/2022,24,7307,2784,4827,425,0,18,15361
12/12/2022,1,7391,2446,4555,428,0,18,14838
12/12/2022,2,7392,1968,4517,461,0,18,14356
12/12/2022,3,7392,2017,4331,467,0,17,14224
12/12/2022,4,7390,2154,4351,533,0,18,14446
12/12/2022,5,7390,2663,4385,535,0,17,14990
12/12/2022,6,7385,3287,4485,538,0,23,15718
12/12/2022,7,7390,4420,4669,531,0,56,17066
12/12/2022,8,7393,4887,5295,507,0,70,18152
12/12/2022,9,7395,5514,5401,389,1,72,18772
12/12/2022,10,7388,5753,5209,320,10,70,18750
12/12/2022,11,7388,5573,5223,330,21,70,18605
12/12/2022,12,7407,5584,5079,279,37,70,18456
12/12/2022,13,7420,5605,4952,222,52,71,18322
12/12/2022,14,7414,5292,4966,187,64,70,17993
12/12/2022,15,7416,5356,4974,142,52,72,18012
12/12/2022,16,7414,4789,5155,90,23,69,17540
12/12/2022,17,7416,4668,5673,128,1,72,17958
12/12/2022,18,7419,5770,5875,235,0,71,19370
12/12/2022,19,7422,5537,5818,324,0,70,19171
12/12/2022,20,7423,5693,5641,447,0,70,19274
12/12/2022,21,7418,4971,5566,441,0,70,18466
12/12/2022,22,7418,5352,5085,409,0,69,18333
12/12/2022,23,7415,4889,4597,446,0,32,17379
12/12/2022,24,7409,3770,4556,452,0,17,16204
12/13/2022,1,7430,3006,4368,461,0,17,15282
12/13/2022,2,7439,2960,4257,521,0,17,15194
12/13/2022,3,7435,2897,4162,557,0,17,15068
12/13/2022,4,7431,2885,4232,514,0,17,15079
12/13/2022,5,7432,3161,4321,438,0,17,15369
12/13/2022,6,7431,3947,4531,341,0,17,16267
12/13/2022,7,7435,5214,5031,321,0,17,18018
12/13/2022,8,7437,5742,5245,361,0,17,18802
12/13/2022,9,7431,5750,5258,380,24,17,18860
12/13/2022,10,7432,5289,5033,419,81,17,18271
12/13/2022,11,7435,5130,4989,369,116,17,18056
12/13/2022,12,7441,5163,4726,376,141,15,17862
12/13/2022,13,7447,5068,4662,455,192,12,17836
12/13/2022,14,7446,4573,4686,440,222,12,17379
12/13/2022,15,7455,4658,4713,340,162,13,17341
12/13/2022,16,7451,4516,4886,424,67,25,17369
12/13/2022,17,7445,4437,5453,616,4,59,18014
12/13/2022,18,7455,5239,5638,767,0,74,19173
12/13/2022,19,7461,4974,5549,1137,0,75,19196
12/13/2022,20,7465,4452,5404,1530,0,76,18927
12/13/2022,21,7462,4050,5201,1721,0,78,18512
12/13/2022,22,7461,3898,4810,1805,0,33,18007
12/13/2022,23,7456,3039,4349,2166,0,23,17033
12/13/2022,24,7467,2648,3833,2055,0,23,16026
12/14/2022,1,7467,2290,3586,2039,0,23,15405
12/14/2022,2,7467,2046,3787,1748,0,23,15071
12/14/2022,3,7465,1985,3545,1968,0,23,14986
12/14/2022,4,7468,2049,3409,1816,0,23,14765
12/14/2022,5,7467,2306,3435,1701,0,23,14932
12/14/2022,6,7468,2794,3756,1370,0,23,15411
12/14/2022,7,7469,2889,3795,2554,0,23,16730
12/14/2022,8,7467,2901,4656,3056,0,23,18103
12/14/2022,9,7465,3371,4701,3022,30,23,18612
12/14/2022,10,7466,2914,4566,3116,87,23,18172
12/14/2022,11,7470,2950,4494,2994,152,23,18083
12/14/2022,12,7476,3088,4418,2749,169,22,17922
12/14/2022,13,7481,2891,4477,2693,179,22,17743
12/14/2022,14,7479,2923,4614,2644,171,22,17853
12/14/2022,15,7474,3022,4746,2457,141,27,17867
12/14/2022,16,7579,2967,4850,2593,74,35,18098
12/14/2022,17,7684,3215,4682,2866,10,34,18491
12/14/2022,18,7690,3233,4885,3338,0,32,19178
12/14/2022,19,7669,3091,4945,3483,0,30,19218
12/14/2022,20,7647,2988,4740,3745,0,25,19145
12/14/2022,21,7639,2595,4448,3897,0,23,18602
12/14/2022,22,7645,2041,4172,3918,0,23,17799
12/14/2022,23,7688,1663,3820,4033,0,23,17227
12/14/2022,24,7837,794,3529,4018,0,24,16202
12/15/2022,1,7841,540,3202,3978,0,24,15585
12/15/2022,2,7841,535,3055,3995,0,24,15450
12/15/2022,3,7866,533,3085,4055,0,23,15562
12/15/2022,4,7974,533,2997,4101,0,23,15628
12/15/2022,5,7967,533,3057,4085,0,23,15665
12/15/2022,6,7972,533,3451,3785,0,23,15764
12/15/2022,7,7972,629,3742,3947,0,23,16313
12/15/2022,8,7967,1044,4458,3846,0,21,17336
12/15/2022,9,7968,1164,4563,3776,6,22,17499
12/15/2022,10,7969,1616,4860,3706,19,22,18192
12/15/2022,11,8082,2158,4967,3517,39,22,18785
12/15/2022,12,8131,2626,4925,3220,51,22,18975
12/15/2022,13,8137,3341,4607,2959,66,22,19132
12/15/2022,14,8140,3549,4593,2682,29,23,19016
12/15/2022,15,8139,3568,4572,2793,23,23,19118
12/15/2022,16,8138,3357,5031,2478,10,22,19036
12/15/2022,17,8139,3463,5330,2214,0,22,19168
12/15/2022,18,8157,3537,5612,1973,0,28,19307
12/15/2022,19,8155,3660,5604,1844,0,25,19288
12/15/2022,20,8155,3612,5201,1775,0,21,18764
12/15/2022,21,8157,3295,5027,1720,0,29,18228
12/15/2022,22,8162,3272,4689,1924,0,24,18071
12/15/2022,23,8174,2656,4379,1826,0,21,17056
12/15/2022,24,8186,1809,4409,1543,0,11,15958
12/16/2022,1,8193,1553,4184,1299,0,3,15232
12/16/2022,2,8185,1551,3910,1091,0,0,14737
12/16/2022,3,8185,1551,4113,960,0,0,14809
12/16/2022,4,8177,1703,3585,1096,0,0,14561
12/16/2022,5,8175,2058,3364,1065,0,0,14662
12/16/2022,6,8184,2495,3500,953,0,0,15132
12/16/2022,7,8182,2801,3923,1091,0,0,15997
12/16/2022,8,8182,4076,4524,1034,0,0,17816
12/16/2022,9,8184,4243,4593,974,2,0,17996
12/16/2022,10,8196,4065,4660,1045,12,0,17978
12/16/2022,11,8194,4399,4628,1159,20,0,18400
12/16/2022,12,8201,3906,4588,1115,27,0,17837
12/16/2022,13,8215,3985,4447,1002,21,0,17670
12/16/2022,14,8219,4082,4650,920,21,0,17892
12/16/2022,15,8229,4179,4787,870,13,0,18078
12/16/2022,16,8235,4156,5040,816,6,0,18253
12/16/2022,17,8235,4503,4955,790,0,0,18483
12/16/2022,18,8247,4354,5409,689,0,0,18699
12/16/2022,19,8247,4117,5405,972,0,0,18741
12/16/2022,20,8251,3796,5335,902,0,0,18284
12/16/2022,21,8252,4106,4969,907,0,0,18234
12/16/2022,22,8251,3717,4581,1116,0,0,17665
12/16/2022,23,8253,3269,4320,1268,0,0,17110
12/16/2022,24,8262,2404,3911,1364,0,0,15941
12/17/2022,1,8256,1339,3975,1703,0,0,15273
12/17/2022,2,8258,1139,3764,1605,0,0,14766
12/17/2022,3,8247,812,3727,1451,0,0,14237
12/17/2022,4,8248,860,3681,1414,0,0,14203
12/17/2022,5,8252,846,3676,1455,0,0,14229
12/17/2022,6,8255,995,3690,1531,0,0,14471
12/17/2022,7,8261,1308,3565,1632,0,0,14766
12/17/2022,8,8261,1804,3801,1698,0,0,15564
12/17/2022,9,8262,2098,4106,1752,0,0,16218
12/17/2022,10,8257,2476,4431,1632,9,0,16805
12/17/2022,11,8263,2897,4398,1763,14,0,17335
12/17/2022,12,8261,2775,4204,1966,26,0,17232
12/17/2022,13,8260,2720,4247,1891,31,0,17149
12/17/2022,14,8261,2757,4183,1830,83,0,17114
12/17/2022,15,8257,2756,4176,1923,49,0,17161
12/17/2022,16,8261,2757,4440,1684,18,0,17160
12/17/2022,17,8258,2836,5175,1407,1,0,17677
12/17/2022,18,8255,2993,5420,1465,0,0,18133
12/17/2022,19,8264,2905,5164,1621,0,0,17954
12/17/2022,20,8259,2791,4816,1847,0,0,17713
12/17/2022,21,8259,2778,4444,2003,0,0,17484
12/17/2022,22,8261,2416,4170,2003,0,0,16850
12/17/2022,23,8260,2171,4006,1820,0,0,16257
12/17/2022,24,8258,1563,3800,1973,0,0,15594
12/18/2022,1,8262,803,3339,2115,0,0,14519
12/18/2022,2,8258,570,3191,2070,0,0,14089
12/18/2022,3,8259,314,3506,2178,0,0,14257
12/18/2022,4,8259,132,3621,2331,0,0,14343
12/18/2022,5,8260,131,3477,2464,0,0,14332
12/18/2022,6,8258,220,3387,2673,0,0,14538
12/18/2022,7,8262,382,3399,2743,0,0,14786
12/18/2022,8,8261,529,3810,2801,0,0,15401
12/18/2022,9,8256,532,4124,2939,7,0,15858
12/18/2022,10,8250,544,4489,3016,58,0,16357
12/18/2022,11,8248,644,4624,3033,94,0,16643
12/18/2022,12,8251,651,4410,3129,117,0,16558
12/18/2022,13,8248,910,4185,3176,106,0,16625
12/18/2022,14,8250,941,3798,3343,62,0,16394
12/18/2022,15,8252,967,3984,3342,48,0,16593
12/18/2022,16,8247,948,4339,3339,19,0,16892
12/18/2022,17,8252,1005,4908,3408,2,0,17575
12/18/2022,18,8252,1111,5377,3520,0,0,18260
12/18/2022,19,8258,1120,5118,3482,0,0,17978
12/18/2022,20,8253,1122,4280,3384,0,0,17039
12/18/2022,21,8247,986,3743,3326,0,0,16302
12/18/2022,22,8242,523,3843,3686,0,0,16294
12/18/2022,23,8258,367,3763,3635,0,3,16026
12/18/2022,24,8261,194,3430,3532,0,6,15423
12/19/2022,1,8265,189,3492,3252,0,5,15203
12/19/2022,2,8263,189,3641,2823,0,5,14921
12/19/2022,3,8265,236,3800,2593,0,25,14919
12/19/2022,4,8266,364,3563,2470,0,28,14691
12/19/2022,5,8259,655,3193,2481,0,34,14622
12/19/2022,6,8260,1334,3511,2536,0,38,15679
12/19/2022,7,8268,2085,4517,2447,0,38,17355
12/19/2022,8,8269,3152,5219,2302,0,34,18976
12/19/2022,9,8271,3896,4879,2125,4,36,19211
12/19/2022,10,8267,4109,5001,2213,16,25,19631
12/19/2022,11,8266,3853,5012,2239,62,27,19459
12/19/2022,12,8267,3582,5053,2203,95,33,19233
12/19/2022,13,8269,4611,4751,2071,128,30,19860
12/19/2022,14,8267,4893,4768,1924,92,32,19976
12/19/2022,15,8269,5273,5174,1680,57,29,20482
12/19/2022,16,7938,5396,5532,1388,18,24,20296
12/19/2022,17,7753,5676,5670,1098,0,56,20253
12/19/2022,18,7757,5899,6011,814,0,83,20564
12/19/2022,19,7760,6283,6027,610,0,93,20773
12/19/2022,20,7759,6524,5845,498,0,89,20715
12/19/2022,21,7760,6495,5721,525,0,75,20576
12/19/2022,22,7754,6425,5112,586,0,71,19948
12/19/2022,23,7753,5753,4864,556,0,30,18956
12/19/2022,24,7749,5188,4754,447,0,18,18156
12/20/2022,1,7745,4457,4518,345,0,18,17083
12/20/2022,2,7750,3974,4329,285,0,18,16356
12/20/2022,3,7751,4003,4140,232,0,18,16144
12/20/2022,4,7751,4055,3978,243,0,18,16045
12/20/2022,5,7754,4346,3982,321,0,18,16421
12/20/2022,6,7755,4746,4366,306,0,18,17191
12/20/2022,7,7759,5227,5052,329,0,26,18393
12/20/2022,8,7760,5777,5424,481,0,60,19502
12/20/2022,9,7760,5949,5382,657,12,76,19836
12/20/2022,10,7758,5875,5117,756,51,78,19635
12/20/2022,11,7757,6076,5079,885,88,78,19963
12/20/2022,12,7760,5587,5067,1100,94,74,19682
12/20/2022,13,7761,5725,4786,1159,94,71,19596
12/20/2022,14,7759,5458,4743,1219,93,72,19344
12/20/2022,15,7763,5230,5078,1249,81,73,19474
12/20/2022,16,7761,5169,5299,1154,32,74,19489
12/20/2022,17,7764,5649,5628,1221,2,76,20340
12/20/2022,18,7764,6033,5826,1341,0,77,21041
12/20/2022,19,7768,5681,5908,1375,0,79,20811
12/20/2022,20,7765,5783,5865,1323,0,77,20813
12/20/2022,21,7759,5919,5341,1573,0,76,20668
12/20/2022,22,7758,5480,5022,1689,0,35,19984
12/20/2022,23,7759,4540,4836,1906,0,18,19059
12/20/2022,24,7759,4003,4769,1912,0,18,18461
12/21/2022,1,7756,3557,4696,1772,0,18,17799
12/21/2022,2,7756,3892,4282,1488,0,18,17436
12/21/2022,3,7759,3497,4264,1431,0,18,16969
12/21/2022,4,7755,3403,4172,1537,0,18,16885
12/21/2022,5,7756,3395,4169,1657,0,18,16995
12/21/2022,6,7755,3969,4427,1647,0,29,17827
12/21/2022,7,7756,4956,4978,1660,0,60,19410
12/21/2022,8,7755,5260,5613,1553,0,72,20253
12/21/2022,9,7754,5760,5535,1298,29,74,20450
12/21/2022,10,7755,5486,5408,946,114,74,19783
12/21/2022,11,7754,5545,5003,710,243,76,19331
12/21/2022,12,7759,5346,4987,437,304,76,18909
12/21/2022,13,7758,5261,4932,276,308,78,18613
12/21/2022,14,7757,5417,5059,211,254,78,18776
12/21/2022,15,7758,5681,5220,163,155,76,19053
12/21/2022,16,7759,5856,5637,109,61,68,19490
12/21/2022,17,7756,6077,5730,88,4,69,19724
12/21/2022,18,7755,6652,5942,97,0,69,20515
12/21/2022,19,7762,6435,5940,174,0,72,20383
12/21/2022,20,7756,6136,5800,310,0,79,20081
12/21/2022,21,7757,6104,5591,446,0,105,20003
12/21/2022,22,7757,5992,5098,717,0,34,19598
12/21/2022,23,7756,5143,4547,1171,0,18,18635
12/21/2022,24,7750,4217,4269,1737,0,18,17991
12/22/2022,1,7752,3575,4191,2398,0,18,17934
12/22/2022,2,7843,2922,4184,2594,0,18,17561
12/22/2022,3,7981,2330,3749,2761,0,18,16839
12/22/2022,4,7985,2382,4230,2245,0,18,16860
12/22/2022,5,7985,2527,4095,2215,0,18,16840
12/22/2022,6,7989,2653,4166,2381,0,18,17207
12/22/2022,7,7990,2918,4932,2663,0,18,18521
12/22/2022,8,7989,3576,5274,2822,0,18,19679
12/22/2022,9,7986,4108,5224,2799,19,18,20154
12/22/2022,10,7981,4426,5160,2572,45,18,20202
12/22/2022,11,8055,4394,5121,2567,113,18,20268
12/22/2022,12,8204,3905,5162,2594,123,18,20006
12/22/2022,13,8396,3724,5114,2610,106,18,19968
12/22/2022,14,8416,4109,5101,2545,70,18,20259
12/22/2022,15,8414,4336,5144,2617,35,18,20564
12/22/2022,16,8416,4310,5329,2643,14,18,20730
12/22/2022,17,8411,3837,5807,2946,1,18,21020
12/22/2022,18,8408,3711,5842,3331,0,18,21310
12/22/2022,19,8403,3274,5682,3417,0,18,20794
12/22/2022,20,8399,3189,5565,3419,0,18,20590
12/22/2022,21,8394,3210,5189,3397,0,19,20209
12/22/2022,22,8403,2975,5066,3148,0,18,19610
12/22/2022,23,8403,2694,4774,2881,0,18,18770
12/22/2022,24,8399,1664,4493,2681,0,12,17249
12/23/2022,1,8389,1319,4373,2399,0,2,16482
12/23/2022,2,8393,1366,4332,2265,0,0,16356
12/23/2022,3,8395,1421,4342,2229,0,0,16387
12/23/2022,4,8391,1614,3966,2257,0,0,16228
12/23/2022,5,8396,1986,3538,2207,0,0,16127
12/23/2022,6,8396,2372,3454,2098,0,0,16320
12/23/2022,7,8399,2709,4162,2067,0,0,17337
12/23/2022,8,8400,2922,4564,2456,0,0,18342
12/23/2022,9,8399,3014,4679,2906,2,0,19000
12/23/2022,10,8400,3211,4952,3329,11,0,19903
12/23/2022,11,8415,3515,5170,3884,19,0,21003
12/23/2022,12,8534,3831,5184,3854,29,0,21432
12/23/2022,13,8577,3674,5325,3663,30,0,21269
12/23/2022,14,8583,3768,5289,3477,26,0,21143
12/23/2022,15,8587,3417,5398,3438,17,0,20857
12/23/2022,16,8585,3458,5645,3445,7,0,21140
12/23/2022,17,8579,3965,6034,3536,1,0,22115
12/23/2022,18,8576,4925,6304,3507,0,0,23312
12/23/2022,19,8580,4294,6212,3465,0,0,22551
12/23/2022,20,8584,4147,5912,3455,0,0,22098
12/23/2022,21,8583,4419,5690,3375,0,0,22067
12/23/2022,22,8583,4270,4909,3383,0,0,21145
12/23/2022,23,8575,3808,4441,3374,0,0,20198
12/23/2022,24,8579,3309,4208,3410,0,0,19506
12/24/2022,1,8581,2629,3992,2905,0,0,18107
12/24/2022,2,8589,1350,4083,3375,0,0,17397
12/24/2022,3,8586,890,4187,3154,0,0,16817
12/24/2022,4,8590,811,3855,3140,0,0,16396
12/24/2022,5,8596,856,4188,3374,0,0,17014
12/24/2022,6,8623,951,4125,3173,0,0,16872
12/24/2022,7,8629,1163,4212,2711,0,0,16715
12/24/2022,8,8632,1267,4386,3592,0,0,17877
12/24/2022,9,8631,2158,5085,3653,4,0,19531
12/24/2022,10,8629,2486,5211,3548,20,0,19894
12/24/2022,11,8621,2899,5611,3537,32,0,20700
12/24/2022,12,8621,2794,5761,3413,40,0,20629
12/24/2022,13,8623,2668,5639,3353,44,1,20328
12/24/2022,14,8625,2796,5654,3239,42,0,20356
12/24/2022,15,8626,2955,5437,3540,24,1,20583
12/24/2022,16,8627,3221,5762,3536,8,0,21154
12/24/2022,17,8626,3572,5994,3583,0,0,21775
12/24/2022,18,8627,3908,6218,3606,0,14,22373
12/24/2022,19,8630,3842,6122,3692,0,40,22326
12/24/2022,20,8630,3300,5745,3777,0,63,21515
12/24/2022,21,8632,3519,5508,3781,0,66,21506
12/24/2022,22,8630,3012,5224,3871,0,60,20797
12/24/2022,23,8627,2739,4582,3933,0,55,19936
12/24/2022,24,8624,2551,4412,3936,0,0,19523
12/25/2022,1,8621,1715,4101,4089,0,0,18526
12/25/2022,2,8629,1427,3977,3532,0,0,17565
12/25/2022,3,8635,736,3998,3949,0,0,17318
12/25/2022,4,8636,532,3932,3282,0,0,16382
12/25/2022,5,8654,660,3700,3399,0,0,16413
12/25/2022,6,8673,936,3595,3240,0,0,16444
12/25/2022,7,8700,1422,3759,2873,0,0,16754
12/25/2022,8,8715,1934,3799,3159,0,0,17607
12/25/2022,9,8737,1988,4242,3623,14,0,18604
12/25/2022,10,8743,2047,4538,3976,53,0,19357
12/25/2022,11,8804,2022,4607,3963,100,0,19496
12/25/2022,12,8864,2408,4699,3931,136,0,20038
12/25/2022,13,8879,2139,4850,3901,158,0,19927
12/25/2022,14,8839,1996,4857,3827,126,0,19645
12/25/2022,15,8846,1979,4579,3803,66,0,19273
12/25/2022,16,8861,2272,5156,3745,23,0,20057
12/25/2022,17,8865,2790,5601,3686,2,0,20944
12/25/2022,18,8934,3204,5694,3677,0,0,21509
12/25/2022,19,9050,2660,5690,3764,0,0,21164
12/25/2022,20,9053,2639,5328,3812,0,0,20832
12/25/2022,21,9050,2246,5041,3779,0,0,20116
12/25/2022,22,9053,2164,4819,3658,0,0,19694
12/25/2022,23,9052,1936,4509,3440,0,0,18937
12/25/2022,24,9048,1394,4387,3266,0,0,18095
12/26/2022,1,9052,1720,4453,3070,0,0,18295
12/26/2022,2,9053,2060,4393,2629,0,0,18135
12/26/2022,3,9057,2098,4201,2246,0,1,17603
12/26/2022,4,9056,2753,4085,2103,0,3,18000
12/26/2022,5,9055,3095,3851,2046,0,0,18047
12/26/2022,6,9052,3606,3857,1728,0,0,18243
12/26/2022,7,9057,4180,4059,1611,0,0,18907
12/26/2022,8,9061,4474,4221,1487,0,0,19243
12/26/2022,9,9058,4802,4412,1415,9,0,19696
12/26/2022,10,9052,5024,4387,1373,26,0,19862
12/26/2022,11,9110,5146,4441,1507,41,0,20245
12/26/2022,12,9120,4725,4571,1534,52,0,20002
12/26/2022,13,9115,4731,4507,1462,105,0,19920
12/26/2022,14,9120,4735,4522,1515,97,0,19989
12/26/2022,15,9128,4637,4726,1643,52,0,20186
12/26/2022,16,9120,4823,5089,1471,25,9,20537
12/26/2022,17,9111,4985,5546,1328,3,38,21011
12/26/2022,18,9122,5053,5790,1282,0,54,21301
12/26/2022,19,9129,5223,5807,1282,0,54,21495
12/26/2022,20,9130,5233,5489,1244,0,53,21149
12/26/2022,21,9130,5483,5237,1253,0,54,21157
12/26/2022,22,9120,5377,4974,1395,0,10,20876
12/26/2022,23,9122,4970,4589,1437,0,0,20118
12/26/2022,24,9128,4018,4593,1456,0,0,19195
12/27/2022,1,9126,3887,4184,1469,0,0,18666
12/27/2022,2,9129,3340,4109,1609,0,9,18196
12/27/2022,3,9132,3282,4131,1542,0,18,18105
12/27/2022,4,9129,3256,4070,1523,0,18,17996
12/27/2022,5,9133,3387,4048,1559,0,18,18145
12/27/2022,6,9127,3697,4063,1431,0,18,18336
12/27/2022,7,9133,4122,4453,1425,0,18,19151
12/27/2022,8,9129,4148,4686,1462,0,18,19443
12/27/2022,9,9132,4272,4865,1426,6,18,19719
12/27/2022,10,9134,4706,4890,1281,23,18,20052
12/27/2022,11,9146,5112,4916,1126,78,18,20396
12/27/2022,12,9145,4882,4882,1145,139,18,20211
12/27/2022,13,9141,4166,4785,1221,134,18,19465
12/27/2022,14,9136,3660,4717,1431,83,18,19045
12/27/2022,15,9089,3566,4888,1932,68,18,19561
12/27/2022,16,9132,3523,5231,2351,29,26,20292
12/27/2022,17,9135,3450,5521,2492,3,58,20659
12/27/2022,18,9132,3757,5841,2902,0,69,21701
12/27/2022,19,9136,3967,5831,3061,0,69,22064
12/27/2022,20,9134,3601,5315,3279,0,70,21399
12/27/2022,21,9132,3753,4857,3404,0,69,21215
12/27/2022,22,9132,3880,4405,3639,0,26,21082
12/27/2022,23,9128,2690,3835,3837,0,18,19508
12/27/2022,24,9131,1583,3583,3772,0,18,18087
12/28/2022,1,9134,656,3324,3783,0,18,16915
12/28/2022,2,9134,234,3231,3572,0,18,16189
12/28/2022,3,9136,142,3305,3815,0,18,16416
12/28/2022,4,9177,210,3147,3701,0,18,16253
12/28/2022,5,9362,442,3142,3520,0,18,16484
12/28/2022,6,9361,802,3073,3333,0,18,16587
12/28/2022,7,9366,1296,3278,3242,0,20,17202
12/28/2022,8,9365,1620,3896,3561,0,18,18460
12/28/2022,9,9371,1766,4290,3775,9,18,19229
12/28/2022,10,9357,1785,4091,3783,61,18,19095
12/28/2022,11,9324,1863,4458,3768,131,18,19562
12/28/2022,12,9289,2053,4648,3696,101,18,19805
12/28/2022,13,9447,1753,4737,3659,101,18,19715
12/28/2022,14,9717,1704,3978,3512,58,18,18987
12/28/2022,15,9769,2070,3945,3304,76,18,19182
12/28/2022,16,9775,2276,4125,2951,61,18,19206
12/28/2022,17,9808,2073,4754,3232,9,18,19894
12/28/2022,18,9805,1832,5520,3797,0,18,20972
12/28/2022,19,9810,1770,5139,3876,0,18,20613
12/28/2022,20,9811,1767,4790,3955,0,18,20341
12/28/2022,21,9813,1439,4647,4063,0,18,19980
12/28/2022,22,9815,1072,4190,4128,0,18,19223
12/28/2022,23,9811,399,4003,4088,0,18,18319
12/28/2022,24,9813,128,3705,3969,0,18,17633
12/29/2022,1,9813,128,3367,4045,0,18,17371
12/29/2022,2,9810,128,3115,4004,0,18,17075
12/29/2022,3,9814,128,3186,3809,0,18,16955
12/29/2022,4,9924,128,3153,3520,0,19,16744
12/29/2022,5,9969,228,3155,3572,0,19,16943
12/29/2022,6,9970,392,3134,3808,0,19,17323
12/29/2022,7,9972,540,3389,3854,0,19,17774
12/29/2022,8,9973,541,3796,4119,0,19,18448
12/29/2022,9,9970,555,4126,4126,33,18,18828
12/29/2022,10,9957,568,3849,3783,130,18,18305
12/29/2022,11,9944,587,3973,3718,205,18,18445
12/29/2022,12,9961,628,4077,3368,168,18,18220
12/29/2022,13,9973,386,4263,4083,126,18,18849
12/29/2022,14,9978,778,4195,4128,56,19,19154
12/29/2022,15,9982,1009,4128,4085,34,19,19257
12/29/2022,16,9976,1190,4273,4073,14,19,19545
12/29/2022,17,9970,1219,4599,4005,0,18,19811
12/29/2022,18,9969,1213,5180,4025,0,16,20403
12/29/2022,19,9975,1200,4713,4056,0,18,19962
12/29/2022,20,9978,754,4828,4096,0,18,19674
12/29/2022,21,9979,582,4631,4083,0,18,19293
12/29/2022,22,10010,272,4145,4022,0,18,18467
12/29/2022,23,10012,129,3780,4004,0,18,17943
12/29/2022,24,10018,129,3329,3879,0,19,17374
12/30/2022,1,10030,129,3197,3635,0,19,17010
12/30/2022,2,10029,129,3118,3420,0,19,16715
12/30/2022,3,10022,129,3133,2971,0,19,16274
12/30/2022,4,10025,129,3169,2715,0,19,16057
12/30/2022,5,10029,129,3118,2881,0,19,16176
12/30/2022,6,10017,128,3162,3087,0,19,16413
12/30/2022,7,10026,128,3235,3603,0,19,17011
12/30/2022,8,10023,129,3629,3717,0,19,17517
12/30/2022,9,10017,132,3845,3738,2,19,17753
12/30/2022,10,10014,131,3829,4023,17,19,18033
12/30/2022,11,10013,178,3871,4147,30,19,18258
12/30/2022,12,10021,247,4303,4188,31,19,18809
12/30/2022,13,10024,343,4410,4107,39,19,18942
12/30/2022,14,10009,575,4355,4033,28,19,19019
12/30/2022,15,10010,934,4159,3872,24,19,19018
12/30/2022,16,10025,1218,4480,3390,9,19,19141
12/30/2022,17,10024,1381,4307,3328,0,19,19059
12/30/2022,18,10020,1386,4715,3368,0,19,19508
12/30/2022,19,10023,1359,5024,2861,0,19,19286
12/30/2022,20,10020,1349,5437,2252,0,19,19077
12/30/2022,21,10020,1267,5261,2020,0,19,18587
12/30/2022,22,10013,987,5062,1616,0,19,17697
12/30/2022,23,10013,807,4999,1180,0,19,17018
12/30/2022,24,10012,328,4862,778,0,19,15999
12/31/2022,1,10004,137,4337,312,0,19,14809
12/31/2022,2,10000,133,4220,177,0,19,14549
12/31/2022,3,9991,173,4236,180,0,19,14599
12/31/2022,4,9993,173,3844,379,0,19,14408
12/31/2022,5,9995,131,3787,624,0,19,14556
12/31/2022,6,10000,127,3420,897,0,19,14463
12/31/2022,7,10003,261,3690,991,0,19,14964
12/31/2022,8,10009,422,4284,871,0,19,15605
12/31/2022,9,10008,865,5038,757,0,19,16687
12/31/2022,10,10007,1166,4975,750,8,19,16925
12/31/2022,11,10003,1219,5202,696,17,19,17156
12/31/2022,12,9992,1333,5408,621,24,19,17397
12/31/2022,13,9989,1539,5207,779,28,19,17561
12/31/2022,14,9992,1242,5300,946,22,19,17521
12/31/2022,15,9992,1493,5256,855,18,19,17633
12/31/2022,16,9994,1471,5594,804,9,19,17891
12/31/2022,17,9994,1592,5841,703,1,19,18150
12/31/2022,18,9990,1634,5884,734,0,19,18261
12/31/2022,19,9990,1449,5669,708,0,19,17835
12/31/2022,20,9990,1442,5615,695,0,19,17761
12/31/2022,21,9990,1664,5568,560,0,19,17801
12/31/2022,22,9994,1682,4926,561,0,19,17182
12/31/2022,23,9993,902,4666,594,0,19,16174
12/31/2022,24,9993,262,4576,560,0,19,15410
