Date,Hour,NUCLEAR,GAS,HYDRO,WIND,SOLAR,BIOFUEL,Total Output
1/1/2023,1,9977,130,4185,533,0,19,14844
1/1/2023,2,9993,130,3928,688,0,19,14758
1/1/2023,3,9996,129,3725,693,0,19,14562
1/1/2023,4,9999,129,3860,685,0,19,14692
1/1/2023,5,10002,152,3826,658,0,19,14657
1/1/2023,6,10000,238,3680,710,0,19,14647
1/1/2023,7,10007,573,3964,592,0,19,15155
1/1/2023,8,10002,975,3670,508,0,24,15179
1/1/2023,9,10003,1252,3979,499,7,27,15767
1/1/2023,10,10006,1412,4008,728,29,27,16210
1/1/2023,11,10004,1715,4263,739,35,28,16784
1/1/2023,12,10004,1906,4675,859,51,28,17523
1/1/2023,13,10005,1977,4733,622,46,27,17410
1/1/2023,14,10005,1804,4845,624,50,26,17354
1/1/2023,15,9999,1246,4893,649,29,27,16843
1/1/2023,16,10002,1280,5008,527,13,27,16857
1/1/2023,17,9998,1657,5193,633,0,27,17508
1/1/2023,18,10004,2000,5297,790,0,27,18118
1/1/2023,19,10004,1993,5048,1034,0,31,18110
1/1/2023,20,10002,1486,4775,1166,0,30,17459
1/1/2023,21,9999,1220,4737,1260,0,31,17247
1/1/2023,22,10002,1166,4258,1254,0,31,16711
1/1/2023,23,10007,837,4178,1359,0,31,16412
1/1/2023,24,9999,372,3860,1361,0,20,15612
1/2/2023,1,10009,131,3804,1451,0,19,15414
1/2/2023,2,10016,131,3419,1536,0,19,15121
1/2/2023,3,10031,130,3676,1226,0,19,15082
1/2/2023,4,10027,309,3862,1075,0,19,15292
1/2/2023,5,10025,839,3340,854,0,19,15077
1/2/2023,6,10014,1484,3243,606,0,19,15366
1/2/2023,7,10017,1856,3417,501,0,24,15815
1/2/2023,8,10016,2101,3730,297,0,30,16174
1/2/2023,9,10013,2158,3995,342,6,30,16544
1/2/2023,10,10010,2162,4778,327,32,30,17339
1/2/2023,11,10011,2162,5076,269,68,30,17616
1/2/2023,12,10013,2151,5042,198,111,30,17545
1/2/2023,13,10009,2208,4444,184,214,30,17089
1/2/2023,14,10011,2253,4904,184,134,30,17516
1/2/2023,15,10017,2197,5514,159,113,30,18030
1/2/2023,16,10025,2246,5497,154,50,30,18002
1/2/2023,17,10025,2595,5896,164,10,30,18720
1/2/2023,18,10026,2887,6007,224,0,31,19175
1/2/2023,19,10025,2867,6025,335,0,31,19283
1/2/2023,20,10028,2721,5990,335,0,31,19105
1/2/2023,21,10026,1854,5697,528,0,31,18136
1/2/2023,22,10024,1240,5188,729,0,31,17212
1/2/2023,23,10025,754,4842,917,0,30,16568
1/2/2023,24,10029,568,4470,900,0,21,15988
1/3/2023,1,10027,655,4483,881,0,19,16065
1/3/2023,2,10026,696,4318,1061,0,19,16120
1/3/2023,3,10026,564,3944,1305,0,19,15858
1/3/2023,4,10032,547,3889,1104,0,19,15591
1/3/2023,5,10028,754,3975,1125,0,19,15901
1/3/2023,6,10025,1323,3527,1191,0,19,16085
1/3/2023,7,10030,1935,3867,1338,0,24,17194
1/3/2023,8,10028,2126,4023,1243,0,30,17450
1/3/2023,9,10024,2133,4393,1574,6,31,18161
1/3/2023,10,10026,2155,4514,1685,13,31,18424
1/3/2023,11,10031,2390,5206,1604,20,31,19282
1/3/2023,12,10020,2553,5167,1666,27,31,19464
1/3/2023,13,10022,2578,4886,1755,36,31,19308
1/3/2023,14,10022,2589,5235,1513,32,31,19422
1/3/2023,15,10022,2886,5401,1361,26,31,19727
1/3/2023,16,10021,2875,5198,1268,12,31,19405
1/3/2023,17,10031,2833,5259,1224,0,31,19378
1/3/2023,18,10027,2803,5985,1384,0,31,20230
1/3/2023,19,10032,2324,6022,1372,0,30,19780
1/3/2023,20,10034,2195,5538,1261,0,30,19058
1/3/2023,21,10030,1901,5233,1139,0,30,18333
1/3/2023,22,10028,1450,5184,1108,0,28,17798
1/3/2023,23,10034,488,5067,1154,0,30,16773
1/3/2023,24,10028,258,5129,916,0,20,16351
1/4/2023,1,10029,462,4690,873,0,19,16073
1/4/2023,2,10029,584,4055,1120,0,19,15807
1/4/2023,3,10029,554,4069,1180,0,19,15851
1/4/2023,4,10032,566,4141,1279,0,19,16037
1/4/2023,5,10030,679,4203,1319,0,19,16250
1/4/2023,6,10036,1008,4014,1204,0,19,16281
1/4/2023,7,10033,1254,4072,1370,0,19,16748
1/4/2023,8,10039,1654,3943,1515,0,23,17174
1/4/2023,9,10009,1861,4008,1556,6,30,17470
1/4/2023,10,9971,1935,4728,1546,17,30,18227
1/4/2023,11,9926,2418,4912,1607,29,30,18922
1/4/2023,12,9818,2607,4934,1593,27,30,19009
1/4/2023,13,9895,2580,5154,1533,38,30,19230
1/4/2023,14,10015,2444,5227,1538,57,30,19311
1/4/2023,15,10019,2403,5359,1737,48,30,19596
1/4/2023,16,10017,2165,5273,1670,27,30,19182
1/4/2023,17,10015,2079,5656,1895,4,30,19679
1/4/2023,18,10018,2323,5810,1855,0,30,20036
1/4/2023,19,10026,2110,5716,2013,0,30,19895
1/4/2023,20,10029,1951,5746,2320,0,30,20076
1/4/2023,21,10030,1972,5508,2536,0,30,20076
1/4/2023,22,10033,1339,5333,2562,0,30,19297
1/4/2023,23,10030,945,5081,2455,0,30,18541
1/4/2023,24,10029,368,4509,2540,0,22,17468
1/5/2023,1,10032,133,4065,2601,0,19,16850
1/5/2023,2,10032,132,3857,2765,0,19,16805
1/5/2023,3,10036,132,3715,2826,0,19,16728
1/5/2023,4,10037,243,3825,2599,0,19,16723
1/5/2023,5,10035,452,4030,2246,0,19,16782
1/5/2023,6,10034,806,3793,1818,0,19,16470
1/5/2023,7,10041,1066,4168,1610,0,19,16904
1/5/2023,8,10038,1459,5111,1529,0,24,18161
1/5/2023,9,10037,1753,5471,1547,11,30,18849
1/5/2023,10,10034,1923,5231,1569,28,30,18815
1/5/2023,11,9519,2453,5802,1515,53,30,19372
1/5/2023,12,8978,3520,5601,1415,63,30,19607
1/5/2023,13,8974,3760,5326,1235,88,30,19413
1/5/2023,14,8977,3869,5411,1096,73,30,19456
1/5/2023,15,8977,3328,5484,925,57,30,18801
1/5/2023,16,8976,3471,5864,694,23,30,19058
1/5/2023,17,8973,3963,5907,751,4,30,19628
1/5/2023,18,8980,4121,5931,658,0,30,19720
1/5/2023,19,8982,3963,5942,836,0,29,19752
1/5/2023,20,8982,3555,5886,937,0,26,19386
1/5/2023,21,8981,3497,5781,857,0,31,19147
1/5/2023,22,8983,2516,5495,806,0,33,17833
1/5/2023,23,8984,2410,4960,705,0,32,17091
1/5/2023,24,8981,1939,4768,694,0,24,16406
1/6/2023,1,8980,1848,4415,678,0,20,15941
1/6/2023,2,8985,1842,3980,729,0,20,15556
1/6/2023,3,8987,2272,3919,754,0,20,15952
1/6/2023,4,8981,2636,3890,720,0,20,16247
1/6/2023,5,8978,2388,3538,734,0,20,15658
1/6/2023,6,8983,2552,3618,734,0,20,15907
1/6/2023,7,8988,3048,4606,757,0,22,17421
1/6/2023,8,8984,3643,4874,926,0,46,18473
1/6/2023,9,8981,4143,4892,968,8,64,19056
1/6/2023,10,8984,4512,4959,912,33,55,19455
1/6/2023,11,9024,4236,4929,834,96,63,19182
1/6/2023,12,9060,4391,4929,741,92,67,19280
1/6/2023,13,9067,4336,4967,629,84,67,19150
1/6/2023,14,9068,4128,4950,846,67,65,19124
1/6/2023,15,9069,3863,5037,941,57,67,19034
1/6/2023,16,9066,4014,5562,875,28,66,19611
1/6/2023,17,9068,4236,5858,861,4,64,20091
1/6/2023,18,9069,4394,5829,941,0,63,20296
1/6/2023,19,9072,4148,5846,866,0,61,19993
1/6/2023,20,9070,3607,5718,803,0,63,19261
1/6/2023,21,9068,3465,5489,778,0,58,18858
1/6/2023,22,9053,3234,4947,836,0,42,18112
1/6/2023,23,9070,2663,4827,649,0,50,17259
1/6/2023,24,9066,2199,4616,731,0,46,16658
1/7/2023,1,9073,1364,4260,720,0,46,15463
1/7/2023,2,9072,1002,4216,713,0,42,15045
1/7/2023,3,9071,776,4321,694,0,40,14902
1/7/2023,4,9074,758,4143,604,0,39,14618
1/7/2023,5,9072,1034,4197,588,0,40,14931
1/7/2023,6,9067,1205,3991,569,0,38,14870
1/7/2023,7,9068,1669,4040,616,0,45,15438
1/7/2023,8,9067,2124,4145,559,0,48,15943
1/7/2023,9,9067,2170,4579,677,4,45,16542
1/7/2023,10,9060,2465,4743,716,21,36,17041
1/7/2023,11,9063,2814,4731,727,45,38,17418
1/7/2023,12,9058,2897,4635,873,119,44,17626
1/7/2023,13,9061,2806,4687,948,162,44,17708
1/7/2023,14,9057,2617,4799,1007,162,39,17681
1/7/2023,15,9068,2443,5022,790,120,33,17476
1/7/2023,16,9103,2524,5328,565,58,30,17608
1/7/2023,17,9226,2863,5805,456,7,32,18389
1/7/2023,18,9242,3303,5703,433,0,30,18711
1/7/2023,19,9242,3289,5690,448,0,32,18701
1/7/2023,20,9253,3094,5617,491,0,32,18487
1/7/2023,21,9243,3052,5483,338,0,32,18148
1/7/2023,22,9243,2928,5270,261,0,31,17733
1/7/2023,23,9243,2767,4860,215,0,31,17116
1/7/2023,24,9243,2168,4564,169,0,23,16167
1/8/2023,1,9241,1831,4463,180,0,21,15736
1/8/2023,2,9241,1710,4368,116,0,21,15456
1/8/2023,3,9236,1842,4272,124,0,21,15495
1/8/2023,4,9232,2064,4230,128,0,21,15675
1/8/2023,5,9239,1861,4152,147,0,21,15420
1/8/2023,6,9238,1983,3816,160,0,21,15218
1/8/2023,7,9246,2121,4380,143,0,26,15916
1/8/2023,8,9245,2197,4507,173,0,30,16152
1/8/2023,9,9247,2339,4884,235,28,30,16763
1/8/2023,10,9245,2517,5094,257,88,30,17231
1/8/2023,11,9241,2878,5375,213,71,30,17808
1/8/2023,12,9243,3543,5370,225,80,30,18491
1/8/2023,13,9244,3119,5255,272,91,36,18017
1/8/2023,14,9244,2754,5103,323,71,53,17548
1/8/2023,15,9168,2620,5204,282,29,60,17363
1/8/2023,16,9257,2765,5571,212,12,50,17867
1/8/2023,17,9270,3335,5883,175,3,47,18713
1/8/2023,18,9270,3921,5843,180,0,53,19267
1/8/2023,19,9273,3747,5875,214,0,46,19155
1/8/2023,20,9277,3565,5843,270,0,34,18989
1/8/2023,21,9267,3291,5511,297,0,34,18400
1/8/2023,22,9270,3032,5084,301,0,34,17721
1/8/2023,23,9280,2166,4801,509,0,34,16790
1/8/2023,24,9299,1071,4597,696,0,25,15688
1/9/2023,1,9364,579,3763,857,0,22,14585
1/9/2023,2,9426,550,3627,1055,0,22,14680
1/9/2023,3,9451,647,3706,1139,0,22,14965
1/9/2023,4,9476,632,3932,1175,0,22,15237
1/9/2023,5,9558,1090,3586,1326,0,22,15582
1/9/2023,6,9630,1739,3404,1549,0,22,16344
1/9/2023,7,9669,2221,3993,1852,0,28,17763
1/9/2023,8,9689,2519,5272,2087,0,33,19600
1/9/2023,9,9748,2507,5301,2274,10,33,19873
1/9/2023,10,9769,2395,5007,2658,29,33,19891
1/9/2023,11,9783,2368,4599,2616,114,32,19512
1/9/2023,12,9791,2366,4026,2799,147,31,19160
1/9/2023,13,9791,2196,3889,2648,151,31,18706
1/9/2023,14,9788,2186,3923,3083,110,32,19122
1/9/2023,15,9789,1842,4230,2446,70,32,18409
1/9/2023,16,9808,1963,4426,2923,35,32,19187
1/9/2023,17,9918,2513,5048,2696,8,45,20228
1/9/2023,18,10065,2787,5868,2353,0,72,21145
1/9/2023,19,10148,2759,5710,2358,0,82,21057
1/9/2023,20,10151,2750,5141,2081,0,82,20205
1/9/2023,21,10154,1995,5330,1724,0,82,19285
1/9/2023,22,10152,1585,5018,1495,0,82,18332
1/9/2023,23,9900,1263,4813,1288,0,44,17308
1/9/2023,24,9886,771,4488,1033,0,25,16203
1/10/2023,1,9886,536,4537,799,0,21,15779
1/10/2023,2,9885,617,4004,640,0,21,15167
1/10/2023,3,9886,935,4010,523,0,21,15375
1/10/2023,4,9888,1399,3981,484,0,21,15773
1/10/2023,5,9888,1824,3902,351,0,21,15986
1/10/2023,6,9828,2008,4366,250,0,30,16482
1/10/2023,7,9920,2448,4933,226,0,70,17597
1/10/2023,8,9928,3155,5464,251,0,84,18882
1/10/2023,9,9928,3404,5513,282,3,85,19215
1/10/2023,10,9931,2555,5404,362,32,84,18368
1/10/2023,11,9937,2576,5559,318,118,84,18592
1/10/2023,12,9997,2534,5465,286,194,87,18563
1/10/2023,13,10045,2299,5465,270,224,105,18408
1/10/2023,14,10037,2289,5356,274,199,103,18258
1/10/2023,15,9941,2386,5441,317,145,104,18334
1/10/2023,16,9833,2953,5829,361,61,100,19137
1/10/2023,17,9880,3820,5852,454,8,101,20115
1/10/2023,18,9993,4186,5788,647,0,103,20717
1/10/2023,19,10025,4146,5933,662,0,108,20874
1/10/2023,20,10028,3896,5933,816,0,110,20783
1/10/2023,21,10020,3335,5755,1162,0,106,20378
1/10/2023,22,10028,2842,5251,1581,0,108,19810
1/10/2023,23,10026,2308,4914,1776,0,69,19093
1/10/2023,24,10018,1583,4349,1902,0,49,17901
1/11/2023,1,10023,991,4176,2088,0,46,17324
1/11/2023,2,10019,725,3997,2183,0,47,16971
1/11/2023,3,10023,802,4055,1902,0,47,16829
1/11/2023,4,10031,1029,4435,1772,0,47,17314
1/11/2023,5,10031,1540,4455,1873,0,48,17947
1/11/2023,6,10034,1921,4353,2168,0,58,18534
1/11/2023,7,10036,2547,4547,2208,0,102,19440
1/11/2023,8,10032,3257,5474,2386,0,111,21260
1/11/2023,9,10024,3845,5326,2308,28,115,21646
1/11/2023,10,10022,3748,5286,2096,92,110,21354
1/11/2023,11,10019,3768,5227,1762,172,115,21063
1/11/2023,12,10017,3881,5191,1435,186,113,20823
1/11/2023,13,9980,4329,5220,1119,156,119,20923
1/11/2023,14,9978,3696,5082,1147,96,115,20114
1/11/2023,15,9980,3042,5214,1306,53,117,19712
1/11/2023,16,9975,3434,5648,1328,28,116,20529
1/11/2023,17,9977,3184,5772,1605,5,122,20665
1/11/2023,18,9974,3086,5746,2002,0,130,20938
1/11/2023,19,9975,3113,5678,2127,0,128,21021
1/11/2023,20,9980,3185,5644,2275,0,127,21211
1/11/2023,21,9976,3603,5435,2294,0,125,21433
1/11/2023,22,9975,3143,5053,2151,0,77,20399
1/11/2023,23,9979,2207,4910,1896,0,58,19050
1/11/2023,24,9978,1542,4773,1650,0,47,17990
1/12/2023,1,9982,872,4477,1582,0,41,16954
1/12/2023,2,9987,753,4208,1492,0,42,16482
1/12/2023,3,9992,753,4080,1610,0,39,16474
1/12/2023,4,9993,861,3473,1209,0,35,15571
1/12/2023,5,9994,1096,3845,1084,0,35,16054
1/12/2023,6,9925,1528,4514,687,0,64,16718
1/12/2023,7,9900,2248,5358,534,0,96,18136
1/12/2023,8,9902,3295,5698,664,0,110,19669
1/12/2023,9,9900,3565,5589,789,0,115,19958
1/12/2023,10,9901,3234,5406,788,11,113,19453
1/12/2023,11,9949,3217,5376,709,19,112,19382
1/12/2023,12,9985,3719,5298,721,26,113,19862
1/12/2023,13,9903,3747,5118,765,26,117,19676
1/12/2023,14,9847,3479,5087,1223,22,127,19785
1/12/2023,15,9843,2810,4876,1671,13,126,19339
1/12/2023,16,9848,2673,4739,2110,6,129,19505
1/12/2023,17,9846,2679,5253,2449,0,125,20352
1/12/2023,18,9847,2691,5232,2908,0,125,20803
1/12/2023,19,9855,2310,4797,2969,0,122,20053
1/12/2023,20,9853,1752,5099,3072,0,121,19897
1/12/2023,21,9851,829,5144,3228,0,122,19174
1/12/2023,22,9852,510,4677,3483,0,80,18602
1/12/2023,23,9849,199,4351,3514,0,69,17982
1/12/2023,24,9851,128,3996,3519,0,51,17545
1/13/2023,1,9848,127,3751,3512,0,51,17289
1/13/2023,2,9847,128,3768,3628,0,49,17420
1/13/2023,3,9567,128,4242,3688,0,50,17675
1/13/2023,4,9505,313,4357,3699,0,49,17923
1/13/2023,5,9511,723,4235,3630,0,51,18150
1/13/2023,6,9500,1225,3914,3516,0,49,18204
1/13/2023,7,9491,1541,4142,3328,0,49,18551
1/13/2023,8,9492,1590,4644,3364,0,58,19148
1/13/2023,9,9491,1608,5350,3321,0,62,19832
1/13/2023,10,9490,1731,5267,3199,4,49,19740
1/13/2023,11,9491,1702,5291,3217,13,51,19765
1/13/2023,12,9491,1599,5238,3201,27,43,19599
1/13/2023,13,9511,1621,5157,3110,32,43,19474
1/13/2023,14,9509,1773,5035,3101,33,45,19496
1/13/2023,15,9506,1771,4999,3041,28,50,19395
1/13/2023,16,9508,1771,5017,3075,16,81,19468
1/13/2023,17,9511,1769,5319,3140,3,87,19829
1/13/2023,18,9501,1782,5740,3099,0,78,20200
1/13/2023,19,9513,1781,5663,3068,0,83,20108
1/13/2023,20,9515,1759,5494,2967,0,87,19822
1/13/2023,21,9516,1630,5344,2913,0,81,19484
1/13/2023,22,9510,1217,5075,2854,0,40,18696
1/13/2023,23,9516,853,4740,2631,0,26,17766
1/13/2023,24,9517,400,4526,2507,0,19,16969
1/14/2023,1,9510,344,4240,2587,0,20,16701
1/14/2023,2,9516,315,4001,2449,0,21,16302
1/14/2023,3,9519,316,4044,2223,0,21,16123
1/14/2023,4,9525,316,4242,2005,0,21,16109
1/14/2023,5,9523,506,4383,1838,0,21,16271
1/14/2023,6,9512,987,4614,1470,0,22,16605
1/14/2023,7,9510,1613,4867,1291,0,22,17303
1/14/2023,8,9513,1793,4945,1354,0,27,17632
1/14/2023,9,9508,2211,5508,923,5,32,18187
1/14/2023,10,9513,3097,5683,570,28,32,18923
1/14/2023,11,9511,2745,5571,654,61,33,18575
1/14/2023,12,9509,2537,5582,714,112,33,18487
1/14/2023,13,9513,2082,5579,592,157,32,17955
1/14/2023,14,9520,1992,5020,817,168,34,17551
1/14/2023,15,9519,2267,4815,897,153,34,17685
1/14/2023,16,9518,2474,5191,702,94,33,18012
1/14/2023,17,9518,2496,5935,521,25,33,18528
1/14/2023,18,9515,3309,6283,407,0,32,19546
1/14/2023,19,9515,3283,6410,460,0,33,19701
1/14/2023,20,9517,2728,6453,480,0,33,19211
1/14/2023,21,9517,2704,6158,484,0,33,18896
1/14/2023,22,9514,2438,5813,609,0,33,18407
1/14/2023,23,9506,2099,5398,522,0,33,17558
1/14/2023,24,9504,1431,5238,422,0,26,16621
1/15/2023,1,9504,1369,4345,415,0,22,15655
1/15/2023,2,9509,1351,4424,361,0,22,15667
1/15/2023,3,9509,1352,4321,293,0,22,15497
1/15/2023,4,9505,1495,4487,271,0,22,15780
1/15/2023,5,9500,1815,4127,303,0,22,15767
1/15/2023,6,9499,2119,4443,337,0,22,16420
1/15/2023,7,9507,2118,4126,353,0,22,16126
1/15/2023,8,9507,1869,4566,419,0,27,16388
1/15/2023,9,9506,2254,5008,466,15,32,17281
1/15/2023,10,9502,2303,4964,480,49,33,17331
1/15/2023,11,9506,1986,5048,409,103,33,17085
1/15/2023,12,9503,1915,5163,437,125,33,17176
1/15/2023,13,9499,2072,4751,457,136,34,16949
1/15/2023,14,9502,2364,4571,472,165,33,17107
1/15/2023,15,9510,2553,4705,467,177,33,17445
1/15/2023,16,9509,2650,4753,481,138,33,17564
1/15/2023,17,9489,2766,5583,526,36,33,18433
1/15/2023,18,9485,3013,6033,644,0,33,19208
1/15/2023,19,9484,3067,5753,956,0,34,19294
1/15/2023,20,9490,2756,5429,1325,0,34,19034
1/15/2023,21,9483,2457,5024,1474,0,34,18472
1/15/2023,22,9492,1897,4635,1635,0,34,17693
1/15/2023,23,9496,1304,4212,1761,0,34,16807
1/15/2023,24,9495,810,3726,1950,0,29,16010
1/16/2023,1,9501,807,3591,1802,0,24,15725
1/16/2023,2,9496,717,3785,1736,0,24,15758
1/16/2023,3,9492,736,3750,1836,0,24,15838
1/16/2023,4,9487,827,3761,1845,0,24,15944
1/16/2023,5,9496,1245,3612,1848,0,24,16225
1/16/2023,6,9503,1757,3426,1959,0,24,16669
1/16/2023,7,9504,2134,4289,1856,0,29,17812
1/16/2023,8,9503,2273,4989,2089,0,33,18887
1/16/2023,9,9497,2865,5408,1817,38,33,19658
1/16/2023,10,9497,2103,5343,1882,149,33,19007
1/16/2023,11,9491,1985,4861,1919,245,32,18533
1/16/2023,12,9486,2047,4600,1742,302,32,18209
1/16/2023,13,9488,2123,4221,1743,315,31,17921
1/16/2023,14,9489,2193,4234,1695,309,31,17951
1/16/2023,15,9494,2131,4419,1681,244,31,18000
1/16/2023,16,9491,2137,4921,1810,128,31,18518
1/16/2023,17,9495,2191,5539,2357,17,32,19631
1/16/2023,18,9493,2104,5437,2742,0,32,19808
1/16/2023,19,9489,2098,5177,2690,0,33,19487
1/16/2023,20,9488,1800,4964,2783,0,33,19068
1/16/2023,21,9481,1589,4894,2969,0,34,18967
1/16/2023,22,9478,1053,4493,2960,0,33,18017
1/16/2023,23,9478,612,3957,2952,0,33,17032
1/16/2023,24,9475,214,3734,2743,0,25,16191
1/17/2023,1,9473,133,3654,2693,0,23,15976
1/17/2023,2,9473,206,3616,2521,0,23,15839
1/17/2023,3,9476,216,3733,2345,0,23,15793
1/17/2023,4,9475,578,3748,2198,0,23,16022
1/17/2023,5,9481,1103,3638,2261,0,23,16506
1/17/2023,6,9483,1868,3872,2103,0,23,17349
1/17/2023,7,9483,2223,4645,2426,0,28,18805
1/17/2023,8,9481,2375,5100,2557,1,33,19547
1/17/2023,9,9477,2456,5401,2579,9,33,19955
1/17/2023,10,9468,2451,4666,1900,21,33,18539
1/17/2023,11,9469,2449,4696,2458,42,33,19147
1/17/2023,12,9467,2449,4873,2511,61,33,19394
1/17/2023,13,9460,2459,4889,2598,53,33,19492
1/17/2023,14,9465,2489,4983,2595,53,33,19618
1/17/2023,15,9468,2389,5379,2248,29,33,19546
1/17/2023,16,9470,2352,5337,2383,32,33,19607
1/17/2023,17,9467,2350,5104,2708,8,33,19670
1/17/2023,18,9464,2352,5906,2752,0,33,20507
1/17/2023,19,9463,2351,5404,2738,0,33,19989
1/17/2023,20,9468,2221,5529,2750,0,34,20002
1/17/2023,21,9467,1776,5258,2773,0,33,19307
1/17/2023,22,9439,1398,4358,2726,0,33,17954
1/17/2023,23,9458,880,3823,2778,0,33,16972
1/17/2023,24,9459,236,3606,2731,0,25,16057
1/18/2023,1,9454,127,3445,2287,0,22,15335
1/18/2023,2,9449,127,3305,2167,0,22,15070
1/18/2023,3,9453,128,3384,2079,0,22,15066
1/18/2023,4,9443,201,3378,2222,0,22,15266
1/18/2023,5,9438,432,3439,2694,0,10,16013
1/18/2023,6,9444,778,3669,2535,0,18,16444
1/18/2023,7,9442,1045,4371,2259,0,30,17147
1/18/2023,8,9440,1503,5240,2068,0,32,18283
1/18/2023,9,9443,2074,5436,1933,2,33,18921
1/18/2023,10,9442,2611,5274,1465,23,32,18847
1/18/2023,11,9442,2964,5456,1240,58,33,19193
1/18/2023,12,9437,3060,5117,1068,46,33,18761
1/18/2023,13,9435,3105,5086,1023,48,33,18730
1/18/2023,14,9438,3107,5289,816,46,36,18732
1/18/2023,15,9441,3146,4960,776,59,33,18415
1/18/2023,16,9445,3235,5132,542,32,33,18419
1/18/2023,17,9443,3103,5868,345,4,33,18796
1/18/2023,18,9453,4038,6082,218,0,33,19824
1/18/2023,19,9451,3284,5920,384,0,32,19071
1/18/2023,20,9451,2962,5792,410,0,32,18647
1/18/2023,21,9448,2796,5357,433,0,32,18066
1/18/2023,22,9444,2497,5086,458,0,32,17517
1/18/2023,23,9445,1495,5238,495,0,32,16705
1/18/2023,24,9444,906,4981,685,0,27,16043
1/19/2023,1,9445,841,4628,1048,0,22,15984
1/19/2023,2,9443,554,3676,1587,0,22,15282
1/19/2023,3,9444,181,3757,2174,0,22,15578
1/19/2023,4,9442,123,4009,2447,0,22,16043
1/19/2023,5,9449,225,3890,2823,0,22,16409
1/19/2023,6,9449,411,3551,3021,0,22,16454
1/19/2023,7,9453,824,3823,2980,0,27,17107
1/19/2023,8,9451,850,4064,3863,0,32,18260
1/19/2023,9,9442,1057,4499,4000,2,33,19033
1/19/2023,10,9438,1316,4656,3886,12,33,19341
1/19/2023,11,9429,1550,4863,3778,27,33,19680
1/19/2023,12,9429,1814,4945,3439,34,33,19694
1/19/2023,13,9424,2077,5130,3051,34,33,19749
1/19/2023,14,9422,2069,4788,3280,32,33,19624
1/19/2023,15,9414,2142,4505,2739,26,32,18858
1/19/2023,16,9421,2133,5328,1934,18,32,18866
1/19/2023,17,9432,2649,5568,1481,3,31,19164
1/19/2023,18,9432,2866,5711,1324,0,30,19363
1/19/2023,19,9438,3012,5693,1143,0,30,19316
1/19/2023,20,9440,3004,5677,913,0,30,19064
1/19/2023,21,9440,2360,5707,975,0,30,18512
1/19/2023,22,9441,2014,4931,1469,0,30,17885
1/19/2023,23,9444,1194,4285,1807,0,30,16760
1/19/2023,24,9445,614,4239,2067,0,25,16390
1/20/2023,1,9449,241,4186,2337,0,20,16233
1/20/2023,2,9450,132,3946,2418,0,20,15966
1/20/2023,3,9452,132,4072,2498,0,20,16174
1/20/2023,4,9451,213,4414,2513,0,20,16611
1/20/2023,5,9443,465,4288,2467,0,20,16683
1/20/2023,6,9441,858,4057,2188,0,20,16564
1/20/2023,7,9445,1503,4299,2052,0,20,17319
1/20/2023,8,9450,1688,4609,2027,0,26,17800
1/20/2023,9,9445,2499,4824,1917,3,32,18720
1/20/2023,10,9451,2874,4709,1708,22,32,18796
1/20/2023,11,9447,2944,4682,1605,54,32,18764
1/20/2023,12,9442,2360,4723,1944,75,32,18576
1/20/2023,13,9454,2465,4253,2116,88,33,18409
1/20/2023,14,9456,2458,4462,1649,82,32,18139
1/20/2023,15,9459,2461,4865,1277,82,33,18177
1/20/2023,16,9464,2332,4985,1328,42,33,18184
1/20/2023,17,9458,2414,5437,1364,9,33,18715
1/20/2023,18,9459,2505,6004,1276,0,33,19277
1/20/2023,19,9459,2542,5910,1218,0,32,19161
1/20/2023,20,9457,2493,5809,1150,0,32,18941
1/20/2023,21,9458,2378,5716,990,0,32,18574
1/20/2023,22,9449,1872,5492,749,0,32,17594
1/20/2023,23,9459,1856,5208,563,0,32,17118
1/20/2023,24,9458,1691,4782,323,0,22,16276
1/21/2023,1,9454,1294,4722,169,0,19,15658
1/21/2023,2,9456,1271,4510,107,0,19,15363
1/21/2023,3,9449,1164,4219,125,0,19,14976
1/21/2023,4,9440,1313,4096,227,0,19,15095
1/21/2023,5,9444,1283,4059,311,0,19,15116
1/21/2023,6,9452,1286,4093,281,0,19,15131
1/21/2023,7,9459,1291,4637,238,0,22,15647
1/21/2023,8,9459,1484,5154,218,0,26,16341
1/21/2023,9,9461,1717,5496,181,0,33,16888
1/21/2023,10,9462,2212,5680,170,14,32,17570
1/21/2023,11,9462,2676,5478,111,28,33,17788
1/21/2023,12,9460,3185,5180,189,36,33,18083
1/21/2023,13,9462,2940,5042,381,33,33,17891
1/21/2023,14,9460,2584,4996,714,28,33,17815
1/21/2023,15,9472,2328,5110,683,25,33,17651
1/21/2023,16,9483,2313,5329,557,16,33,17731
1/21/2023,17,9483,2348,5758,527,2,33,18151
1/21/2023,18,9480,2436,6003,658,0,33,18610
1/21/2023,19,9477,2418,5834,763,0,33,18525
1/21/2023,20,9480,2127,5783,743,0,33,18166
1/21/2023,21,9481,1584,5725,776,0,33,17599
1/21/2023,22,9483,1394,5271,900,0,33,17081
1/21/2023,23,9478,1167,4885,790,0,33,16353
1/21/2023,24,9482,643,4682,714,0,23,15544
1/22/2023,1,9484,506,4564,684,0,20,15258
1/22/2023,2,9489,504,4502,604,0,20,15119
1/22/2023,3,9504,363,4301,530,0,20,14718
1/22/2023,4,9563,316,4316,292,0,26,14513
1/22/2023,5,9585,463,4652,190,0,33,14923
1/22/2023,6,9584,566,4572,195,0,33,14950
1/22/2023,7,9591,859,4559,153,0,34,15196
1/22/2023,8,9591,1200,4832,118,0,32,15773
1/22/2023,9,9596,1523,5421,124,0,34,16698
1/22/2023,10,9642,1600,5638,192,4,34,17110
1/22/2023,11,9700,1832,5574,239,12,34,17391
1/22/2023,12,9761,2240,5608,180,14,35,17838
1/22/2023,13,9832,2358,5469,95,18,34,17806
1/22/2023,14,9860,2352,5535,69,20,34,17870
1/22/2023,15,9861,2364,5431,59,12,35,17762
1/22/2023,16,9868,2426,5564,43,4,34,17939
1/22/2023,17,9864,2532,6069,27,1,34,18527
1/22/2023,18,9865,2968,6333,28,0,34,19228
1/22/2023,19,9867,3121,6226,44,0,34,19292
1/22/2023,20,9867,2621,6048,126,0,34,18696
1/22/2023,21,9866,2290,5952,151,0,35,18294
1/22/2023,22,9863,1585,5501,197,0,35,17181
1/22/2023,23,9890,1224,5059,233,0,34,16440
1/22/2023,24,9929,1074,4637,260,0,30,15930
1/23/2023,1,9977,664,4559,309,0,22,15531
1/23/2023,2,9972,407,4403,416,0,22,15220
1/23/2023,3,9973,619,4130,542,0,22,15286
1/23/2023,4,9973,802,4252,642,0,28,15697
1/23/2023,5,9971,1060,3904,720,0,39,15694
1/23/2023,6,9964,1578,3873,619,0,42,16076
1/23/2023,7,9970,1969,4506,675,0,50,17170
1/23/2023,8,9971,2281,5554,623,0,52,18481
1/23/2023,9,9971,2485,5853,537,0,49,18895
1/23/2023,10,9969,2486,5965,523,2,35,18980
1/23/2023,11,10021,2276,5853,603,13,33,18799
1/23/2023,12,10025,2300,5518,694,25,33,18595
1/23/2023,13,10028,2465,5276,770,24,33,18596
1/23/2023,14,10027,2167,4796,1162,20,33,18205
1/23/2023,15,10024,1991,4989,1307,17,33,18361
1/23/2023,16,10027,2274,4647,1448,11,33,18440
1/23/2023,17,10024,2413,4602,1558,1,33,18631
1/23/2023,18,10034,2335,4709,2703,0,33,19814
1/23/2023,19,10064,2066,4495,2971,0,33,19629
1/23/2023,20,10063,1620,4355,3149,0,34,19221
1/23/2023,21,10064,1162,4174,3352,0,34,18786
1/23/2023,22,10056,780,3848,3755,0,34,18473
1/23/2023,23,10052,354,3844,3924,0,34,18208
1/23/2023,24,10043,132,3694,3933,0,25,17827
1/24/2023,1,10048,131,3581,3895,0,24,17679
1/24/2023,2,10056,132,3618,3919,0,23,17748
1/24/2023,3,10059,132,3753,4086,0,23,18053
1/24/2023,4,10060,132,3766,4089,0,23,18070
1/24/2023,5,10065,333,3544,3879,0,23,17844
1/24/2023,6,9978,761,3471,3096,0,23,17329
1/24/2023,7,9977,917,3822,3020,0,28,17764
1/24/2023,8,9973,920,4343,3515,0,33,18784
1/24/2023,9,9967,1026,4353,3272,2,46,18666
1/24/2023,10,9972,1249,4491,2912,10,41,18675
1/24/2023,11,9932,1652,4685,2618,34,49,18970
1/24/2023,12,10010,1783,4207,2152,70,51,18273
1/24/2023,13,10010,1912,4182,1684,89,40,17917
1/24/2023,14,10011,1980,4325,1246,170,33,17765
1/24/2023,15,10001,2086,4888,950,173,31,18129
1/24/2023,16,10009,2325,5004,930,95,26,18389
1/24/2023,17,10010,2448,5586,780,37,10,18871
1/24/2023,18,10007,3067,5810,638,1,4,19527
1/24/2023,19,10006,3252,5578,790,0,7,19633
1/24/2023,20,10013,3041,5619,752,0,7,19432
1/24/2023,21,10008,2866,5401,808,0,4,19087
1/24/2023,22,10010,2360,5402,557,0,10,18339
1/24/2023,23,10004,1959,5316,464,0,19,17762
1/24/2023,24,10001,1341,4669,389,0,23,16423
1/25/2023,1,9998,1298,4324,370,0,22,16012
1/25/2023,2,9997,1244,4144,446,0,22,15853
1/25/2023,3,10006,1201,3875,489,0,22,15593
1/25/2023,4,10006,1334,3747,579,0,22,15688
1/25/2023,5,10008,1731,3684,305,0,22,15750
1/25/2023,6,10006,2147,3799,485,0,22,16459
1/25/2023,7,10015,2498,4006,917,0,25,17461
1/25/2023,8,10012,2637,4791,1630,0,31,19101
1/25/2023,9,10013,2754,5013,1760,4,31,19575
1/25/2023,10,10010,2599,4350,1951,13,31,18954
1/25/2023,11,10013,2239,4446,2397,16,31,19142
1/25/2023,12,10017,2202,4342,2600,17,30,19208
1/25/2023,13,10002,2390,4201,2699,22,30,19344
1/25/2023,14,10035,2379,4070,3010,13,30,19537
1/25/2023,15,10028,2365,4156,2775,9,31,19364
1/25/2023,16,10027,2142,4192,3112,3,30,19506
1/25/2023,17,10031,2243,4962,2988,0,31,20255
1/25/2023,18,10030,2951,5541,2345,0,31,20898
1/25/2023,19,10035,3114,5396,2138,0,31,20714
1/25/2023,20,10035,2401,5252,2315,0,32,20035
1/25/2023,21,10033,2108,4900,2293,0,32,19366
1/25/2023,22,10034,1378,4404,2487,0,30,18333
1/25/2023,23,10031,1021,3823,2775,0,30,17680
1/25/2023,24,10029,506,3634,2661,0,26,16856
1/26/2023,1,10030,187,3677,3006,0,22,16922
1/26/2023,2,10028,155,3800,3076,0,22,17081
1/26/2023,3,10028,155,4113,3026,0,23,17345
1/26/2023,4,10032,234,3977,3174,0,23,17440
1/26/2023,5,10029,524,3858,3084,0,23,17518
1/26/2023,6,10028,1323,3796,2162,0,23,17332
1/26/2023,7,10027,2050,4102,2476,0,28,18683
1/26/2023,8,10028,2324,4369,2406,0,32,19159
1/26/2023,9,10028,2364,4430,2338,0,32,19192
1/26/2023,10,10024,2479,4762,2015,7,32,19319
1/26/2023,11,10028,2637,4778,1717,20,27,19207
1/26/2023,12,10027,2783,4824,1274,30,21,18959
1/26/2023,13,10031,2247,4836,989,39,21,18163
1/26/2023,14,9866,2336,4873,861,41,21,17998
1/26/2023,15,9836,2567,4874,689,44,21,18031
1/26/2023,16,9839,2863,4730,556,37,21,18046
1/26/2023,17,10021,2948,5246,468,12,21,18716
1/26/2023,18,10052,3052,5828,449,0,24,19405
1/26/2023,19,10047,3396,5886,672,0,17,20018
1/26/2023,20,10050,2965,5392,1105,0,23,19535
1/26/2023,21,10054,2773,5177,1386,0,31,19421
1/26/2023,22,10044,2266,4956,1644,0,31,18941
1/26/2023,23,10049,1557,4643,1617,0,31,17897
1/26/2023,24,10056,1223,4443,1803,0,25,17550
1/27/2023,1,10053,843,4320,1795,0,20,17031
1/27/2023,2,10060,732,4117,2029,0,20,16958
1/27/2023,3,10060,736,4117,1797,0,20,16730
1/27/2023,4,10057,736,3932,2344,0,20,17089
1/27/2023,5,10053,912,3960,2367,0,20,17312
1/27/2023,6,10061,1294,4071,1744,0,20,17190
1/27/2023,7,10059,1770,4484,1762,0,28,18103
1/27/2023,8,10065,1811,5344,2000,0,32,19252
1/27/2023,9,10071,2299,5459,1943,5,32,19809
1/27/2023,10,10065,1883,5152,2383,20,32,19535
1/27/2023,11,10056,1454,4569,3042,33,32,19186
1/27/2023,12,10039,1184,4272,3105,30,32,18662
1/27/2023,13,10059,865,4161,3639,26,32,18782
1/27/2023,14,10075,742,4123,3909,35,32,18916
1/27/2023,15,10074,743,4367,4246,31,32,19493
1/27/2023,16,10095,745,4617,4422,14,33,19926
1/27/2023,17,10087,744,4580,4479,8,32,19930
1/27/2023,18,10096,745,4600,4361,1,32,19835
1/27/2023,19,10046,743,4951,4361,0,32,20133
1/27/2023,20,10044,745,4840,4427,0,32,20088
1/27/2023,21,10040,322,4521,4503,0,32,19418
1/27/2023,22,10044,128,4239,4535,0,32,18978
1/27/2023,23,10042,127,3942,4565,0,31,18707
1/27/2023,24,10035,127,3520,4500,0,25,18207
1/28/2023,1,10032,127,3318,4324,0,21,17822
1/28/2023,2,10031,127,3371,4009,0,20,17558
1/28/2023,3,10039,126,3344,3903,0,20,17432
1/28/2023,4,10039,126,3341,3933,0,20,17459
1/28/2023,5,10036,127,3218,3942,0,20,17343
1/28/2023,6,10034,250,3286,3728,0,20,17318
1/28/2023,7,10039,529,3639,3416,0,28,17651
1/28/2023,8,10041,748,3957,3098,0,30,17874
1/28/2023,9,10040,769,4349,2540,10,31,17739
1/28/2023,10,10038,873,4712,2233,35,31,17922
1/28/2023,11,10026,1026,4669,1893,85,31,17730
1/28/2023,12,10017,1188,5037,1563,139,31,17975
1/28/2023,13,10027,1640,4501,1317,150,31,17666
1/28/2023,14,10041,1661,4179,1314,129,31,17355
1/28/2023,15,10042,1691,4516,1270,116,31,17666
1/28/2023,16,10040,1931,4736,939,81,31,17758
1/28/2023,17,10033,2355,4995,813,27,23,18246
1/28/2023,18,10037,2380,5763,467,0,23,18670
1/28/2023,19,10042,2576,5979,141,0,23,18761
1/28/2023,20,10040,2301,5821,115,0,23,18300
1/28/2023,21,10040,2162,5286,216,0,23,17727
1/28/2023,22,10037,1510,5138,369,0,23,17077
1/28/2023,23,10037,632,4758,600,0,23,16050
1/28/2023,24,10036,163,4510,823,0,19,15551
1/29/2023,1,10030,138,4648,769,0,20,15605
1/29/2023,2,10032,138,4418,756,0,19,15363
1/29/2023,3,10030,138,4309,883,0,0,15360
1/29/2023,4,10036,140,4507,838,0,0,15521
1/29/2023,5,10041,138,4294,1071,0,0,15544
1/29/2023,6,10042,135,3785,1671,0,2,15635
1/29/2023,7,10043,131,4021,1624,0,17,15836
1/29/2023,8,10042,254,4632,1707,0,16,16651
1/29/2023,9,10043,433,4669,1782,4,10,16941
1/29/2023,10,10040,982,4598,1665,20,27,17332
1/29/2023,11,10031,1430,4589,1450,33,26,17559
1/29/2023,12,10032,1902,4726,1667,41,23,18391
1/29/2023,13,10033,2164,4464,1633,60,23,18377
1/29/2023,14,10036,2363,4409,1745,55,23,18631
1/29/2023,15,10036,2490,4459,2112,54,23,19174
1/29/2023,16,10038,2588,4442,1499,42,23,18632
1/29/2023,17,10039,2590,4566,1591,17,23,18826
1/29/2023,18,10036,2858,5488,1350,0,24,19756
1/29/2023,19,10036,3487,5622,1030,0,24,20199
1/29/2023,20,10040,2983,5537,699,0,24,19283
1/29/2023,21,10036,2708,5441,453,0,25,18663
1/29/2023,22,10032,2372,5162,467,0,25,18058
1/29/2023,23,10029,1845,4750,548,0,25,17197
1/29/2023,24,10028,1699,4420,554,0,19,16720
1/30/2023,1,10024,1712,4185,382,0,15,16318
1/30/2023,2,10028,1786,4071,394,0,15,16294
1/30/2023,3,10029,1789,3971,418,0,15,16222
1/30/2023,4,10029,1908,4212,395,0,15,16559
1/30/2023,5,10029,2295,3894,331,0,15,16564
1/30/2023,6,10027,2644,3954,271,0,29,16925
1/30/2023,7,10032,3037,4737,424,0,63,18293
1/30/2023,8,10036,4117,5069,383,0,74,19679
1/30/2023,9,10033,4301,5047,452,1,84,19918
1/30/2023,10,10034,4429,4931,384,11,85,19874
1/30/2023,11,10030,4492,4953,353,32,85,19945
1/30/2023,12,10032,4030,4856,536,85,87,19626
1/30/2023,13,10031,3752,4789,847,85,85,19589
1/30/2023,14,10028,3395,4628,939,87,84,19161
1/30/2023,15,10027,3638,4530,1151,73,83,19502
1/30/2023,16,10025,3411,4513,1312,50,84,19395
1/30/2023,17,10019,3452,4919,1601,16,82,20089
1/30/2023,18,10026,3900,5054,1734,0,81,20795
1/30/2023,19,10034,4090,5220,1614,0,86,21044
1/30/2023,20,10036,3535,5403,1846,0,80,20900
1/30/2023,21,10030,3200,5011,2271,0,80,20592
1/30/2023,22,10028,2859,4405,2524,0,80,19896
1/30/2023,23,10028,1900,4251,2350,0,38,18567
1/30/2023,24,10032,1601,4071,2535,0,19,18258
1/31/2023,1,10028,1734,4033,2470,0,17,18282
1/31/2023,2,10032,1947,3865,2490,0,17,18351
1/31/2023,3,10033,1982,4282,2075,0,17,18389
1/31/2023,4,10028,2094,4386,1916,0,17,18441
1/31/2023,5,10024,2197,3767,1793,0,18,17799
1/31/2023,6,10030,2457,4029,1505,0,25,18046
1/31/2023,7,10037,2925,5233,1303,0,65,19563
1/31/2023,8,10027,3845,5847,994,0,91,20804
1/31/2023,9,10029,4297,5849,715,27,88,21005
1/31/2023,10,10026,4255,5612,389,111,83,20476
1/31/2023,11,10032,3528,5514,279,193,83,19629
1/31/2023,12,10039,3253,5185,252,198,84,19011
1/31/2023,13,10043,3298,5091,225,175,84,18916
1/31/2023,14,10042,3118,5161,213,143,85,18762
1/31/2023,15,10045,3212,5168,244,144,85,18898
1/31/2023,16,10041,3180,5259,301,76,81,18938
1/31/2023,17,10047,3354,6220,379,22,77,20099
1/31/2023,18,10049,4604,6227,342,2,83,21307
1/31/2023,19,10040,5051,6069,354,0,82,21596
1/31/2023,20,10036,4912,5949,474,0,81,21452
1/31/2023,21,10038,4660,5916,786,0,80,21480
1/31/2023,22,10031,3832,5635,1152,0,36,20686
1/31/2023,23,10035,3210,4507,1510,0,30,19292
1/31/2023,24,10024,2733,4121,1280,0,25,18183
2/1/2023,1,10023,1696,4346,1849,0,20,17934
2/1/2023,2,10020,1472,4295,2078,0,20,17885
2/1/2023,3,10011,1831,3998,1951,0,20,17811
2/1/2023,4,10025,2266,3874,1924,0,20,18109
2/1/2023,5,10031,2514,3891,1773,0,20,18229
2/1/2023,6,10030,2836,4095,2176,0,39,19176
2/1/2023,7,10029,3057,5151,2240,0,68,20545
2/1/2023,8,10028,3837,5857,2275,1,79,22077
2/1/2023,9,10022,3773,5843,2620,46,80,22384
2/1/2023,10,10024,3796,5648,2532,120,82,22202
2/1/2023,11,10023,3372,5136,2345,174,83,21133
2/1/2023,12,10027,2521,4915,2542,202,83,20290
2/1/2023,13,10020,2301,4733,2619,212,82,19967
2/1/2023,14,10018,2641,4574,2472,202,84,19991
2/1/2023,15,10012,3052,4265,2757,193,45,20324
2/1/2023,16,9989,2861,4365,2299,152,32,19698
2/1/2023,17,9989,2536,5037,2437,61,32,20092
2/1/2023,18,9990,2553,5268,3194,3,32,21040
2/1/2023,19,9987,2620,5060,3217,0,32,20916
2/1/2023,20,9987,2441,4994,3350,0,31,20803
2/1/2023,21,9980,2272,4609,3055,0,31,19947
2/1/2023,22,9980,1531,4546,3063,0,31,19151
2/1/2023,23,9990,759,4145,2535,0,31,17460
2/1/2023,24,9994,308,3907,2365,0,22,16596
2/2/2023,1,9994,239,3886,2281,0,20,16420
2/2/2023,2,9994,239,3977,1568,0,20,15798
2/2/2023,3,9988,239,3913,1249,0,20,15409
2/2/2023,4,9991,335,3867,1181,0,20,15394
2/2/2023,5,9992,527,3707,1297,0,20,15543
2/2/2023,6,9933,666,3781,1561,0,20,15961
2/2/2023,7,9936,677,4032,2381,0,26,17052
2/2/2023,8,9939,717,4424,3003,0,29,18112
2/2/2023,9,9935,760,4336,3502,18,29,18580
2/2/2023,10,9931,1027,4253,3301,109,29,18650
2/2/2023,11,9937,1033,3952,3346,134,29,18431
2/2/2023,12,9958,822,3859,3150,161,33,17983
2/2/2023,13,9985,837,3771,3022,202,41,17858
2/2/2023,14,9980,1004,3622,2766,199,42,17613
2/2/2023,15,9989,1083,3740,2830,186,43,17871
2/2/2023,16,9988,1196,4358,3631,109,42,19324
2/2/2023,17,9980,957,4550,3966,32,37,19522
2/2/2023,18,9983,896,4713,4349,1,31,19973
2/2/2023,19,9983,895,4687,4276,0,30,19871
2/2/2023,20,9976,795,4747,4397,0,30,19945
2/2/2023,21,9976,738,4523,4387,0,30,19654
2/2/2023,22,9974,602,4180,4141,0,30,18927
2/2/2023,23,9976,267,3951,3613,0,30,17837
2/2/2023,24,9974,199,3956,2947,0,21,17097
2/3/2023,1,9983,199,3873,3163,0,20,17238
2/3/2023,2,9979,242,3840,2631,0,20,16712
2/3/2023,3,9976,280,3859,2611,0,20,16746
2/3/2023,4,9974,700,3747,2641,0,0,17062
2/3/2023,5,9983,1449,3846,2792,0,0,18070
2/3/2023,6,9974,2239,3977,3147,0,0,19337
2/3/2023,7,9974,2832,4858,3455,0,0,21119
2/3/2023,8,9983,3673,5522,3295,2,0,22475
2/3/2023,9,9984,4104,5486,3138,59,0,22771
2/3/2023,10,9983,3993,5518,3197,157,0,22848
2/3/2023,11,9988,3526,5301,3205,206,0,22226
2/3/2023,12,9990,3339,5140,3124,215,0,21808
2/3/2023,13,9994,3530,4935,3162,233,0,21854
2/3/2023,14,9990,3758,5082,3119,214,0,22163
2/3/2023,15,9996,4138,5304,3068,207,30,22743
2/3/2023,16,9991,4725,5287,2892,159,50,23104
2/3/2023,17,9988,5237,5560,2637,71,91,23584
2/3/2023,18,9983,6132,6022,2263,6,135,24541
2/3/2023,19,10000,6239,5875,2119,0,114,24347
2/3/2023,20,10004,6076,5964,2120,0,81,24245
2/3/2023,21,10004,5996,5893,1820,0,84,23797
2/3/2023,22,9994,5734,5979,1514,0,84,23305
2/3/2023,23,9996,5226,5839,1065,0,84,22210
2/3/2023,24,9996,4975,5706,762,0,77,21516
2/4/2023,1,9987,5103,5223,709,0,74,21096
2/4/2023,2,9994,5103,5188,769,0,76,21130
2/4/2023,3,9992,5072,5124,787,0,78,21053
2/4/2023,4,9995,4302,5125,1010,0,82,20514
2/4/2023,5,9999,4597,5021,1284,0,83,20984
2/4/2023,6,9996,4315,4949,1814,0,86,21160
2/4/2023,7,9998,3728,5362,2382,0,82,21552
2/4/2023,8,9999,3674,5440,2750,0,84,21947
2/4/2023,9,9915,4045,5142,3064,7,85,22258
2/4/2023,10,8790,4872,5582,2838,16,89,22187
2/4/2023,11,9094,4874,5117,3067,52,93,22297
2/4/2023,12,9098,4665,5033,3262,96,85,22239
2/4/2023,13,9114,5024,4814,3271,103,85,22411
2/4/2023,14,9122,5077,4773,3298,126,86,22482
2/4/2023,15,9123,4657,4753,3277,179,85,22074
2/4/2023,16,9121,4730,4849,3228,136,85,22149
2/4/2023,17,9122,4535,4925,3111,52,86,21831
2/4/2023,18,9124,4911,5284,3069,4,88,22480
2/4/2023,19,9125,5225,5502,3060,0,86,22998
2/4/2023,20,9123,4732,5065,3014,0,85,22019
2/4/2023,21,9116,3848,4929,3060,0,83,21036
2/4/2023,22,9410,3255,4825,3039,0,91,20620
2/4/2023,23,9727,2674,4695,3081,0,86,20263
2/4/2023,24,9954,1695,4016,3089,0,41,18795
2/5/2023,1,10030,1214,3516,2720,0,21,17501
2/5/2023,2,10032,929,3412,2818,0,21,17212
2/5/2023,3,10040,928,3407,2806,0,21,17202
2/5/2023,4,10033,929,3389,2817,0,21,17189
2/5/2023,5,10016,927,3434,2686,0,21,17084
2/5/2023,6,10017,985,3626,2845,0,21,17494
2/5/2023,7,10032,1179,3941,2968,0,26,18146
2/5/2023,8,10036,1420,3883,2568,0,28,17935
2/5/2023,9,10030,1618,4059,2521,16,31,18275
2/5/2023,10,10036,2017,4138,2453,50,37,18731
2/5/2023,11,10035,2199,4117,2630,110,69,19160
2/5/2023,12,10034,2162,3969,2109,105,84,18463
2/5/2023,13,10032,2280,3984,2319,128,84,18827
2/5/2023,14,10031,2122,3950,1813,75,84,18075
2/5/2023,15,10029,2369,3930,1946,58,86,18418
2/5/2023,16,10030,2755,3947,1615,39,85,18471
2/5/2023,17,10028,3285,4435,1769,12,86,19615
2/5/2023,18,10024,3408,4572,2069,0,84,20157
2/5/2023,19,10022,3568,4706,2031,0,85,20412
2/5/2023,20,10019,3268,4744,1720,0,85,19836
2/5/2023,21,10021,2734,4667,1859,0,43,19324
2/5/2023,22,10020,1511,4423,1881,0,31,17866
2/5/2023,23,10026,711,4211,2114,0,31,17093
2/5/2023,24,10023,509,3909,2083,0,23,16547
2/6/2023,1,10013,509,3617,2061,0,21,16221
2/6/2023,2,10018,509,3674,2104,0,21,16326
2/6/2023,3,10010,509,3836,2053,0,21,16429
2/6/2023,4,10006,551,4342,1584,0,21,16504
2/6/2023,5,10007,814,4146,1499,0,21,16487
2/6/2023,6,10011,1407,4273,1507,0,21,17219
2/6/2023,7,10025,2291,4880,1477,0,29,18702
2/6/2023,8,10024,2690,5353,1373,1,33,19474
2/6/2023,9,10021,3329,5282,1198,30,33,19893
2/6/2023,10,10017,3155,5238,933,116,33,19492
2/6/2023,11,10014,2626,4979,623,204,33,18479
2/6/2023,12,10023,2409,4771,360,294,33,17890
2/6/2023,13,10019,2070,4663,277,329,33,17391
2/6/2023,14,10020,2078,4284,261,296,33,16972
2/6/2023,15,9978,2447,4223,163,158,33,17002
2/6/2023,16,10015,2747,4276,193,157,38,17426
2/6/2023,17,10020,2810,4862,282,71,69,18114
2/6/2023,18,10019,3158,5432,308,1,87,19005
2/6/2023,19,10031,3344,5815,559,0,84,19833
2/6/2023,20,10030,3328,5762,883,0,83,20086
2/6/2023,21,10029,3015,5338,1386,0,84,19852
2/6/2023,22,10016,1941,4367,2115,0,43,18482
2/6/2023,23,10026,583,4061,2567,0,31,17268
2/6/2023,24,10028,206,3593,2941,0,24,16792
2/7/2023,1,10028,129,3444,3133,0,20,16754
2/7/2023,2,10031,126,3450,3310,0,20,16937
2/7/2023,3,10030,126,3816,3385,0,20,17377
2/7/2023,4,10027,126,4148,3448,0,20,17769
2/7/2023,5,10028,126,4000,3482,0,24,17660
2/7/2023,6,9952,214,3642,3683,0,33,17524
2/7/2023,7,9942,356,4202,3813,0,40,18353
2/7/2023,8,9948,539,4303,4022,5,44,18861
2/7/2023,9,9946,545,4322,4124,54,42,19033
2/7/2023,10,9947,546,4271,4143,104,36,19047
2/7/2023,11,10018,605,4148,4192,88,41,19092
2/7/2023,12,10029,705,4476,4400,98,39,19747
2/7/2023,13,10028,686,4229,4235,81,39,19298
2/7/2023,14,10024,578,3569,4204,86,41,18502
2/7/2023,15,10026,599,3685,4158,66,39,18573
2/7/2023,16,10033,1047,3960,4243,72,44,19399
2/7/2023,17,10031,1101,4461,4239,26,46,19904
2/7/2023,18,10033,1008,4821,3954,2,44,19862
2/7/2023,19,10035,982,4942,3628,0,39,19626
2/7/2023,20,10035,978,5108,3302,0,34,19457
2/7/2023,21,10037,978,4808,3161,0,32,19016
2/7/2023,22,10037,456,4883,2693,0,32,18101
2/7/2023,23,10033,271,4894,2234,0,32,17464
2/7/2023,24,10025,174,4330,2151,0,26,16706
2/8/2023,1,10031,131,4122,2118,0,22,16424
2/8/2023,2,10023,130,4013,2220,0,22,16408
2/8/2023,3,10024,129,4178,2033,0,22,16386
2/8/2023,4,10027,125,4218,1927,0,22,16319
2/8/2023,5,10029,182,4340,1618,0,22,16191
2/8/2023,6,10025,252,4349,1506,0,22,16154
2/8/2023,7,10022,508,4864,1254,0,25,16673
2/8/2023,8,10027,652,5420,1353,1,32,17485
2/8/2023,9,10027,568,4959,1380,65,32,17031
2/8/2023,10,10026,515,4788,1118,175,33,16655
2/8/2023,11,10030,509,4380,834,235,33,16021
2/8/2023,12,10033,509,4279,631,289,33,15774
2/8/2023,13,10030,611,4156,692,310,33,15832
2/8/2023,14,10028,853,4116,536,343,32,15908
2/8/2023,15,10026,1104,4153,587,300,30,16200
2/8/2023,16,10027,1327,4448,516,150,32,16500
2/8/2023,17,10032,1467,4801,790,79,32,17201
2/8/2023,18,10027,1465,5427,1328,6,31,18284
2/8/2023,19,10031,1464,5342,1374,0,32,18243
2/8/2023,20,10031,1463,5212,1371,0,32,18109
2/8/2023,21,10031,1369,4707,1520,0,30,17657
2/8/2023,22,10026,878,4830,1713,0,30,17477
2/8/2023,23,10025,414,4743,1259,0,32,16473
2/8/2023,24,10026,394,4595,1212,0,25,16252
2/9/2023,1,10024,189,4308,1297,0,20,15838
2/9/2023,2,10026,176,4186,1241,0,20,15649
2/9/2023,3,10021,202,4573,1172,0,20,15988
2/9/2023,4,10025,301,4431,1350,0,20,16127
2/9/2023,5,10028,407,3940,1281,0,20,15676
2/9/2023,6,9952,521,4035,1131,0,22,15661
2/9/2023,7,9940,512,4264,1628,0,24,16368
2/9/2023,8,9939,513,4857,2291,1,30,17631
2/9/2023,9,9945,520,5010,2417,8,30,17930
2/9/2023,10,9945,517,5507,2670,19,30,18688
2/9/2023,11,10000,598,5698,2765,22,32,19115
2/9/2023,12,10040,532,5073,2986,38,31,18700
2/9/2023,13,10025,325,4680,2865,36,31,17962
2/9/2023,14,10027,171,4694,2877,38,31,17838
2/9/2023,15,10028,257,4621,2563,95,32,17596
2/9/2023,16,10029,296,4698,2544,84,32,17683
2/9/2023,17,10031,350,5097,3093,14,33,18618
2/9/2023,18,10029,445,5621,3076,1,33,19205
2/9/2023,19,10022,429,5020,3159,0,33,18663
2/9/2023,20,10034,351,4557,2999,0,30,17971
2/9/2023,21,10034,352,4633,3161,0,21,18201
2/9/2023,22,10030,452,4430,3261,0,22,18195
2/9/2023,23,10031,363,4123,3300,0,22,17839
2/9/2023,24,10036,268,4050,3005,0,22,17381
2/10/2023,1,10039,266,3904,3212,0,22,17443
2/10/2023,2,10038,132,3853,3419,0,22,17464
2/10/2023,3,10030,126,3972,3037,0,22,17187
2/10/2023,4,10034,126,3852,3212,0,22,17246
2/10/2023,5,10030,126,3816,3305,0,22,17299
2/10/2023,6,10024,125,4045,3336,0,22,17552
2/10/2023,7,10024,129,4696,3495,0,39,18383
2/10/2023,8,10028,134,4993,3396,0,67,18618
2/10/2023,9,10022,135,5245,3100,11,84,18597
2/10/2023,10,10017,242,5389,2942,25,83,18698
2/10/2023,11,10022,218,4964,3134,31,83,18452
2/10/2023,12,10024,198,4704,3231,54,83,18294
2/10/2023,13,10031,283,4497,3478,78,83,18450
2/10/2023,14,10027,346,4302,3405,104,83,18267
2/10/2023,15,10026,351,4305,3317,113,83,18195
2/10/2023,16,10019,353,4996,3395,92,83,18938
2/10/2023,17,10009,355,5740,3376,40,84,19604
2/10/2023,18,10007,382,5946,3225,5,84,19649
2/10/2023,19,10021,403,5608,3134,0,85,19251
2/10/2023,20,10023,362,5382,3082,0,46,18895
2/10/2023,21,10017,223,5082,3278,0,31,18631
2/10/2023,22,10013,128,4279,3292,0,31,17743
2/10/2023,23,10019,128,4111,3270,0,31,17559
2/10/2023,24,10016,128,4088,3146,0,22,17400
2/11/2023,1,10017,128,4188,2884,0,21,17238
2/11/2023,2,10011,129,4443,2463,0,21,17067
2/11/2023,3,10011,128,4547,2077,0,21,16784
2/11/2023,4,10028,245,4718,1454,0,21,16466
2/11/2023,5,10026,431,4889,915,0,21,16282
2/11/2023,6,10027,476,4548,767,0,21,15839
2/11/2023,7,10033,382,4671,701,0,26,15813
2/11/2023,8,10031,401,5129,701,8,29,16299
2/11/2023,9,10029,474,4906,801,81,30,16321
2/11/2023,10,9888,435,4506,1015,166,30,16040
2/11/2023,11,9213,631,4762,1384,222,30,16242
2/11/2023,12,9213,218,4638,1697,268,30,16064
2/11/2023,13,9195,140,4906,1828,338,30,16437
2/11/2023,14,9196,232,4509,2087,382,30,16436
2/11/2023,15,9194,290,4190,2410,366,29,16479
2/11/2023,16,9197,357,4191,2392,264,29,16430
2/11/2023,17,9192,359,4538,2728,110,29,16956
2/11/2023,18,9192,363,5496,3547,14,29,18641
2/11/2023,19,9205,367,5616,3785,0,30,19003
2/11/2023,20,9204,358,5382,3825,0,31,18800
2/11/2023,21,9204,357,4904,3924,0,32,18421
2/11/2023,22,9205,221,4256,3864,0,32,17578
2/11/2023,23,9209,129,4342,3790,0,32,17502
2/11/2023,24,9202,128,3994,3690,0,24,17038
2/12/2023,1,9204,128,3845,3410,0,23,16610
2/12/2023,2,9206,128,4232,2926,0,23,16515
2/12/2023,3,9204,166,4594,2419,0,22,16405
2/12/2023,4,9206,212,4654,1915,0,22,16009
2/12/2023,5,9206,298,4584,1503,0,22,15613
2/12/2023,6,9201,347,4565,1228,0,22,15363
2/12/2023,7,9206,443,4948,1104,0,26,15727
2/12/2023,8,9205,539,4906,1071,10,29,15760
2/12/2023,9,9205,544,4854,781,125,29,15538
2/12/2023,10,9204,643,4990,332,263,27,15459
2/12/2023,11,9208,664,4847,145,354,14,15232
2/12/2023,12,9207,819,4831,101,385,26,15369
2/12/2023,13,9210,971,4830,133,387,29,15560
2/12/2023,14,9205,1230,4367,242,383,29,15456
2/12/2023,15,9210,1557,4200,336,354,29,15686
2/12/2023,16,9208,1674,4165,315,262,29,15653
2/12/2023,17,9208,1685,4807,313,103,29,16145
2/12/2023,18,9215,1858,5830,413,16,29,17361
2/12/2023,19,9215,2202,5879,608,0,30,17934
2/12/2023,20,9213,1786,5484,779,0,29,17291
2/12/2023,21,9214,882,4700,1153,0,31,15980
2/12/2023,22,9216,581,4432,1593,0,31,15853
2/12/2023,23,9219,418,3893,1833,0,31,15394
2/12/2023,24,9218,162,4342,1645,0,23,15390
2/13/2023,1,9211,129,4322,1714,0,22,15398
2/13/2023,2,9215,129,4001,1795,0,22,15162
2/13/2023,3,9219,129,4375,1658,0,22,15403
2/13/2023,4,9220,155,4345,1730,0,22,15472
2/13/2023,5,9221,213,3761,1816,0,22,15033
2/13/2023,6,9227,304,3771,2033,0,22,15357
2/13/2023,7,9225,525,4159,2200,0,29,16138
2/13/2023,8,9228,535,4543,2778,13,33,17130
2/13/2023,9,9224,543,4547,2704,108,32,17158
2/13/2023,10,9219,551,4399,2507,197,33,16906
2/13/2023,11,9222,401,4717,2190,310,33,16873
2/13/2023,12,9223,379,4370,2231,372,32,16607
2/13/2023,13,9220,307,3939,2554,383,31,16434
2/13/2023,14,9217,329,3720,2654,354,32,16306
2/13/2023,15,9214,366,4198,3007,261,45,17091
2/13/2023,16,9211,376,5074,2682,220,75,17638
2/13/2023,17,9206,483,5562,2479,111,82,17923
2/13/2023,18,9203,728,5764,2319,12,83,18109
2/13/2023,19,9203,613,5705,2177,0,80,17778
2/13/2023,20,9200,627,5816,2026,0,81,17750
2/13/2023,21,9197,578,5529,2171,0,50,17525
2/13/2023,22,9233,280,5169,2063,0,29,16774
2/13/2023,23,9578,151,4141,1941,0,29,15840
2/13/2023,24,9725,132,4002,1691,0,22,15572
2/14/2023,1,9861,131,3972,1631,0,20,15615
2/14/2023,2,9858,131,4352,1542,0,20,15903
2/14/2023,3,9866,132,4528,1325,0,20,15871
2/14/2023,4,9868,131,4416,1091,0,20,15526
2/14/2023,5,9869,196,4563,846,0,20,15494
2/14/2023,6,9865,318,4774,527,0,21,15505
2/14/2023,7,9871,390,5280,579,0,28,16148
2/14/2023,8,9871,371,5557,846,15,32,16692
2/14/2023,9,9869,376,4424,1124,143,52,15988
2/14/2023,10,9869,356,4434,737,276,82,15754
2/14/2023,11,9864,356,4086,824,360,82,15572
2/14/2023,12,9867,356,3988,1259,403,84,15957
2/14/2023,13,9895,213,4167,1290,412,82,16059
2/14/2023,14,9939,130,3952,1457,414,82,15974
2/14/2023,15,9939,218,3965,1083,373,83,15661
2/14/2023,16,9937,295,4465,737,269,83,15786
2/14/2023,17,9936,363,4539,1518,107,82,16545
2/14/2023,18,9937,358,5105,2430,8,84,17922
2/14/2023,19,9940,356,4925,2891,0,43,18155
2/14/2023,20,9941,357,4601,3291,0,31,18221
2/14/2023,21,9935,357,4625,3509,0,30,18456
2/14/2023,22,9926,357,3812,3644,0,30,17769
2/14/2023,23,9927,221,3602,3662,0,30,17442
2/14/2023,24,9932,130,3596,3408,0,23,17089
2/15/2023,1,9938,131,3556,3019,0,21,16665
2/15/2023,2,9965,131,3617,2536,0,21,16270
2/15/2023,3,9964,131,3654,2311,0,21,16081
2/15/2023,4,9964,130,3654,2065,0,21,15834
2/15/2023,5,9963,130,3657,2269,0,21,16040
2/15/2023,6,9961,130,3588,3030,0,21,16730
2/15/2023,7,9963,130,3742,3791,0,26,17652
2/15/2023,8,9981,131,4190,3685,3,32,18022
2/15/2023,9,9985,130,4319,3506,25,33,17998
2/15/2023,10,9982,130,4395,3549,42,32,18130
2/15/2023,11,9977,129,4251,3897,122,32,18408
2/15/2023,12,9977,211,4096,3811,73,32,18200
2/15/2023,13,9979,288,4090,3350,95,32,17834
2/15/2023,14,9986,353,4017,2918,125,32,17431
2/15/2023,15,9989,468,4026,2544,183,32,17242
2/15/2023,16,9984,471,4030,2492,147,32,17156
2/15/2023,17,9989,473,4344,2865,88,32,17791
2/15/2023,18,9999,477,4568,3243,13,32,18332
2/15/2023,19,10004,477,4437,3903,0,32,18853
2/15/2023,20,10005,476,4544,3796,0,32,18853
2/15/2023,21,10003,475,4683,3980,0,31,19172
2/15/2023,22,10005,277,4406,3821,0,31,18540
2/15/2023,23,10004,127,3832,3692,0,31,17686
2/15/2023,24,9990,127,3763,3065,0,25,16970
2/16/2023,1,9993,127,3628,2478,0,20,16246
2/16/2023,2,10012,127,3646,2125,0,20,15930
2/16/2023,3,10005,127,3634,1727,0,20,15513
2/16/2023,4,10009,128,3943,1374,0,20,15474
2/16/2023,5,10014,148,4411,1067,0,20,15660
2/16/2023,6,10008,238,4373,948,0,29,15596
2/16/2023,7,10010,373,4955,733,0,62,16133
2/16/2023,8,10012,745,5932,465,2,94,17250
2/16/2023,9,10010,902,5887,413,30,147,17389
2/16/2023,10,10014,888,5650,549,85,86,17272
2/16/2023,11,10011,879,5414,662,103,75,17144
2/16/2023,12,10013,980,5329,782,103,74,17281
2/16/2023,13,10019,1161,4900,803,138,106,17127
2/16/2023,14,10023,1298,4565,1029,118,130,17163
2/16/2023,15,10026,1315,4479,1378,91,128,17417
2/16/2023,16,10025,1375,4418,1803,49,75,17745
2/16/2023,17,10019,1326,4922,1753,16,75,18111
2/16/2023,18,10020,1174,5666,1893,1,40,18794
2/16/2023,19,10020,1316,6005,1488,0,30,18859
2/16/2023,20,10021,1649,5583,1455,0,37,18745
2/16/2023,21,10018,1284,5401,1422,0,37,18162
2/16/2023,22,10014,969,4955,1435,0,29,17402
2/16/2023,23,9988,387,4811,1530,0,32,16748
2/16/2023,24,9995,173,4407,1559,0,22,16156
2/17/2023,1,10001,177,4360,1521,0,24,16083
2/17/2023,2,10015,267,4740,1439,0,31,16492
2/17/2023,3,10014,282,4468,1491,0,34,16289
2/17/2023,4,10012,189,3981,1477,0,33,15692
2/17/2023,5,10003,199,3971,1467,0,31,15671
2/17/2023,6,10005,207,3854,1476,0,29,15571
2/17/2023,7,10006,329,4367,1604,0,53,16359
2/17/2023,8,10006,715,4754,1697,1,76,17249
2/17/2023,9,10003,981,4909,1640,25,76,17634
2/17/2023,10,9998,1239,5006,1500,54,99,17896
2/17/2023,11,9999,1269,4970,1606,73,77,17994
2/17/2023,12,10005,1233,4756,1600,111,74,17779
2/17/2023,13,10009,1168,4765,1565,121,74,17702
2/17/2023,14,10009,1697,4779,1535,138,74,18232
2/17/2023,15,10016,1952,4833,1480,124,74,18479
2/17/2023,16,10017,2154,4797,1257,117,74,18416
2/17/2023,17,10020,2349,5491,1146,54,74,19134
2/17/2023,18,10015,2575,5853,1061,10,80,19594
2/17/2023,19,10019,2890,5872,905,0,108,19794
2/17/2023,20,10016,2943,5911,713,0,79,19662
2/17/2023,21,10017,2775,5783,641,0,33,19249
2/17/2023,22,10013,2466,5393,628,0,21,18521
2/17/2023,23,10018,2256,4738,923,0,21,17956
2/17/2023,24,10016,1426,3793,1402,0,21,16658
2/18/2023,1,10021,543,3500,2034,0,21,16119
2/18/2023,2,10019,368,3571,2386,0,21,16365
2/18/2023,3,10021,232,3705,2685,0,21,16664
2/18/2023,4,10022,164,3505,3008,0,21,16720
2/18/2023,5,10019,130,3403,3090,0,21,16663
2/18/2023,6,10019,130,3441,3284,0,21,16895
2/18/2023,7,10025,130,3554,3529,0,21,17259
2/18/2023,8,10024,130,3944,3573,9,21,17701
2/18/2023,9,10023,130,4165,3547,72,41,17978
2/18/2023,10,10021,130,4167,3628,168,71,18185
2/18/2023,11,10024,130,4491,3569,195,73,18482
2/18/2023,12,10019,133,4892,3522,222,73,18861
2/18/2023,13,10010,244,4661,3479,210,74,18678
2/18/2023,14,10014,242,4163,3449,208,75,18151
2/18/2023,15,10013,292,3922,3386,190,73,17876
2/18/2023,16,10012,661,3877,3255,147,69,18021
2/18/2023,17,10014,762,4091,2848,66,61,17842
2/18/2023,18,10009,804,4696,2540,12,64,18125
2/18/2023,19,10010,967,5115,2256,0,69,18417
2/18/2023,20,10007,967,4728,2256,0,66,18024
2/18/2023,21,10001,949,4633,2193,0,70,17846
2/18/2023,22,10008,688,4224,2311,0,75,17306
2/18/2023,23,10006,370,3758,2429,0,76,16639
2/18/2023,24,10007,336,3531,2618,0,76,16568
2/19/2023,1,10007,212,3348,2830,0,76,16473
2/19/2023,2,10016,132,3297,2822,0,76,16343
2/19/2023,3,10022,131,3357,2884,0,37,16431
2/19/2023,4,10016,131,3392,2982,0,23,16544
2/19/2023,5,9653,131,3311,3237,0,23,16355
2/19/2023,6,9505,132,3368,3262,0,23,16290
2/19/2023,7,9511,132,3489,3195,0,22,16349
2/19/2023,8,9507,133,3900,3685,5,12,17242
2/19/2023,9,9507,134,4149,3670,35,32,17527
2/19/2023,10,9511,133,4066,3910,95,72,17787
2/19/2023,11,9508,133,4038,3890,202,74,17845
2/19/2023,12,9510,212,3970,3711,260,74,17737
2/19/2023,13,9506,246,3886,3769,315,73,17795
2/19/2023,14,9507,296,3969,3389,288,75,17524
2/19/2023,15,9509,353,3867,3430,241,74,17474
2/19/2023,16,9509,354,3988,3332,143,74,17400
2/19/2023,17,9508,358,4199,3416,88,75,17644
2/19/2023,18,9510,360,4416,3575,14,74,17949
2/19/2023,19,9510,362,4406,3644,0,75,17997
2/19/2023,20,9508,361,4408,3540,0,75,17892
2/19/2023,21,9508,226,4432,3695,0,75,17936
2/19/2023,22,9507,133,4911,3538,0,74,18163
2/19/2023,23,9508,132,3975,3348,0,32,16995
2/19/2023,24,9511,132,4198,2982,0,21,16844
2/20/2023,1,9508,134,3723,2814,0,21,16200
2/20/2023,2,9512,133,3870,2505,0,21,16041
2/20/2023,3,9509,132,4120,2216,0,21,15998
2/20/2023,4,9504,132,4309,1874,0,21,15840
2/20/2023,5,9507,133,4056,1872,0,21,15589
2/20/2023,6,9504,132,3465,1941,0,30,15072
2/20/2023,7,9502,146,3712,1448,0,58,14866
2/20/2023,8,9500,154,3917,1353,7,72,15003
2/20/2023,9,9498,185,4044,1081,48,72,14928
2/20/2023,10,9493,197,4557,811,185,72,15315
2/20/2023,11,9492,213,4590,676,261,72,15304
2/20/2023,12,9493,282,4984,529,306,73,15667
2/20/2023,13,9491,351,4918,521,338,73,15692
2/20/2023,14,9490,627,4485,466,312,73,15453
2/20/2023,15,9495,910,4160,357,339,73,15334
2/20/2023,16,9494,1336,4442,234,174,73,15753
2/20/2023,17,9498,1500,4808,138,59,73,16076
2/20/2023,18,9496,1756,5698,198,17,73,17238
2/20/2023,19,9496,2161,5804,250,0,73,17784
2/20/2023,20,9499,1841,5761,357,0,73,17531
2/20/2023,21,9496,1760,5454,490,0,73,17273
2/20/2023,22,9464,1741,4706,711,0,73,16695
2/20/2023,23,8708,1736,4281,976,0,34,15735
2/20/2023,24,8709,1250,3867,1275,0,21,15122
2/21/2023,1,8713,610,3889,1591,0,21,14824
2/21/2023,2,8708,511,3606,2212,0,21,15058
2/21/2023,3,8714,510,3437,2659,0,21,15341
2/21/2023,4,8712,605,3472,2932,0,21,15742
2/21/2023,5,8714,938,3514,3004,0,21,16191
2/21/2023,6,8714,1549,3474,3031,0,36,16804
2/21/2023,7,8710,1746,4284,3173,0,68,17981
2/21/2023,8,8704,2208,4647,3192,13,76,18840
2/21/2023,9,8705,1856,4800,3435,40,73,18909
2/21/2023,10,8703,1814,4108,3626,99,74,18424
2/21/2023,11,8705,1833,3935,3602,175,73,18323
2/21/2023,12,8708,1529,4040,3343,192,74,17886
2/21/2023,13,8707,918,4060,4008,141,74,17908
2/21/2023,14,8707,719,3855,4427,119,74,17901
2/21/2023,15,8704,785,3901,4200,181,36,17807
2/21/2023,16,8706,1106,4003,3868,127,21,17831
2/21/2023,17,8707,1561,4385,3323,87,21,18084
2/21/2023,18,8707,1820,5569,3003,15,21,19135
2/21/2023,19,8704,2015,5783,2443,0,28,18973
2/21/2023,20,8704,1718,5926,2057,0,61,18466
2/21/2023,21,8704,1674,5860,1644,0,74,17956
2/21/2023,22,8704,1932,5635,1291,0,74,17636
2/21/2023,23,8705,1708,5024,942,0,74,16453
2/21/2023,24,8702,1308,4750,693,0,74,15527
2/22/2023,1,8708,1047,4771,441,0,74,15041
2/22/2023,2,8710,1045,4596,393,0,74,14818
2/22/2023,3,8710,1095,4371,325,0,74,14575
2/22/2023,4,8713,1341,4258,445,0,74,14831
2/22/2023,5,8713,2001,4025,697,0,74,15510
2/22/2023,6,8716,2470,3906,781,0,74,15947
2/22/2023,7,8713,2665,4285,1519,0,74,17256
2/22/2023,8,8714,2625,5073,1812,11,73,18308
2/22/2023,9,8718,2629,4715,1911,37,74,18084
2/22/2023,10,8717,2645,4807,2116,75,48,18408
2/22/2023,11,8714,2327,4424,2378,117,21,17981
2/22/2023,12,8709,2289,4615,2385,111,21,18130
2/22/2023,13,8699,2404,4602,2355,109,21,18190
2/22/2023,14,8694,2418,4551,2552,109,20,18344
2/22/2023,15,8688,1928,4668,2644,86,28,18042
2/22/2023,16,8701,1939,4807,2699,73,62,18281
2/22/2023,17,8696,2002,5144,2814,32,72,18760
2/22/2023,18,8696,2359,5553,2692,3,84,19387
2/22/2023,19,8691,2634,5417,2553,0,103,19398
2/22/2023,20,8695,2436,5394,2457,0,73,19055
2/22/2023,21,8696,2085,5203,2610,0,60,18654
2/22/2023,22,8697,2018,4837,2395,0,20,17967
2/22/2023,23,8697,1728,4261,2399,0,20,17105
2/22/2023,24,8698,1443,4207,2353,0,20,16721
2/23/2023,1,8696,1104,4278,2235,0,19,16332
2/23/2023,2,8699,1046,4117,2023,0,19,15904
2/23/2023,3,8700,790,4023,1879,0,19,15411
2/23/2023,4,8702,681,3997,1729,0,19,15128
2/23/2023,5,8705,871,3803,1689,0,19,15087
2/23/2023,6,8702,1659,3892,1604,0,31,15888
2/23/2023,7,8704,2422,4653,1551,0,64,17394
2/23/2023,8,8708,2786,5470,1365,3,107,18439
2/23/2023,9,8709,3460,5732,1173,25,101,19200
2/23/2023,10,8708,3890,5504,1101,48,12,19263
2/23/2023,11,8707,4245,5642,926,78,12,19610
2/23/2023,12,8704,4550,5284,966,85,12,19601
2/23/2023,13,8709,4768,5082,870,82,12,19523
2/23/2023,14,8711,4962,4897,920,77,12,19579
2/23/2023,15,8716,4976,5034,942,61,12,19741
2/23/2023,16,8708,4488,5207,1297,38,12,19750
2/23/2023,17,8699,3957,5348,1847,17,12,19880
2/23/2023,18,8699,3972,5523,2124,5,18,20341
2/23/2023,19,8710,3725,5679,2268,0,19,20401
2/23/2023,20,8709,3391,5883,2372,0,19,20374
2/23/2023,21,8708,3461,5211,2446,0,20,19846
2/23/2023,22,8708,2812,4813,2451,0,20,18804
2/23/2023,23,8706,2075,4494,2484,0,20,17779
2/23/2023,24,8709,2003,4382,2519,0,20,17633
2/24/2023,1,8709,1776,4295,2482,0,20,17282
2/24/2023,2,8712,1313,4176,2470,0,20,16691
2/24/2023,3,8711,1250,4153,2516,0,20,16650
2/24/2023,4,8708,1528,3996,2467,0,19,16718
2/24/2023,5,8708,1981,3897,2463,0,20,17069
2/24/2023,6,8703,2631,3794,2428,0,27,17583
2/24/2023,7,8700,3305,4917,2271,0,58,19251
2/24/2023,8,8699,4225,5332,1926,9,93,20284
2/24/2023,9,8697,4419,5441,1694,77,105,20433
2/24/2023,10,8701,4216,5445,1446,164,90,20062
2/24/2023,11,8701,3757,5124,1324,266,71,19243
2/24/2023,12,8699,3252,5045,1344,332,71,18743
2/24/2023,13,8697,2848,4939,1397,365,71,18317
2/24/2023,14,8697,2672,4266,1415,342,71,17463
2/24/2023,15,8698,2960,4165,1241,280,71,17415
2/24/2023,16,8699,3388,4431,619,194,71,17402
2/24/2023,17,8693,3630,5234,969,120,71,18717
2/24/2023,18,8704,4055,5985,818,22,71,19655
2/24/2023,19,8704,4907,6088,715,0,71,20485
2/24/2023,20,8702,4799,6122,658,0,71,20352
2/24/2023,21,8699,4632,6100,635,0,71,20137
2/24/2023,22,8699,4493,5767,579,0,73,19611
2/24/2023,23,8700,4438,5250,488,0,73,18949
2/24/2023,24,8694,4109,5085,495,0,72,18455
2/25/2023,1,8703,4056,4720,456,0,75,18010
2/25/2023,2,8703,3679,4248,471,0,73,17174
2/25/2023,3,8705,3599,4202,596,0,78,17180
2/25/2023,4,8704,3506,4231,446,0,76,16963
2/25/2023,5,8703,3558,4188,640,0,79,17168
2/25/2023,6,8703,3403,4154,1086,0,74,17420
2/25/2023,7,8704,3628,4766,1314,0,73,18485
2/25/2023,8,8702,3991,5250,1559,4,73,19579
2/25/2023,9,8704,4097,5346,1478,27,73,19725
2/25/2023,10,8701,4818,5405,863,58,74,19919
2/25/2023,11,8706,5371,4897,490,113,80,19657
2/25/2023,12,8709,4826,4854,401,181,73,19044
2/25/2023,13,8709,4728,4926,426,166,71,19026
2/25/2023,14,8707,4288,4830,544,123,73,18565
2/25/2023,15,8706,3642,4867,547,111,72,17945
2/25/2023,16,8709,3354,4563,497,125,71,17319
2/25/2023,17,8714,3465,5487,366,68,72,18172
2/25/2023,18,8715,4489,5657,374,13,71,19319
2/25/2023,19,8719,4157,5668,558,0,67,19169
2/25/2023,20,8720,3901,5782,670,0,22,19095
2/25/2023,21,8717,4179,5376,943,0,21,19236
2/25/2023,22,8716,3387,4537,1575,0,20,18235
2/25/2023,23,8713,3199,3850,2133,0,20,17915
2/25/2023,24,8715,2571,3140,2320,0,20,16766
2/26/2023,1,8714,1618,3690,2776,0,20,16818
2/26/2023,2,8715,941,3901,2850,0,20,16427
2/26/2023,3,8721,566,3313,3390,0,20,16010
2/26/2023,4,8715,505,3208,3695,0,20,16143
2/26/2023,5,8716,505,3381,3773,0,20,16395
2/26/2023,6,8713,578,3937,3444,0,20,16692
2/26/2023,7,8713,737,4384,3129,0,20,16983
2/26/2023,8,8718,844,4857,2581,8,27,17035
2/26/2023,9,8716,768,4741,2776,57,58,17116
2/26/2023,10,8713,933,4527,2765,145,66,17149
2/26/2023,11,8710,969,4213,2760,275,66,16993
2/26/2023,12,8715,1134,4383,2708,257,66,17263
2/26/2023,13,8721,1222,3806,2666,280,66,16761
2/26/2023,14,8720,1301,3729,2854,302,66,16972
2/26/2023,15,8721,1960,3729,2116,285,66,16877
2/26/2023,16,8721,2477,3725,1499,214,34,16670
2/26/2023,17,8716,2819,3944,1707,129,29,17344
2/26/2023,18,8714,2667,4763,1558,32,34,17768
2/26/2023,19,8712,2742,5414,1307,0,33,18208
2/26/2023,20,8712,2753,5490,972,0,26,17953
2/26/2023,21,8710,2719,5307,898,0,21,17655
2/26/2023,22,8710,2281,5046,743,0,19,16799
2/26/2023,23,8714,2268,4369,715,0,19,16085
2/26/2023,24,8714,1735,3878,856,0,19,15202
2/27/2023,1,8709,1570,4126,709,0,19,15133
2/27/2023,2,8713,1750,4358,573,0,19,15413
2/27/2023,3,8714,1607,4059,794,0,19,15193
2/27/2023,4,8712,1648,3493,1325,0,19,15197
2/27/2023,5,8714,2005,3352,1318,0,19,15408
2/27/2023,6,8718,2555,3512,1421,0,39,16245
2/27/2023,7,8714,2677,3874,2811,0,70,18146
2/27/2023,8,8716,2675,4324,3285,45,71,19116
2/27/2023,9,8716,2677,4207,3364,159,72,19195
2/27/2023,10,8710,2526,4006,2692,206,73,18213
2/27/2023,11,8713,2448,3934,3211,234,72,18612
2/27/2023,12,8710,1881,4133,3289,229,32,18274
2/27/2023,13,8706,1689,4542,3007,224,19,18187
2/27/2023,14,8707,2173,4615,2709,159,19,18382
2/27/2023,15,8704,2076,4331,2741,96,19,17967
2/27/2023,16,8700,1996,4329,2875,48,29,17977
2/27/2023,17,8705,2277,4524,3249,31,60,18846
2/27/2023,18,8712,2301,5216,3452,5,73,19759
2/27/2023,19,8712,2492,5508,3432,0,74,20218
2/27/2023,20,8715,2652,5240,3291,0,83,19981
2/27/2023,21,8717,2691,5043,2900,0,98,19449
2/27/2023,22,8709,2727,4428,2050,0,99,18013
2/27/2023,23,8713,2588,4043,1207,0,84,16635
2/27/2023,24,8707,1075,4284,973,0,88,15127
2/28/2023,1,8701,798,3963,855,0,78,14395
2/28/2023,2,8702,766,3880,717,0,74,14139
2/28/2023,3,8705,544,3472,729,0,74,13524
2/28/2023,4,8699,585,3333,1066,0,74,13757
2/28/2023,5,8709,957,3201,1367,0,74,14308
2/28/2023,6,8710,1514,3141,1649,0,74,15088
2/28/2023,7,8712,2113,3413,2314,0,73,16625
2/28/2023,8,8712,2378,4105,2770,0,76,18041
2/28/2023,9,8711,2403,4650,2915,3,76,18758
2/28/2023,10,8711,2459,4074,3071,11,76,18402
2/28/2023,11,8709,2432,4419,2888,20,74,18542
2/28/2023,12,8701,2451,4361,2715,28,36,18292
2/28/2023,13,8701,2356,4419,2713,42,20,18251
2/28/2023,14,8698,2477,4314,2403,61,21,17974
2/28/2023,15,8701,2256,4044,2133,84,20,17238
2/28/2023,16,8709,1836,4057,1713,75,28,16418
2/28/2023,17,8704,1983,4478,1338,47,62,16612
2/28/2023,18,8707,2600,5407,1178,12,77,17981
2/28/2023,19,8706,2747,5639,1022,0,78,18192
2/28/2023,20,8702,2195,5455,1163,0,75,17590
2/28/2023,21,8705,2138,4872,1304,0,75,17094
2/28/2023,22,8703,1814,4381,1498,0,77,16473
2/28/2023,23,8697,1670,3648,1311,0,75,15401
2/28/2023,24,8696,998,3641,1589,0,75,14999
3/1/2023,1,8703,898,3975,1241,0,33,14850
3/1/2023,2,8704,1036,3984,1058,0,21,14803
3/1/2023,3,8709,1105,3664,1052,0,21,14551
3/1/2023,4,8706,1433,3429,1030,0,21,14619
3/1/2023,5,8705,1929,3472,796,0,22,14924
3/1/2023,6,8706,1802,3741,966,0,27,15242
3/1/2023,7,8704,2213,4279,1440,0,56,16692
3/1/2023,8,8703,2471,4536,1680,9,74,17473
3/1/2023,9,8701,2366,4402,1978,36,78,17561
3/1/2023,10,8701,2379,4189,1812,73,79,17233
3/1/2023,11,8703,1841,4257,1688,158,82,16729
3/1/2023,12,8695,1729,4857,1110,204,83,16678
3/1/2023,13,8692,2391,4764,780,252,88,16967
3/1/2023,14,8692,2294,4672,558,241,80,16537
3/1/2023,15,8701,2460,4604,391,238,77,16471
3/1/2023,16,8702,2812,4704,367,192,70,16847
3/1/2023,17,8703,2813,4911,402,120,69,17018
3/1/2023,18,8708,2891,5457,364,30,70,17520
3/1/2023,19,8705,3209,5523,375,0,70,17882
3/1/2023,20,8703,2896,5609,511,0,67,17786
3/1/2023,21,8707,2567,5509,778,0,66,17627
3/1/2023,22,8657,2075,4768,905,0,68,16473
3/1/2023,23,7916,2493,4589,632,0,75,15705
3/1/2023,24,7913,2113,4383,419,0,78,14906
3/2/2023,1,7917,1695,4185,275,0,77,14149
3/2/2023,2,7914,1373,4183,308,0,76,13854
3/2/2023,3,7913,1364,4156,359,0,45,13837
3/2/2023,4,7917,1487,4173,371,0,26,13974
3/2/2023,5,7912,1827,3921,425,0,25,14110
3/2/2023,6,7917,2045,3781,493,0,26,14262
3/2/2023,7,7913,2566,4675,664,0,31,15849
3/2/2023,8,7909,3516,5121,566,13,64,17189
3/2/2023,9,7912,3825,5310,550,57,91,17745
3/2/2023,10,7912,3715,5147,610,96,93,17573
3/2/2023,11,7900,2891,5051,638,141,93,16714
3/2/2023,12,7897,2818,4876,633,201,92,16517
3/2/2023,13,7896,3380,4478,496,241,93,16584
3/2/2023,14,7892,3388,4343,518,235,92,16468
3/2/2023,15,7894,3433,4151,541,183,86,16288
3/2/2023,16,7890,3042,4342,655,162,85,16176
3/2/2023,17,7890,3171,4885,910,105,83,17044
3/2/2023,18,7892,3243,5271,957,34,81,17478
3/2/2023,19,7895,3800,5749,659,0,77,18180
3/2/2023,20,7899,3957,5546,486,0,77,17965
3/2/2023,21,7900,3946,5390,575,0,78,17889
3/2/2023,22,7898,3328,4908,700,0,77,16911
3/2/2023,23,7900,2802,4514,602,0,89,15907
3/2/2023,24,7907,1940,4212,628,0,75,14762
3/3/2023,1,7910,1505,3976,782,0,72,14245
3/3/2023,2,7902,1340,3782,846,0,74,13944
3/3/2023,3,7906,1422,3973,904,0,33,14238
3/3/2023,4,7905,1711,3931,939,0,20,14506
3/3/2023,5,7909,2167,3666,1187,0,20,14949
3/3/2023,6,7908,2392,3215,1417,0,20,14952
3/3/2023,7,7906,2781,3925,1850,0,25,16487
3/3/2023,8,7909,2793,4591,2054,47,55,17449
3/3/2023,9,7901,2795,4357,1933,138,85,17209
3/3/2023,10,7913,2488,4385,1818,200,95,16899
3/3/2023,11,7916,1740,4543,1941,245,95,16480
3/3/2023,12,7915,1387,4731,2341,253,97,16724
3/3/2023,13,7911,1376,4409,2880,210,95,16881
3/3/2023,14,7911,1382,4180,3169,176,95,16913
3/3/2023,15,7903,1235,4165,3440,139,96,16978
3/3/2023,16,7900,1292,4243,3597,95,98,17225
3/3/2023,17,7896,1190,4759,3656,47,95,17643
3/3/2023,18,7901,1134,4992,3795,8,52,17882
3/3/2023,19,7901,1210,4805,3859,0,40,17815
3/3/2023,20,7898,1123,4684,4027,0,39,17771
3/3/2023,21,7898,1124,5003,3683,0,40,17748
3/3/2023,22,7902,950,4642,3598,0,39,17131
3/3/2023,23,7901,540,4069,3748,0,41,16299
3/3/2023,24,7901,201,3431,3730,0,42,15305
3/4/2023,1,7898,130,3366,3709,0,42,15145
3/4/2023,2,7893,131,3565,3575,0,38,15202
3/4/2023,3,7893,130,3705,3508,0,38,15274
3/4/2023,4,7895,130,3873,3443,0,37,15378
3/4/2023,5,7890,285,3796,3446,0,41,15458
3/4/2023,6,7893,361,3583,3424,0,66,15327
3/4/2023,7,7896,696,3699,3016,0,96,15403
3/4/2023,8,7894,1296,4190,2401,3,101,15885
3/4/2023,9,7896,1988,4519,1599,27,111,16140
3/4/2023,10,7895,2259,4797,1247,81,119,16398
3/4/2023,11,7891,2413,4790,860,138,119,16211
3/4/2023,12,7886,2237,4685,668,184,114,15774
3/4/2023,13,7886,2220,4459,537,221,110,15433
3/4/2023,14,7886,2239,3923,477,251,105,14881
3/4/2023,15,7885,2265,3866,265,247,102,14630
3/4/2023,16,7884,2288,3965,215,189,97,14638
3/4/2023,17,7886,2351,4370,396,115,94,15212
3/4/2023,18,7885,2462,4849,475,34,109,15814
3/4/2023,19,7885,2665,5645,474,0,105,16774
3/4/2023,20,7883,2801,5568,657,0,105,17014
3/4/2023,21,7881,2887,5126,930,0,108,16932
3/4/2023,22,7886,2892,4917,1002,0,97,16794
3/4/2023,23,7889,2895,4072,1116,0,62,16034
3/4/2023,24,7907,2642,3831,1078,0,50,15508
3/5/2023,1,7923,2084,3883,1074,0,48,15012
3/5/2023,2,7930,1780,4050,886,0,48,14694
3/5/2023,3,7942,1615,4044,893,0,47,14541
3/5/2023,4,7952,1544,4010,1048,0,47,14601
3/5/2023,5,7967,1532,3635,1371,0,46,14551
3/5/2023,6,7984,1532,3465,1547,0,44,14572
3/5/2023,7,7998,1701,3618,1617,0,40,14974
3/5/2023,8,7997,1870,4181,1629,15,60,15752
3/5/2023,9,7992,1959,4601,1417,74,100,16143
3/5/2023,10,7993,1958,4575,1268,103,101,15998
3/5/2023,11,8005,1796,4717,906,211,101,15736
3/5/2023,12,8020,1761,4568,772,306,107,15534
3/5/2023,13,8042,1831,4277,772,275,97,15294
3/5/2023,14,8064,1926,4297,819,271,55,15432
3/5/2023,15,8074,1723,4234,722,251,56,15060
3/5/2023,16,8083,1983,4380,601,175,56,15278
3/5/2023,17,8110,2517,4709,508,81,55,15980
3/5/2023,18,8116,2893,5517,445,29,57,17057
3/5/2023,19,8114,3826,5825,340,0,57,18162
3/5/2023,20,8112,4089,5620,388,0,53,18262
3/5/2023,21,8106,3735,5085,452,0,42,17420
3/5/2023,22,8106,3324,4904,489,0,35,16858
3/5/2023,23,8134,3052,4317,542,0,32,16077
3/5/2023,24,8135,2397,4171,595,0,19,15317
3/6/2023,1,8152,1953,4085,776,0,19,14985
3/6/2023,2,8151,1734,3781,894,0,19,14579
3/6/2023,3,8161,1562,3963,776,0,18,14480
3/6/2023,4,8178,1580,3992,808,0,19,14577
3/6/2023,5,8180,1523,3454,1105,0,42,14304
3/6/2023,6,8210,1519,3491,975,0,76,14271
3/6/2023,7,8271,1519,4139,1382,2,90,15403
3/6/2023,8,8271,1530,4910,1698,38,87,16534
3/6/2023,9,8278,1520,4461,1977,129,89,16454
3/6/2023,10,8270,1627,4492,1997,206,80,16672
3/6/2023,11,8250,1605,4370,1822,231,88,16366
3/6/2023,12,8257,1136,4371,1992,212,91,16059
3/6/2023,13,8259,1131,3934,2085,212,90,15711
3/6/2023,14,8377,976,4020,2330,208,89,16000
3/6/2023,15,8491,1090,4376,2385,211,87,16640
3/6/2023,16,8534,1078,4082,2548,162,84,16488
3/6/2023,17,8530,1336,4615,2410,62,83,17036
3/6/2023,18,8481,1394,5029,2475,12,77,17468
3/6/2023,19,8491,1515,4920,2431,0,35,17392
3/6/2023,20,8491,1519,5010,2131,0,26,17177
3/6/2023,21,8490,1534,4758,2075,0,29,16886
3/6/2023,22,8481,1538,4395,2075,0,26,16515
3/6/2023,23,8484,1529,4130,2058,0,26,16227
3/6/2023,24,8490,676,3529,2124,0,25,14844
3/7/2023,1,8482,362,3668,2101,0,28,14641
3/7/2023,2,8502,175,3670,2445,0,33,14825
3/7/2023,3,8681,228,3400,2324,0,28,14661
3/7/2023,4,8720,384,3359,2463,0,27,14953
3/7/2023,5,8738,612,3457,2120,0,34,14961
3/7/2023,6,8887,774,3634,2218,0,32,15545
3/7/2023,7,8884,941,3872,2673,2,33,16405
3/7/2023,8,8887,1007,4227,2872,41,28,17062
3/7/2023,9,8890,994,4230,2733,130,23,17000
3/7/2023,10,8891,1132,4256,2239,230,21,16769
3/7/2023,11,8893,836,4075,2923,321,20,17068
3/7/2023,12,8895,834,3566,3542,405,20,17262
3/7/2023,13,8895,866,3499,3503,416,20,17199
3/7/2023,14,8894,905,3472,3371,415,20,17077
3/7/2023,15,8900,1029,3584,3336,347,20,17216
3/7/2023,16,8899,1327,3701,3021,283,20,17251
3/7/2023,17,8897,1152,4240,3042,168,20,17519
3/7/2023,18,8892,820,4907,3369,54,20,18062
3/7/2023,19,8957,774,4985,3275,1,20,18012
3/7/2023,20,9029,770,5185,3255,0,20,18259
3/7/2023,21,9030,658,5098,3230,0,20,18036
3/7/2023,22,9023,733,4910,3048,0,20,17734
3/7/2023,23,9027,661,4186,3082,0,20,16976
3/7/2023,24,9031,227,3777,3215,0,20,16270
3/8/2023,1,9030,147,3394,3120,0,20,15711
3/8/2023,2,9032,160,3522,3168,0,20,15902
3/8/2023,3,9033,186,3727,2959,0,20,15925
3/8/2023,4,9035,262,3651,2849,0,20,15817
3/8/2023,5,9055,542,3281,2609,0,20,15507
3/8/2023,6,9059,552,3386,2498,0,20,15515
3/8/2023,7,9055,548,4052,2524,0,29,16208
3/8/2023,8,9060,586,4707,2644,48,55,17100
3/8/2023,9,9063,637,4547,2588,178,68,17081
3/8/2023,10,9066,543,4095,2278,322,71,16375
3/8/2023,11,9064,330,3903,1817,409,69,15592
3/8/2023,12,9060,137,3846,1790,416,69,15318
3/8/2023,13,9073,220,3775,2012,401,69,15550
3/8/2023,14,9073,397,3701,1624,387,69,15251
3/8/2023,15,9076,681,3802,1589,418,69,15635
3/8/2023,16,9072,987,4085,1259,354,69,15826
3/8/2023,17,9061,1080,4116,1388,221,70,15936
3/8/2023,18,9071,1084,4611,1980,65,34,16845
3/8/2023,19,9072,1085,5005,2160,1,20,17343
3/8/2023,20,9076,1077,5259,2064,0,20,17496
3/8/2023,21,9077,977,5138,1917,0,20,17129
3/8/2023,22,9077,624,4861,1739,0,20,16321
3/8/2023,23,9080,453,4563,1440,0,20,15556
3/8/2023,24,9091,417,4126,1306,0,20,14960
3/9/2023,1,9088,502,3561,1224,0,20,14395
3/9/2023,2,9097,552,3891,1201,0,20,14761
3/9/2023,3,9098,765,4006,1256,0,20,15145
3/9/2023,4,9091,885,3676,1290,0,20,14962
3/9/2023,5,9089,1285,3409,1266,0,19,15068
3/9/2023,6,9091,1384,3478,1149,0,26,15128
3/9/2023,7,9096,1551,4546,1145,2,57,16397
3/9/2023,8,9098,1783,4991,1014,76,78,17040
3/9/2023,9,9098,1701,4957,614,132,76,16578
3/9/2023,10,9104,1603,4467,509,202,69,15954
3/9/2023,11,9106,1662,4173,475,276,70,15762
3/9/2023,12,9109,1362,4268,573,278,34,15624
3/9/2023,13,9107,1380,3969,617,333,20,15426
3/9/2023,14,9118,1542,3849,511,404,20,15444
3/9/2023,15,9118,1771,3838,427,393,20,15567
3/9/2023,16,9115,2141,3911,220,294,20,15701
3/9/2023,17,9116,2140,4195,491,188,28,16158
3/9/2023,18,9117,2143,4933,577,47,60,16877
3/9/2023,19,9118,2181,5409,738,0,70,17516
3/9/2023,20,9135,2184,5350,1007,0,73,17749
3/9/2023,21,9136,1826,5175,1092,0,74,17303
3/9/2023,22,9133,1328,5160,1192,0,74,16887
3/9/2023,23,9136,1143,4359,1226,0,74,15938
3/9/2023,24,9137,635,4021,1110,0,72,14975
3/10/2023,1,9136,557,4099,1013,0,74,14879
3/10/2023,2,9137,589,4001,1114,0,34,14875
3/10/2023,3,9130,405,3898,1271,0,20,14724
3/10/2023,4,9129,380,3691,1840,0,19,15059
3/10/2023,5,9152,428,3328,1486,0,20,14414
3/10/2023,6,9157,666,3313,1916,0,21,15073
3/10/2023,7,9152,733,3595,2750,2,21,16253
3/10/2023,8,9158,733,3967,3053,23,20,16954
3/10/2023,9,9158,734,4406,3034,67,20,17419
3/10/2023,10,9160,842,4546,2919,121,20,17608
3/10/2023,11,9155,1172,4253,2899,131,20,17630
3/10/2023,12,9153,1190,4249,2779,135,20,17526
3/10/2023,13,9156,1312,4172,2649,155,31,17475
3/10/2023,14,9013,1132,4002,2801,144,58,17150
3/10/2023,15,8687,1166,4086,2932,123,72,17066
3/10/2023,16,8656,1320,3845,3095,91,72,17079
3/10/2023,17,8657,1304,4160,3528,53,72,17774
3/10/2023,18,8655,1300,4567,3453,11,71,18057
3/10/2023,19,8659,1303,5043,3072,0,74,18151
3/10/2023,20,8658,1305,5111,2770,0,75,17919
3/10/2023,21,8658,963,4992,2864,0,74,17551
3/10/2023,22,8652,754,4658,2863,0,73,17000
3/10/2023,23,8656,836,4274,2649,0,88,16503
3/10/2023,24,8655,617,3831,2637,0,78,15818
3/11/2023,1,8653,563,3765,2436,0,78,15495
3/11/2023,2,8653,597,3886,2070,0,79,15285
3/11/2023,3,8658,687,3864,1933,0,95,15237
3/11/2023,4,8660,604,3794,1925,0,79,15062
3/11/2023,5,8658,865,3774,2001,0,94,15392
3/11/2023,6,8661,1129,3392,1988,0,74,15244
3/11/2023,7,8670,1154,3791,1821,0,76,15512
3/11/2023,8,8668,1174,4265,1584,10,70,15771
3/11/2023,9,8666,1345,4503,1355,47,68,15984
3/11/2023,10,8667,1680,4436,1313,135,69,16300
3/11/2023,11,8670,1847,3906,1167,249,70,15909
3/11/2023,12,8676,2012,3785,988,338,70,15869
3/11/2023,13,8673,1761,3680,816,365,70,15365
3/11/2023,14,8673,2101,3466,440,339,85,15104
3/11/2023,15,8676,2169,3509,675,298,79,15406
3/11/2023,16,8686,2173,3779,616,266,36,15556
3/11/2023,17,8682,2193,4284,702,162,33,16056
3/11/2023,18,8679,2218,5190,652,44,20,16803
3/11/2023,19,8658,2515,5785,589,0,19,17566
3/11/2023,20,8655,2769,5634,501,0,19,17578
3/11/2023,21,8661,2617,5360,515,0,19,17172
3/11/2023,22,8672,2284,5053,510,0,19,16538
3/11/2023,23,8677,1710,4471,582,0,20,15460
3/11/2023,24,8682,1558,4066,596,0,20,14922
3/12/2023,1,8691,1383,3892,484,0,20,14470
3/12/2023,2,8708,1389,4256,368,0,20,14741
3/12/2023,3,8713,1437,4278,307,0,20,14755
3/12/2023,4,8706,1488,4261,301,0,20,14776
3/12/2023,5,8701,1476,4270,313,0,20,14780
3/12/2023,6,8700,1492,4134,368,0,36,14730
3/12/2023,7,8703,1541,4251,384,5,66,14950
3/12/2023,8,8704,1544,4060,432,55,69,14864
3/12/2023,9,8698,1545,4623,413,123,71,15473
3/12/2023,10,8701,1541,5056,297,185,69,15849
3/12/2023,11,8701,1541,5012,246,196,70,15766
3/12/2023,12,8699,1541,4678,260,236,34,15448
3/12/2023,13,8701,1645,4527,241,246,19,15379
3/12/2023,14,8700,2176,4411,184,198,19,15688
3/12/2023,15,8703,2333,4423,163,143,19,15784
3/12/2023,16,8702,2413,4494,174,102,30,15915
3/12/2023,17,8700,2305,5027,190,53,53,16328
3/12/2023,18,8699,2267,5326,234,14,52,16592
3/12/2023,19,8703,2269,5640,244,0,50,16906
3/12/2023,20,8714,2270,5316,294,0,51,16645
3/12/2023,21,8553,2214,5061,283,0,51,16162
3/12/2023,22,7892,2508,4941,241,0,51,15633
3/12/2023,23,7887,1897,4714,273,0,51,14822
3/12/2023,24,7888,1438,4591,277,0,51,14245
3/13/2023,1,7893,1279,4135,262,0,53,13622
3/13/2023,2,7892,1253,4320,261,0,52,13778
3/13/2023,3,7892,1433,4281,297,0,51,13954
3/13/2023,4,7890,1895,4146,377,0,51,14359
3/13/2023,5,7894,2470,3724,384,0,51,14523
3/13/2023,6,7892,2828,4441,424,0,51,15636
3/13/2023,7,7888,3766,4893,399,0,51,16997
3/13/2023,8,7884,3876,5336,442,4,55,17597
3/13/2023,9,7882,3909,5374,458,20,57,17700
3/13/2023,10,7888,3989,5526,453,42,74,17972
3/13/2023,11,7893,3777,5191,427,97,56,17441
3/13/2023,12,7890,3224,5028,357,138,53,16690
3/13/2023,13,7890,3141,4900,413,139,53,16536
3/13/2023,14,7890,2881,4757,697,128,53,16406
3/13/2023,15,7886,2492,4633,1034,121,53,16219
3/13/2023,16,7883,2270,4582,1491,105,53,16384
3/13/2023,17,7884,2151,5086,1825,63,53,17062
3/13/2023,18,7885,2169,5426,1939,21,53,17493
3/13/2023,19,7882,2255,5494,1962,0,53,17646
3/13/2023,20,7884,2180,5250,2130,0,53,17497
3/13/2023,21,7884,2139,4943,2062,0,53,17081
3/13/2023,22,7886,2020,4295,2064,0,52,16317
3/13/2023,23,7887,1770,4092,1951,0,52,15752
3/13/2023,24,7888,1078,3956,1983,0,54,14959
3/14/2023,1,7888,429,4056,2156,0,13,14542
3/14/2023,2,7889,439,4324,2111,0,0,14763
3/14/2023,3,7885,359,4137,2238,0,0,14619
3/14/2023,4,7888,470,4049,2511,0,0,14918
3/14/2023,5,7891,866,3901,2684,0,0,15342
3/14/2023,6,7886,940,4121,2882,0,0,15829
3/14/2023,7,7887,1213,4718,2923,0,6,16747
3/14/2023,8,7887,1433,5017,3011,13,38,17399
3/14/2023,9,7887,1636,4918,3154,51,53,17699
3/14/2023,10,7888,1595,4494,3272,112,53,17414
3/14/2023,11,7891,1194,4375,3393,188,53,17094
3/14/2023,12,7896,999,4117,3373,203,54,16642
3/14/2023,13,7888,1049,3966,2989,275,15,16182
3/14/2023,14,7886,1114,3899,3055,326,0,16280
3/14/2023,15,7888,1271,3928,3006,280,0,16373
3/14/2023,16,7885,1415,4051,3190,198,0,16739
3/14/2023,17,7882,1611,4271,3490,115,0,17369
3/14/2023,18,7885,1479,4671,3277,38,0,17350
3/14/2023,19,7881,1392,5401,3031,1,0,17706
3/14/2023,20,7880,1550,5568,2822,0,0,17820
3/14/2023,21,7883,1238,5268,2592,0,0,16981
3/14/2023,22,7879,1036,5012,2545,0,0,16472
3/14/2023,23,7880,937,4469,2587,0,0,15873
3/14/2023,24,7884,541,4033,2654,0,0,15112
3/15/2023,1,7890,505,3983,2508,0,0,14886
3/15/2023,2,7890,521,4145,2344,0,0,14900
3/15/2023,3,7894,690,4056,2203,0,0,14843
3/15/2023,4,7895,1110,3974,2186,0,0,15165
3/15/2023,5,7894,1727,3467,2192,0,0,15280
3/15/2023,6,7893,2030,4238,1900,0,0,16061
3/15/2023,7,7896,2685,5018,1612,3,0,17214
3/15/2023,8,7899,2910,5302,1213,103,0,17427
3/15/2023,9,7899,2684,5235,695,262,0,16775
3/15/2023,10,7896,2251,5028,491,383,0,16049
3/15/2023,11,7895,1725,5055,426,403,0,15504
3/15/2023,12,7899,1176,5023,407,424,0,14929
3/15/2023,13,7902,1180,4651,548,418,0,14699
3/15/2023,14,7899,1402,4303,839,413,0,14856
3/15/2023,15,7900,1464,4099,911,399,0,14773
3/15/2023,16,7898,1470,4124,1193,324,0,15009
3/15/2023,17,7906,1469,4511,1268,200,0,15354
3/15/2023,18,7904,1474,5134,1310,61,0,15883
3/15/2023,19,7903,1471,5265,1690,1,0,16330
3/15/2023,20,7903,1473,5061,2032,0,0,16469
3/15/2023,21,7899,1219,4987,2288,0,0,16393
3/15/2023,22,7897,675,4610,2655,0,0,15837
3/15/2023,23,7897,504,4035,2740,0,0,15176
3/15/2023,24,7901,504,4061,2620,0,0,15086
3/16/2023,1,7897,564,4093,2649,0,0,15203
3/16/2023,2,7899,508,3965,2600,0,0,14972
3/16/2023,3,7898,637,3848,2491,0,4,14878
3/16/2023,4,7895,839,3911,2239,0,0,14884
3/16/2023,5,7899,1213,3641,2112,0,14,14879
3/16/2023,6,7895,1416,3676,2181,0,45,15213
3/16/2023,7,7900,1704,4301,2158,2,53,16118
3/16/2023,8,7900,1772,4534,2128,36,51,16421
3/16/2023,9,7897,1946,4912,1922,107,51,16835
3/16/2023,10,7898,1734,4698,1946,217,51,16544
3/16/2023,11,7900,1317,4776,2082,242,52,16369
3/16/2023,12,7897,1242,4559,2188,248,52,16186
3/16/2023,13,7895,1194,4318,2341,336,21,16105
3/16/2023,14,7890,1276,4011,2341,305,0,15823
3/16/2023,15,7894,1474,3891,2428,277,0,15964
3/16/2023,16,7891,1926,4061,2406,190,0,16474
3/16/2023,17,7896,1952,4337,2374,87,0,16646
3/16/2023,18,7898,1958,4608,2167,29,0,16660
3/16/2023,19,7897,1967,4682,2412,0,0,16958
3/16/2023,20,7900,1925,4623,2476,0,0,16924
3/16/2023,21,7900,1104,4627,3003,0,0,16634
3/16/2023,22,7901,531,4234,3280,0,0,15946
3/16/2023,23,7900,164,4010,3252,0,0,15326
3/16/2023,24,7892,133,3500,3313,0,0,14838
3/17/2023,1,7882,132,3386,3485,0,0,14885
3/17/2023,2,7880,133,3133,3508,0,0,14654
3/17/2023,3,7881,231,3062,3485,0,0,14659
3/17/2023,4,7891,372,3250,3628,0,0,15141
3/17/2023,5,7890,539,2968,3556,0,0,14953
3/17/2023,6,7895,540,3112,3510,0,22,15079
3/17/2023,7,7897,540,3911,3750,0,51,16149
3/17/2023,8,7900,542,4227,4107,3,51,16830
3/17/2023,9,7899,542,4494,4183,12,53,17183
3/17/2023,10,7901,677,4712,4173,30,60,17553
3/17/2023,11,7901,875,4672,4153,42,61,17704
3/17/2023,12,7900,742,4443,4232,48,61,17426
3/17/2023,13,7903,588,4123,4347,49,55,17065
3/17/2023,14,7899,215,3914,4300,47,54,16429
3/17/2023,15,7901,129,3743,4447,52,51,16323
3/17/2023,16,7898,214,4123,4509,36,50,16830
3/17/2023,17,7898,284,4311,4337,23,50,16903
3/17/2023,18,7893,357,4442,4407,11,12,17122
3/17/2023,19,7893,353,4614,4172,0,0,17032
3/17/2023,20,7895,354,4863,3875,0,0,16987
3/17/2023,21,7897,356,4876,3716,0,0,16845
3/17/2023,22,7898,355,4425,3712,0,0,16390
3/17/2023,23,7902,355,4067,3756,0,0,16080
3/17/2023,24,7902,218,4063,3580,0,0,15763
3/18/2023,1,7902,125,4078,3330,0,0,15435
3/18/2023,2,7907,131,4133,3000,0,0,15171
3/18/2023,3,7907,191,4123,2993,0,0,15214
3/18/2023,4,7911,133,3378,3347,0,0,14769
3/18/2023,5,7908,124,3320,3018,0,0,14370
3/18/2023,6,7908,125,3609,3002,0,0,14644
3/18/2023,7,7908,125,4045,3074,2,0,15154
3/18/2023,8,7903,125,3980,3387,50,0,15445
3/18/2023,9,7905,125,3944,3637,149,0,15760
3/18/2023,10,7901,125,3825,3624,243,0,15718
3/18/2023,11,7907,125,4016,3855,281,0,16184
3/18/2023,12,7902,161,4376,3912,248,0,16599
3/18/2023,13,7897,198,3840,4152,201,16,16304
3/18/2023,14,7893,126,3665,4278,217,47,16226
3/18/2023,15,7901,126,3533,4232,213,51,16056
3/18/2023,16,7903,126,3666,4194,173,51,16113
3/18/2023,17,7904,126,4084,4343,118,51,16626
3/18/2023,18,7902,126,4240,4319,40,51,16678
3/18/2023,19,7902,127,4610,4270,3,26,16938
3/18/2023,20,7909,126,4686,4226,1,0,16948
3/18/2023,21,7908,126,4529,4267,1,0,16831
3/18/2023,22,7911,126,4233,4324,1,0,16595
3/18/2023,23,7916,126,3765,4344,1,0,16152
3/18/2023,24,7913,127,3896,4355,1,0,16292
3/19/2023,1,7913,127,3954,4402,1,0,16397
3/19/2023,2,7910,127,3679,4360,1,0,16077
3/19/2023,3,7915,128,3844,4213,1,0,16101
3/19/2023,4,7915,182,4044,3931,1,0,16073
3/19/2023,5,7911,203,4008,3798,1,0,15921
3/19/2023,6,7908,287,4096,3799,1,0,16091
3/19/2023,7,7904,311,3887,3807,7,0,15916
3/19/2023,8,7903,334,4385,3690,76,0,16388
3/19/2023,9,7911,331,4081,3771,182,0,16276
3/19/2023,10,7910,331,3929,3519,289,0,15978
3/19/2023,11,7913,331,3964,3515,315,0,16038
3/19/2023,12,7904,332,4033,3687,343,2,16301
3/19/2023,13,7900,332,3753,3515,353,1,15854
3/19/2023,14,7902,333,3557,3458,353,9,15612
3/19/2023,15,7901,337,3624,3536,357,42,15797
3/19/2023,16,7903,416,3768,3569,300,52,16008
3/19/2023,17,7904,489,3985,3694,204,51,16327
3/19/2023,18,7900,545,4080,3832,70,51,16478
3/19/2023,19,7901,548,4442,3827,4,52,16774
3/19/2023,20,7901,548,4680,3921,0,53,17103
3/19/2023,21,7909,548,4264,4065,0,53,16839
3/19/2023,22,7908,552,3870,4160,0,53,16543
3/19/2023,23,7914,405,3426,4107,0,53,15905
3/19/2023,24,7912,267,3218,4271,0,10,15678
3/20/2023,1,7911,245,3512,4265,0,0,15933
3/20/2023,2,7909,245,3577,4238,0,0,15969
3/20/2023,3,7932,241,3529,4198,0,0,15900
3/20/2023,4,8103,306,3169,4053,0,0,15631
3/20/2023,5,8098,366,3287,3889,0,6,15646
3/20/2023,6,8097,449,3910,3896,0,37,16389
3/20/2023,7,8097,504,4717,3875,9,53,17255
3/20/2023,8,8095,581,4781,3697,101,54,17309
3/20/2023,9,8090,527,4299,3576,249,52,16793
3/20/2023,10,8101,565,3929,3545,370,53,16563
3/20/2023,11,8168,560,3912,3405,415,17,16477
3/20/2023,12,8322,407,3706,3844,403,0,16682
3/20/2023,13,8447,400,3731,3951,400,0,16929
3/20/2023,14,8578,467,3550,3959,395,0,16949
3/20/2023,15,8578,469,3444,3843,375,6,16715
3/20/2023,16,8573,526,3574,3566,308,37,16584
3/20/2023,17,8584,621,3961,3714,190,51,17121
3/20/2023,18,8593,574,4575,3596,55,51,17444
3/20/2023,19,8591,554,4590,3502,3,51,17291
3/20/2023,20,8594,419,4842,3422,0,52,17329
3/20/2023,21,8587,326,4564,3368,0,53,16898
3/20/2023,22,8575,374,4328,3118,0,51,16446
3/20/2023,23,8584,464,4320,2470,0,52,15890
3/20/2023,24,8588,484,4067,2445,0,55,15639
3/21/2023,1,8596,292,3429,2482,0,7,14806
3/21/2023,2,8688,340,3229,2649,0,0,14906
3/21/2023,3,8695,421,3192,2624,0,0,14932
3/21/2023,4,8693,640,3248,2268,0,0,14849
3/21/2023,5,8693,1019,3244,2381,0,9,15346
3/21/2023,6,8696,1804,3678,2271,0,43,16492
3/21/2023,7,8699,2536,4414,2020,4,56,17729
3/21/2023,8,8697,2718,4704,1682,55,60,17916
3/21/2023,9,8660,2058,4525,1252,171,54,16720
3/21/2023,10,8631,1963,3907,970,292,53,15816
3/21/2023,11,8506,1900,4085,814,375,53,15733
3/21/2023,12,8665,1356,3996,753,387,55,15212
3/21/2023,13,8707,1041,3976,868,330,54,14976
3/21/2023,14,8703,1271,3960,838,337,53,15162
3/21/2023,15,8702,1414,4156,699,292,53,15316
3/21/2023,16,8696,1473,4201,705,212,54,15341
3/21/2023,17,8703,1627,4457,539,144,53,15523
3/21/2023,18,8703,1608,4988,525,51,53,15928
3/21/2023,19,8707,1664,5307,705,3,53,16439
3/21/2023,20,8706,1727,5229,1016,0,53,16731
3/21/2023,21,8709,1564,4492,1293,0,53,16111
3/21/2023,22,8710,1067,4164,1539,0,53,15533
3/21/2023,23,8706,377,3774,1601,0,53,14511
3/21/2023,24,8703,291,3788,1853,0,53,14688
3/22/2023,1,8705,258,3536,2141,0,53,14693
3/22/2023,2,8705,252,3161,2415,0,53,14586
3/22/2023,3,8712,252,3181,2484,0,53,14682
3/22/2023,4,8711,371,3559,2204,0,53,14898
3/22/2023,5,8709,669,3979,1747,0,66,15170
3/22/2023,6,8710,1521,4109,1557,0,77,15974
3/22/2023,7,8707,1846,4336,1477,7,62,16435
3/22/2023,8,8708,1802,4104,1844,51,55,16564
3/22/2023,9,8705,1699,4264,1843,126,51,16688
3/22/2023,10,8709,1757,4298,1874,202,61,16901
3/22/2023,11,8706,1650,4147,2086,237,59,16885
3/22/2023,12,8704,1124,4078,2411,193,57,16567
3/22/2023,13,8708,914,3901,2556,199,52,16330
3/22/2023,14,8709,1007,4048,2560,183,49,16556
3/22/2023,15,8707,933,4005,2702,120,50,16517
3/22/2023,16,8704,1095,4216,2707,59,55,16836
3/22/2023,17,8704,1114,4137,2755,27,53,16790
3/22/2023,18,8704,785,4030,2632,8,50,16209
3/22/2023,19,8706,756,4438,2608,0,50,16558
3/22/2023,20,8704,751,4311,2503,0,50,16319
3/22/2023,21,8705,747,4073,2688,0,50,16263
3/22/2023,22,8710,240,3683,2760,0,50,15443
3/22/2023,23,8709,126,3326,2688,0,50,14899
3/22/2023,24,8701,126,3141,2865,0,14,14847
3/23/2023,1,8706,126,3423,2851,0,0,15106
3/23/2023,2,8706,127,3501,2939,0,0,15273
3/23/2023,3,8707,128,3338,2793,0,0,14966
3/23/2023,4,8710,331,3453,2726,0,0,15220
3/23/2023,5,8620,581,3302,2545,0,0,15048
3/23/2023,6,8606,1050,3753,2139,0,0,15548
3/23/2023,7,8607,1647,4185,2102,0,0,16541
3/23/2023,8,8607,1595,4308,2477,4,0,16991
3/23/2023,9,8606,1423,4321,2454,16,0,16820
3/23/2023,10,8609,1388,4399,2421,34,0,16851
3/23/2023,11,8644,1572,4613,1854,82,1,16766
3/23/2023,12,8717,1505,4371,1914,87,0,16594
3/23/2023,13,8722,1346,4641,2117,74,0,16900
3/23/2023,14,8722,1298,4472,2410,85,0,16987
3/23/2023,15,8720,1304,4092,2524,83,1,16724
3/23/2023,16,8718,1409,4033,2428,75,0,16663
3/23/2023,17,8717,1690,3942,2291,67,4,16711
3/23/2023,18,8715,1720,4224,2076,35,39,16809
3/23/2023,19,8721,1849,4788,1771,2,54,17185
3/23/2023,20,8726,2110,4681,1678,0,51,17246
3/23/2023,21,8722,1774,4630,1524,0,52,16702
3/23/2023,22,8720,1217,4348,1420,0,53,15758
3/23/2023,23,8724,732,3946,1312,0,52,14766
3/23/2023,24,8725,626,3682,1265,0,51,14349
3/24/2023,1,8728,526,3332,1219,0,51,13856
3/24/2023,2,8726,511,3267,1059,0,51,13614
3/24/2023,3,8731,806,3290,816,0,47,13690
3/24/2023,4,8736,1161,3218,653,0,0,13768
3/24/2023,5,8733,1820,3533,550,0,0,14636
3/24/2023,6,8732,2036,4255,535,0,0,15558
3/24/2023,7,8731,2392,5034,518,6,0,16681
3/24/2023,8,8726,2542,5116,505,57,17,16963
3/24/2023,9,8724,2425,4996,566,145,48,16904
3/24/2023,10,8718,2074,4699,443,266,53,16253
3/24/2023,11,8722,1942,4192,324,339,53,15572
3/24/2023,12,8724,1643,4199,232,362,53,15213
3/24/2023,13,8728,1585,3972,181,399,53,14918
3/24/2023,14,8726,1746,3663,225,394,53,14807
3/24/2023,15,8731,1616,3566,347,368,53,14681
3/24/2023,16,8730,1423,3899,353,255,53,14713
3/24/2023,17,8732,1671,4475,387,169,53,15487
3/24/2023,18,8735,1570,4832,456,60,53,15706
3/24/2023,19,8734,1702,5256,550,3,57,16302
3/24/2023,20,8737,1637,5004,704,0,53,16135
3/24/2023,21,8737,1638,4988,938,0,51,16352
3/24/2023,22,8731,1208,4306,1366,0,51,15662
3/24/2023,23,8730,800,3600,1597,0,51,14778
3/24/2023,24,8730,201,3318,2118,0,51,14418
3/25/2023,1,8735,126,3046,2579,0,51,14537
3/25/2023,2,8736,126,3024,2632,0,51,14569
3/25/2023,3,8732,126,3009,3170,0,14,15051
3/25/2023,4,8734,127,3027,3743,0,0,15631
3/25/2023,5,8726,126,3171,3751,0,0,15774
3/25/2023,6,8730,126,3226,3683,0,0,15765
3/25/2023,7,8727,127,3554,4062,3,0,16473
3/25/2023,8,8725,141,3948,3993,22,20,16849
3/25/2023,9,8725,236,4225,4017,37,55,17295
3/25/2023,10,8725,538,4693,3680,58,80,17774
3/25/2023,11,8721,722,4538,3565,74,88,17708
3/25/2023,12,8727,530,3595,3727,63,54,16696
3/25/2023,13,8728,411,3392,3490,57,53,16131
3/25/2023,14,8731,335,3273,3893,92,12,16336
3/25/2023,15,8733,431,3761,3705,103,0,16733
3/25/2023,16,8735,427,4136,3441,45,0,16784
3/25/2023,17,8733,522,4078,3555,66,0,16954
3/25/2023,18,8738,406,3593,3038,22,0,15797
3/25/2023,19,8737,130,3760,2855,1,0,15483
3/25/2023,20,8738,126,3751,2670,0,0,15285
3/25/2023,21,8735,125,3727,2897,0,0,15484
3/25/2023,22,8278,125,3432,3735,0,0,15570
3/25/2023,23,8290,126,3072,3722,0,0,15210
3/25/2023,24,8308,125,3001,3837,0,0,15271
3/26/2023,1,8308,126,2918,3623,0,0,14975
3/26/2023,2,8308,126,2913,3741,0,0,15088
3/26/2023,3,8306,126,2750,3703,0,0,14885
3/26/2023,4,8309,126,2776,3653,0,0,14864
3/26/2023,5,8315,142,2793,3453,0,0,14703
3/26/2023,6,8312,212,2893,3047,0,0,14464
3/26/2023,7,8316,282,3591,3030,4,0,15223
3/26/2023,8,8383,351,3692,2779,58,0,15263
3/26/2023,9,8457,351,4430,2508,154,0,15900
3/26/2023,10,8467,357,4226,2347,232,0,15629
3/26/2023,11,8466,373,4139,2117,273,0,15368
3/26/2023,12,8468,386,4190,1818,314,0,15176
3/26/2023,13,8463,660,4525,1693,364,0,15705
3/26/2023,14,8456,1054,3863,1767,399,0,15539
3/26/2023,15,8508,1556,3495,1211,413,0,15183
3/26/2023,16,8619,1748,3639,1360,336,5,15707
3/26/2023,17,8639,1724,3951,1277,197,34,15822
3/26/2023,18,8644,1726,3980,1257,71,53,15731
3/26/2023,19,8641,1729,4222,1034,6,53,15685
3/26/2023,20,8640,1723,4731,653,0,53,15800
3/26/2023,21,8641,1501,4810,386,0,51,15389
3/26/2023,22,8641,1060,4746,347,0,46,14840
3/26/2023,23,8639,901,3922,385,0,15,13862
3/26/2023,24,8641,900,3736,336,0,0,13613
3/27/2023,1,8644,901,3637,382,0,0,13564
3/27/2023,2,8650,901,3739,471,0,0,13761
3/27/2023,3,8694,1001,3641,521,0,0,13857
3/27/2023,4,8712,1202,3027,709,0,0,13650
3/27/2023,5,8713,1489,3372,756,0,0,14330
3/27/2023,6,8715,2107,4332,921,0,0,16075
3/27/2023,7,8714,2231,4694,1139,8,0,16786
3/27/2023,8,8718,2295,4698,1122,39,0,16872
3/27/2023,9,8719,2817,4671,876,59,0,17142
3/27/2023,10,8724,3182,4597,827,75,0,17405
3/27/2023,11,8721,3148,4526,950,105,0,17450
3/27/2023,12,8720,3030,4366,996,109,0,17221
3/27/2023,13,8715,2974,4202,1129,107,0,17127
3/27/2023,14,8714,2799,4148,1160,117,0,16938
3/27/2023,15,8712,2603,4091,1400,133,0,16939
3/27/2023,16,8708,2284,4075,1766,90,0,16923
3/27/2023,17,8707,2553,4339,1619,63,0,17281
3/27/2023,18,8708,2730,4619,1293,30,0,17380
3/27/2023,19,8710,3138,4843,967,2,0,17660
3/27/2023,20,8708,2889,4641,768,0,0,17006
3/27/2023,21,8706,2772,4678,669,0,0,16825
3/27/2023,22,8708,2017,4315,695,0,0,15735
3/27/2023,23,8710,1821,3933,598,0,0,15062
3/27/2023,24,8712,1492,3685,682,0,0,14571
3/28/2023,1,8714,1442,3457,740,0,0,14353
3/28/2023,2,8015,1563,3684,645,0,0,13907
3/28/2023,3,7908,1960,3632,606,0,0,14106
3/28/2023,4,7896,2148,3658,507,0,0,14209
3/28/2023,5,7883,2970,3801,372,0,0,15026
3/28/2023,6,7887,3288,4360,347,0,0,15882
3/28/2023,7,7889,3650,5167,336,13,0,17055
3/28/2023,8,7892,3479,5111,288,91,10,16871
3/28/2023,9,7890,3124,5025,114,174,1,16328
3/28/2023,10,7891,2708,4729,68,277,0,15673
3/28/2023,11,7890,2488,4184,279,340,0,15181
3/28/2023,12,7887,1886,4074,410,305,0,14562
3/28/2023,13,7888,2128,3948,452,305,1,14722
3/28/2023,14,7887,2126,3779,443,297,0,14532
3/28/2023,15,7888,2100,3629,398,265,8,14288
3/28/2023,16,7886,2259,3911,304,247,32,14639
3/28/2023,17,7887,2372,4345,386,168,51,15209
3/28/2023,18,7887,2343,4774,433,60,52,15549
3/28/2023,19,7893,2375,4983,601,6,54,15912
3/28/2023,20,7890,2400,5107,1019,0,54,16470
3/28/2023,21,7887,2101,4416,1484,0,54,15942
3/28/2023,22,7868,1479,3917,1810,0,24,15098
3/28/2023,23,7888,1202,3524,2079,0,3,14696
3/28/2023,24,7885,975,3086,2269,0,0,14215
3/29/2023,1,7879,933,3449,2181,0,0,14442
3/29/2023,2,7881,943,3743,1959,0,0,14526
3/29/2023,3,7876,1047,3662,1778,0,0,14363
3/29/2023,4,7887,1253,3212,1915,0,0,14267
3/29/2023,5,7902,1562,3327,1806,0,0,14597
3/29/2023,6,7902,1569,3845,2518,0,0,15834
3/29/2023,7,7904,1568,4467,2885,14,0,16838
3/29/2023,8,7903,1399,4324,3000,87,0,16713
3/29/2023,9,7906,1183,3942,3317,175,0,16523
3/29/2023,10,7906,1146,3789,3578,250,0,16669
3/29/2023,11,7902,658,3367,3559,267,0,15753
3/29/2023,12,7906,518,3250,3967,280,0,15921
3/29/2023,13,7911,543,3777,4386,219,0,16836
3/29/2023,14,7912,670,3874,4437,148,0,17041
3/29/2023,15,7899,803,3708,4426,97,0,16933
3/29/2023,16,7883,970,3889,4406,78,22,17248
3/29/2023,17,7897,1137,3706,4315,55,48,17158
3/29/2023,18,7901,1138,3850,4038,38,52,17017
3/29/2023,19,7902,1211,4502,3751,3,53,17422
3/29/2023,20,7898,1470,5002,3096,0,69,17535
3/29/2023,21,7901,1757,4544,2615,0,77,16894
3/29/2023,22,7900,1543,4097,2345,0,56,15941
3/29/2023,23,7896,1234,3930,2142,0,9,15211
3/29/2023,24,7999,927,3700,2079,0,0,14705
3/30/2023,1,8130,1043,3368,1862,0,0,14403
3/30/2023,2,8208,1258,3217,1628,0,0,14311
3/30/2023,3,8300,1678,3411,1309,0,0,14698
3/30/2023,4,8313,2373,3563,878,0,0,15127
3/30/2023,5,8365,2877,3798,506,0,8,15554
3/30/2023,6,8483,3437,4274,341,0,39,16574
3/30/2023,7,8486,3823,4902,343,11,66,17631
3/30/2023,8,8490,3709,4898,326,76,64,17563
3/30/2023,9,8490,3017,4778,351,200,52,16888
3/30/2023,10,8492,2373,4148,487,307,51,15858
3/30/2023,11,8492,1495,4408,782,356,15,15548
3/30/2023,12,8491,1196,4066,1105,386,0,15244
3/30/2023,13,8489,1146,3542,1287,396,0,14860
3/30/2023,14,8491,1148,3591,1321,392,0,14943
3/30/2023,15,8496,1258,3444,1053,379,2,14632
3/30/2023,16,8498,1479,3511,1131,327,0,14946
3/30/2023,17,8525,1770,4038,1210,202,0,15745
3/30/2023,18,8634,1772,4220,1238,81,0,15945
3/30/2023,19,8671,1873,5006,1117,6,0,16673
3/30/2023,20,8669,2116,5270,1070,0,0,17125
3/30/2023,21,8668,2029,4899,1265,0,0,16861
3/30/2023,22,8676,1674,4215,1367,0,0,15932
3/30/2023,23,8678,1131,3896,1365,0,0,15070
3/30/2023,24,8679,687,3746,1425,0,0,14537
3/31/2023,1,8691,426,3236,1704,0,0,14057
3/31/2023,2,8696,368,3359,1517,0,0,13940
3/31/2023,3,8694,420,3577,1387,0,0,14078
3/31/2023,4,8683,703,3850,1249,0,0,14485
3/31/2023,5,8692,1018,3139,1600,0,0,14449
3/31/2023,6,8696,1017,3386,2161,0,0,15260
3/31/2023,7,8696,1107,3835,2529,11,0,16178
3/31/2023,8,8704,1111,4120,3044,30,0,17009
3/31/2023,9,8712,1111,3885,3371,62,0,17141
3/31/2023,10,8714,1114,4454,3267,73,0,17622
3/31/2023,11,8713,1243,4494,2939,80,0,17469
3/31/2023,12,8717,1239,4452,2995,91,0,17494
3/31/2023,13,8715,717,4224,3069,95,0,16820
3/31/2023,14,8715,668,4276,3250,81,0,16990
3/31/2023,15,8712,550,4695,3021,65,0,17043
3/31/2023,16,8715,930,4719,2695,58,0,17117
3/31/2023,17,8719,845,4493,2522,40,0,16619
3/31/2023,18,8717,452,4265,2439,14,0,15887
3/31/2023,19,8719,335,4506,2383,2,0,15945
3/31/2023,20,8714,321,3956,2285,0,0,15276
3/31/2023,21,8712,169,4021,2496,0,0,15398
3/31/2023,22,8710,139,3678,2603,0,0,15130
3/31/2023,23,8711,139,3038,2908,0,0,14796
3/31/2023,24,8710,140,2929,3000,0,0,14779
4/1/2023,1,8715,138,2959,3204,0,0,15016
4/1/2023,2,8723,137,3138,3343,0,0,15341
4/1/2023,3,8721,137,3404,3446,0,0,15708
4/1/2023,4,8716,140,3618,3590,0,0,16064
4/1/2023,5,8715,140,3389,3811,0,0,16055
4/1/2023,6,8719,139,3175,3855,0,0,15888
4/1/2023,7,8722,139,3725,3587,8,0,16181
4/1/2023,8,8724,140,4078,3939,75,0,16956
4/1/2023,9,8724,140,4744,3310,250,0,17168
4/1/2023,10,8714,176,5167,2410,322,0,16789
4/1/2023,11,8715,383,4626,2154,286,0,16164
4/1/2023,12,8717,302,3163,2145,315,0,14642
4/1/2023,13,8721,258,3133,2312,183,0,14607
4/1/2023,14,8719,140,3020,2530,181,0,14590
4/1/2023,15,8718,140,3058,3198,180,0,15294
4/1/2023,16,8721,127,3441,3658,82,0,16029
4/1/2023,17,8710,126,3726,3916,55,0,16533
4/1/2023,18,8710,126,4380,3763,21,0,17000
4/1/2023,19,8704,126,4667,3796,2,0,17295
4/1/2023,20,8705,127,4215,3883,0,0,16930
4/1/2023,21,8712,126,3868,3747,0,0,16453
4/1/2023,22,8706,126,3973,3613,0,0,16418
4/1/2023,23,8710,126,3634,3426,0,0,15896
4/1/2023,24,8705,126,3600,2955,0,0,15386
4/2/2023,1,8698,235,4169,2209,0,0,15311
4/2/2023,2,8704,366,4336,1530,0,0,14936
4/2/2023,3,8708,265,3921,1279,0,0,14173
4/2/2023,4,8708,276,3728,1130,0,0,13842
4/2/2023,5,8712,402,3817,942,0,0,13873
4/2/2023,6,8709,695,4062,675,0,0,14141
4/2/2023,7,8711,839,4585,492,19,0,14646
4/2/2023,8,8711,645,4517,383,123,0,14379
4/2/2023,9,8713,539,4221,400,251,0,14124
4/2/2023,10,8713,539,3767,422,396,0,13837
4/2/2023,11,8714,564,4079,568,419,0,14344
4/2/2023,12,8707,243,3994,641,419,0,14004
4/2/2023,13,8710,243,3719,811,412,0,13895
4/2/2023,14,8712,527,3176,970,410,0,13795
4/2/2023,15,8697,946,3047,886,405,9,13990
4/2/2023,16,8675,959,3281,936,353,42,14246
4/2/2023,17,8677,1001,3862,970,236,53,14799
4/2/2023,18,8675,1097,4543,1160,82,53,15610
4/2/2023,19,8674,1139,4802,1420,19,52,16106
4/2/2023,20,8669,1139,4931,1916,5,53,16713
4/2/2023,21,8669,1137,4255,2122,0,53,16236
4/2/2023,22,8672,465,4176,2268,0,53,15634
4/2/2023,23,8677,327,3818,2334,0,12,15168
4/2/2023,24,8676,279,3786,2497,0,0,15238
4/3/2023,1,8674,136,3961,2618,0,0,15389
4/3/2023,2,8675,165,3622,3049,0,0,15511
4/3/2023,3,8695,143,3133,3616,0,0,15587
4/3/2023,4,8692,141,3142,3265,0,0,15240
4/3/2023,5,8693,163,3094,3275,0,0,15225
4/3/2023,6,8695,287,4036,3454,0,1,16473
4/3/2023,7,8693,571,4717,3323,13,12,17329
4/3/2023,8,8691,514,4581,3506,83,17,17392
4/3/2023,9,8697,491,4721,3323,159,13,17404
4/3/2023,10,8697,479,4841,2691,238,17,16963
4/3/2023,11,8698,740,4928,2307,284,20,16977
4/3/2023,12,8697,1117,4404,2088,264,21,16591
4/3/2023,13,8695,1270,3898,1860,280,16,16019
4/3/2023,14,8695,1362,3848,1439,234,19,15597
4/3/2023,15,8691,1816,4110,1295,216,26,16154
4/3/2023,16,8696,2141,4338,1259,114,53,16601
4/3/2023,17,8693,1847,4530,1215,60,68,16413
4/3/2023,18,8696,1723,4946,1150,15,68,16598
4/3/2023,19,8694,1516,4850,1265,2,59,16386
4/3/2023,20,8692,1565,5145,887,0,51,16340
4/3/2023,21,8681,1574,4610,860,0,54,15779
4/3/2023,22,8683,1779,4275,691,0,72,15500
4/3/2023,23,8685,1371,4053,605,0,52,14766
4/3/2023,24,8682,877,3816,695,0,51,14121
4/4/2023,1,8679,711,3849,561,0,51,13851
4/4/2023,2,8680,923,3551,596,0,51,13801
4/4/2023,3,8680,1143,3435,608,0,51,13917
4/4/2023,4,8685,1426,3570,589,0,51,14321
4/4/2023,5,8683,2021,3775,481,0,51,15011
4/4/2023,6,8682,3055,4178,430,0,53,16398
4/4/2023,7,8681,3764,4538,528,5,66,17582
4/4/2023,8,8673,3449,4372,654,27,69,17244
4/4/2023,9,8675,3233,4230,646,75,68,16927
4/4/2023,10,8671,2631,4161,587,193,62,16305
4/4/2023,11,8675,2294,4052,609,237,71,15938
4/4/2023,12,8674,2176,3862,697,274,69,15752
4/4/2023,13,8679,2021,3681,1065,276,69,15791
4/4/2023,14,8675,1595,3858,1272,248,69,15717
4/4/2023,15,8674,998,3771,1595,215,69,15322
4/4/2023,16,8673,824,3923,1716,175,72,15383
4/4/2023,17,8666,1304,4258,1861,154,31,16274
4/4/2023,18,8671,1248,4247,2457,76,14,16713
4/4/2023,19,8673,1077,4271,3004,33,1,17059
4/4/2023,20,8669,972,4356,3457,13,1,17468
4/4/2023,21,8669,648,3959,3680,0,0,16956
4/4/2023,22,8667,581,3635,3897,0,0,16780
4/4/2023,23,8669,554,3242,3910,0,0,16375
4/4/2023,24,8664,219,3179,4118,0,0,16180
4/5/2023,1,8664,137,2991,4125,0,0,15917
4/5/2023,2,8667,136,3064,4054,0,0,15921
4/5/2023,3,8666,137,3206,3944,0,0,15953
4/5/2023,4,8667,147,3688,3892,0,0,16394
4/5/2023,5,8669,238,3747,3738,0,0,16392
4/5/2023,6,8661,468,4183,3431,0,0,16743
4/5/2023,7,8654,838,4556,3303,2,8,17361
4/5/2023,8,8654,806,4436,3347,23,12,17278
4/5/2023,9,8659,798,4602,3251,50,36,17396
4/5/2023,10,8656,1376,4568,2934,54,78,17666
4/5/2023,11,8657,2039,4519,2773,74,101,18163
4/5/2023,12,8661,2273,4585,2907,64,81,18571
4/5/2023,13,8664,1826,4399,2849,58,77,17873
4/5/2023,14,8663,1808,4601,2411,67,72,17622
4/5/2023,15,8667,2137,4547,1656,39,77,17123
4/5/2023,16,8670,1678,4405,1933,43,70,16799
4/5/2023,17,8668,1666,4626,2322,20,71,17373
4/5/2023,18,8669,1512,4225,2737,17,62,17222
4/5/2023,19,8674,1634,4102,2783,1,57,17251
4/5/2023,20,8667,1343,3839,3626,0,54,17529
4/5/2023,21,8667,1219,3571,3511,0,16,16984
4/5/2023,22,8661,835,3559,3639,0,0,16694
4/5/2023,23,8663,198,3797,3872,0,0,16530
4/5/2023,24,8662,138,3490,3894,0,0,16184
4/6/2023,1,8661,138,3019,3820,0,0,15638
4/6/2023,2,8665,138,2952,3364,0,0,15119
4/6/2023,3,8659,139,3269,3130,0,0,15197
4/6/2023,4,8656,247,3894,2922,0,0,15719
4/6/2023,5,8652,442,4001,2412,0,0,15507
4/6/2023,6,8646,591,4244,2376,0,0,15857
4/6/2023,7,8646,568,4565,2420,12,9,16220
4/6/2023,8,8643,569,4643,2362,53,13,16283
4/6/2023,9,8643,572,4471,2477,99,6,16268
4/6/2023,10,8640,563,4457,2545,172,8,16385
4/6/2023,11,8642,556,4018,2401,222,11,15850
4/6/2023,12,8642,221,3574,2907,254,10,15608
4/6/2023,13,8644,136,3718,3298,246,11,16053
4/6/2023,14,8648,137,3629,3555,262,14,16245
4/6/2023,15,8589,138,3367,3283,249,23,15649
4/6/2023,16,8640,138,3467,3115,196,52,15608
4/6/2023,17,8642,139,3763,2972,135,67,15718
4/6/2023,18,8641,138,4049,3003,61,63,15955
4/6/2023,19,8637,139,4147,3326,11,54,16314
4/6/2023,20,8638,140,4328,3706,3,53,16868
4/6/2023,21,8639,139,4406,3709,3,22,16918
4/6/2023,22,8634,139,4494,3284,2,0,16553
4/6/2023,23,8634,139,4048,3307,0,0,16128
4/6/2023,24,8639,139,3483,3506,0,0,15767
4/7/2023,1,8634,139,3174,3260,0,0,15207
4/7/2023,2,8634,139,3536,2977,0,0,15286
4/7/2023,3,8630,139,3952,2846,0,0,15567
4/7/2023,4,8626,194,4152,2789,0,0,15761
4/7/2023,5,8627,145,3721,2964,0,0,15457
4/7/2023,6,8627,139,4154,2960,0,0,15880
4/7/2023,7,8624,139,4367,2577,22,0,15729
4/7/2023,8,8620,139,4400,2217,143,0,15519
4/7/2023,9,8617,139,4016,2186,276,0,15234
4/7/2023,10,8621,139,3773,2039,371,0,14943
4/7/2023,11,8624,146,4437,1617,415,0,15239
4/7/2023,12,8624,256,4672,1334,412,0,15298
4/7/2023,13,8621,189,4199,1249,416,0,14674
4/7/2023,14,8622,270,3870,1270,415,0,14447
4/7/2023,15,8621,408,3530,1208,394,14,14175
4/7/2023,16,8620,677,3768,983,364,46,14458
4/7/2023,17,8613,924,4451,975,242,51,15256
4/7/2023,18,8613,1024,4751,829,104,51,15372
4/7/2023,19,8615,1084,5201,548,10,51,15509
4/7/2023,20,8607,1194,5450,384,0,50,15685
4/7/2023,21,8607,1276,5357,385,0,48,15673
4/7/2023,22,8604,1272,4959,389,0,0,15224
4/7/2023,23,8604,516,4516,338,0,0,13974
4/7/2023,24,8606,293,4157,253,0,0,13309
4/8/2023,1,8626,236,4289,217,0,0,13368
4/8/2023,2,8632,147,4057,247,0,0,13083
4/8/2023,3,8626,138,4028,218,0,0,13010
4/8/2023,4,8631,172,4100,190,0,0,13093
4/8/2023,5,8634,190,4289,219,0,13,13345
4/8/2023,6,8635,190,4701,301,0,49,13876
4/8/2023,7,8634,186,4808,602,32,53,14315
4/8/2023,8,8628,174,4306,815,155,52,14130
4/8/2023,9,8630,163,4075,980,296,51,14195
4/8/2023,10,8632,156,4215,726,392,51,14172
4/8/2023,11,8628,223,4570,308,402,53,14184
4/8/2023,12,8624,283,4296,294,421,53,13971
4/8/2023,13,8641,215,4095,310,416,52,13729
4/8/2023,14,8645,242,3983,268,402,52,13592
4/8/2023,15,8646,515,3701,259,366,51,13538
4/8/2023,16,8645,774,3782,281,299,51,13832
4/8/2023,17,8646,874,4349,236,179,51,14335
4/8/2023,18,8649,1093,4919,148,90,51,14950
4/8/2023,19,8647,1258,5086,92,28,51,15162
4/8/2023,20,8647,1336,5166,96,9,53,15307
4/8/2023,21,8641,1328,5037,120,0,50,15176
4/8/2023,22,8640,985,4756,187,0,50,14618
4/8/2023,23,8652,637,4126,259,0,50,13724
4/8/2023,24,8665,616,4066,312,0,51,13710
4/9/2023,1,8667,229,4063,325,0,19,13303
4/9/2023,2,8663,192,4124,328,0,0,13307
4/9/2023,3,8668,171,3986,400,0,0,13225
4/9/2023,4,8668,160,3983,434,0,0,13245
4/9/2023,5,8670,175,4040,434,0,0,13319
4/9/2023,6,8670,280,4751,449,0,11,14161
4/9/2023,7,8666,242,4755,534,35,49,14281
4/9/2023,8,8680,162,4540,571,157,51,14161
4/9/2023,9,8683,149,4565,386,299,51,14133
4/9/2023,10,8685,148,4627,388,397,51,14296
4/9/2023,11,8688,148,4313,390,424,51,14014
4/9/2023,12,8685,206,4344,429,430,34,14128
4/9/2023,13,8677,224,4064,472,430,0,13867
4/9/2023,14,8673,272,3887,468,428,0,13728
4/9/2023,15,8673,495,3845,444,419,0,13876
4/9/2023,16,8671,781,4160,451,365,0,14428
4/9/2023,17,8683,898,4105,471,236,0,14393
4/9/2023,18,8696,919,4497,485,110,0,14707
4/9/2023,19,8697,1064,4722,568,12,0,15063
4/9/2023,20,8695,1099,4901,879,1,0,15575
4/9/2023,21,8696,1150,4747,1183,1,0,15777
4/9/2023,22,8695,1065,4346,1444,0,0,15550
4/9/2023,23,8695,896,3802,1689,0,0,15082
4/9/2023,24,8693,317,3563,1888,0,0,14461
4/10/2023,1,8695,144,3478,2007,0,0,14324
4/10/2023,2,8714,142,3336,2042,0,0,14234
4/10/2023,3,8725,141,3698,1910,0,0,14474
4/10/2023,4,8721,319,3857,1757,0,0,14654
4/10/2023,5,8718,629,3816,1818,0,11,14992
4/10/2023,6,8722,964,4131,1784,1,42,15644
4/10/2023,7,8720,968,4514,1698,32,63,15995
4/10/2023,8,8721,881,4688,1469,146,68,15973
4/10/2023,9,8718,878,4525,1152,262,61,15596
4/10/2023,10,8716,868,4513,1118,363,62,15640
4/10/2023,11,8717,867,4170,1129,397,66,15346
4/10/2023,12,8719,1198,4172,1187,418,73,15767
4/10/2023,13,8716,997,4081,1303,420,42,15559
4/10/2023,14,8717,890,3941,1325,414,19,15306
4/10/2023,15,8716,873,4098,1392,393,18,15490
4/10/2023,16,8718,873,4498,1560,319,16,15984
4/10/2023,17,8719,927,4761,1659,206,20,16292
4/10/2023,18,8717,943,4822,1685,78,21,16266
4/10/2023,19,8719,1026,5188,1540,11,7,16491
4/10/2023,20,8717,1351,5102,1649,0,0,16819
4/10/2023,21,8715,1177,4780,1906,0,0,16578
4/10/2023,22,8712,888,4161,2336,0,0,16097
4/10/2023,23,8718,623,3395,2694,0,0,15430
4/10/2023,24,8718,220,3362,2878,0,0,15178
4/11/2023,1,8724,243,3187,3234,0,0,15388
4/11/2023,2,8726,299,3212,2909,0,0,15146
4/11/2023,3,8726,299,3075,3304,0,0,15404
4/11/2023,4,8722,299,3143,3266,0,0,15430
4/11/2023,5,8720,299,3199,3283,0,0,15501
4/11/2023,6,8723,362,3830,3471,0,1,16387
4/11/2023,7,8724,504,4159,3825,21,17,17250
4/11/2023,8,8722,908,3927,3278,93,18,16946
4/11/2023,9,8721,1002,3751,3103,195,12,16784
4/11/2023,10,8718,992,3802,2733,282,11,16538
4/11/2023,11,8725,977,3404,3074,348,18,16546
4/11/2023,12,8726,894,3497,3162,358,24,16661
4/11/2023,13,8648,342,3599,3443,309,24,16365
4/11/2023,14,8723,141,3544,3805,222,24,16459
4/11/2023,15,8713,224,3609,3618,224,24,16412
4/11/2023,16,8708,303,3752,3257,194,27,16241
4/11/2023,17,8720,380,4014,3300,107,27,16548
4/11/2023,18,8719,379,4443,3474,50,22,17087
4/11/2023,19,8718,371,4725,3325,17,6,17162
4/11/2023,20,8715,371,4811,3341,10,0,17248
4/11/2023,21,8719,366,4805,3238,5,0,17133
4/11/2023,22,8723,365,4101,2961,0,0,16150
4/11/2023,23,8722,226,3995,2368,0,0,15311
4/11/2023,24,8719,139,3534,2543,0,0,14935
4/12/2023,1,8720,140,3487,2437,0,0,14784
4/12/2023,2,8726,139,3486,2377,0,0,14728
4/12/2023,3,8733,139,3438,2474,0,0,14784
4/12/2023,4,8732,139,3490,2373,0,0,14734
4/12/2023,5,8734,140,3502,2532,0,0,14908
4/12/2023,6,8733,139,3873,2726,0,4,15475
4/12/2023,7,8729,138,4288,3134,17,17,16323
4/12/2023,8,8728,138,4328,2968,85,21,16268
4/12/2023,9,8720,138,4411,2651,229,22,16171
4/12/2023,10,8721,142,4554,2493,370,26,16306
4/12/2023,11,8719,139,4463,2449,417,24,16211
4/12/2023,12,8723,216,4431,2684,425,27,16506
4/12/2023,13,8722,244,3801,3110,430,21,16328
4/12/2023,14,8724,245,3719,3263,426,18,16395
4/12/2023,15,8724,243,3687,3390,411,26,16481
4/12/2023,16,8723,289,4149,3395,348,24,16928
4/12/2023,17,8726,381,4675,3478,218,24,17502
4/12/2023,18,8722,370,4427,3456,68,16,17059
4/12/2023,19,8726,373,4705,3291,8,1,17104
4/12/2023,20,8719,367,4585,3564,0,0,17235
4/12/2023,21,8715,363,4565,3799,0,0,17442
4/12/2023,22,8721,364,4209,3749,0,0,17043
4/12/2023,23,8724,229,3728,3655,0,0,16336
4/12/2023,24,8720,143,3648,3238,0,0,15749
4/13/2023,1,8723,148,3596,2721,0,0,15188
4/13/2023,2,8726,144,3557,2539,0,0,14966
4/13/2023,3,8728,148,3560,2321,0,0,14757
4/13/2023,4,8718,148,3595,2419,0,0,14880
4/13/2023,5,8718,157,3656,2783,0,0,15314
4/13/2023,6,8720,248,3916,2954,0,8,15846
4/13/2023,7,8725,256,4241,3170,26,24,16442
4/13/2023,8,8722,260,4439,2669,122,27,16239
4/13/2023,9,8723,260,4794,1939,238,20,15974
4/13/2023,10,8666,318,4893,1628,325,17,15847
4/13/2023,11,8536,374,5144,1380,367,27,15828
4/13/2023,12,8534,590,5024,1520,375,22,16065
4/13/2023,13,8650,706,4386,1951,378,18,16089
4/13/2023,14,8714,1005,4294,1586,375,26,16000
4/13/2023,15,8713,1464,4403,1626,356,26,16588
4/13/2023,16,8718,1490,4319,2694,283,25,17529
4/13/2023,17,8718,1488,4499,2652,180,24,17561
4/13/2023,18,8708,1488,4869,2382,70,24,17541
4/13/2023,19,8706,1490,5000,2119,9,17,17341
4/13/2023,20,8704,1488,4854,2217,0,0,17263
4/13/2023,21,8706,1488,4708,2180,0,0,17082
4/13/2023,22,8702,1343,4286,2119,0,0,16450
4/13/2023,23,8708,543,4424,2052,0,0,15727
4/13/2023,24,8714,259,4741,1696,0,0,15410
4/14/2023,1,8720,143,4298,1365,0,0,14526
4/14/2023,2,8721,138,4565,1072,0,0,14496
4/14/2023,3,8725,139,4787,982,0,0,14633
4/14/2023,4,8720,373,4832,870,0,0,14795
4/14/2023,5,8720,792,4396,724,0,0,14632
4/14/2023,6,8717,1308,4823,619,1,2,15470
4/14/2023,7,8723,1415,5235,599,31,22,16025
4/14/2023,8,8716,1398,5191,470,121,23,15919
4/14/2023,9,8719,1391,5007,333,230,18,15698
4/14/2023,10,8723,1443,5372,271,310,17,16136
4/14/2023,11,8725,1477,5304,242,362,25,16135
4/14/2023,12,8723,1712,5358,197,374,24,16388
4/14/2023,13,8721,1379,5382,171,376,23,16052
4/14/2023,14,8722,1275,5430,171,369,23,15990
4/14/2023,15,8714,1471,5610,159,347,24,16325
4/14/2023,16,8710,1644,5642,121,269,21,16407
4/14/2023,17,8712,1867,5782,84,180,22,16647
4/14/2023,18,8712,2007,5868,84,72,20,16763
4/14/2023,19,8717,1824,5955,131,11,0,16638
4/14/2023,20,8717,1783,5897,290,0,0,16687
4/14/2023,21,8708,1741,5801,478,0,0,16728
4/14/2023,22,8718,1725,5269,696,0,0,16408
4/14/2023,23,8712,762,5095,884,0,0,15453
4/14/2023,24,8718,191,5050,783,0,0,14742
4/15/2023,1,8721,139,5029,649,0,0,14538
4/15/2023,2,8720,139,4999,570,0,0,14428
4/15/2023,3,8716,138,4817,622,0,0,14293
4/15/2023,4,8711,140,4747,633,0,0,14231
4/15/2023,5,8716,140,5165,633,0,0,14654
4/15/2023,6,8717,139,5174,614,0,0,14644
4/15/2023,7,8718,140,5002,559,24,0,14443
4/15/2023,8,8712,140,5059,409,101,0,14421
4/15/2023,9,8712,199,5454,265,231,0,14861
4/15/2023,10,8707,270,5732,157,269,0,15135
4/15/2023,11,8709,392,5716,103,282,0,15202
4/15/2023,12,8712,502,5460,93,364,0,15131
4/15/2023,13,8708,590,5026,119,347,0,14790
4/15/2023,14,8710,863,5310,211,340,0,15434
4/15/2023,15,8710,1255,5387,309,323,0,15984
4/15/2023,16,8708,1544,5579,326,252,0,16409
4/15/2023,17,8711,1614,5773,291,159,0,16548
4/15/2023,18,8712,1555,5736,242,73,0,16318
4/15/2023,19,8711,1534,5308,299,12,0,15864
4/15/2023,20,8709,1535,5237,472,0,0,15953
4/15/2023,21,8701,1421,4908,910,0,0,15940
4/15/2023,22,8706,1084,5121,758,0,0,15669
4/15/2023,23,8705,528,4862,699,0,0,14794
4/15/2023,24,8708,188,5148,559,0,0,14603
4/16/2023,1,8713,139,5005,568,0,0,14425
4/16/2023,2,8712,139,4575,975,0,0,14401
4/16/2023,3,8724,139,4202,1112,0,0,14177
4/16/2023,4,8716,139,4396,1115,0,0,14366
4/16/2023,5,8715,140,4364,1208,0,0,14427
4/16/2023,6,8716,221,4274,1299,0,0,14510
4/16/2023,7,8714,371,4581,1276,30,0,14972
4/16/2023,8,8709,488,4484,999,125,0,14805
4/16/2023,9,8715,489,4943,752,215,0,15114
4/16/2023,10,8714,490,5070,864,297,0,15435
4/16/2023,11,8710,486,4889,1257,349,0,15691
4/16/2023,12,8710,545,4590,1841,334,0,16020
4/16/2023,13,8711,623,4561,2008,330,0,16233
4/16/2023,14,8710,502,4641,2053,339,0,16245
4/16/2023,15,8707,371,5279,1869,291,0,16517
4/16/2023,16,8706,543,4598,2561,178,0,16586
4/16/2023,17,8708,766,4672,2653,93,0,16892
4/16/2023,18,8712,891,5022,2840,29,0,17494
4/16/2023,19,8714,894,4843,3290,6,0,17747
4/16/2023,20,8712,889,4729,3403,0,0,17733
4/16/2023,21,8711,726,4741,3531,0,0,17709
4/16/2023,22,8710,688,4305,2773,0,0,16476
4/16/2023,23,8706,595,4243,2334,0,0,15878
4/16/2023,24,8705,322,4159,1944,0,0,15130
4/17/2023,1,8702,142,4069,1826,0,0,14739
4/17/2023,2,8700,200,4008,1821,0,0,14729
4/17/2023,3,8707,294,3976,1170,0,0,14147
4/17/2023,4,8705,352,4093,1221,0,0,14371
4/17/2023,5,8706,352,4340,2087,0,0,15485
4/17/2023,6,8699,416,4492,1981,0,1,15589
4/17/2023,7,8698,561,4459,1962,8,14,15702
4/17/2023,8,8699,720,4541,2191,29,20,16200
4/17/2023,9,8699,794,4659,2385,55,17,16609
4/17/2023,10,8706,813,4904,2678,68,14,17183
4/17/2023,11,8702,894,4897,2807,91,14,17405
4/17/2023,12,8703,1078,4921,2998,118,20,17838
4/17/2023,13,8701,1157,4491,3019,195,21,17584
4/17/2023,14,8695,1345,4411,2361,179,18,17009
4/17/2023,15,8697,1457,4430,2297,112,20,17013
4/17/2023,16,8690,1371,4433,3108,111,19,17732
4/17/2023,17,8688,1481,4749,3006,51,18,17993
4/17/2023,18,8689,1596,4685,3154,22,11,18157
4/17/2023,19,8687,1722,4622,3151,7,0,18189
4/17/2023,20,8692,1725,4574,3365,0,0,18356
4/17/2023,21,8687,1339,4456,3211,0,0,17693
4/17/2023,22,8687,1107,4411,2830,0,0,17035
4/17/2023,23,8691,1106,4228,2449,0,0,16474
4/17/2023,24,8694,794,4221,2528,0,0,16237
4/18/2023,1,8696,402,4355,2659,0,0,16112
4/18/2023,2,8697,137,4212,2853,0,0,15899
4/18/2023,3,8697,255,4198,2734,0,0,15884
4/18/2023,4,8695,363,4330,2678,0,0,16066
4/18/2023,5,8695,498,4449,2678,0,2,16322
4/18/2023,6,8702,528,4350,2809,2,12,16403
4/18/2023,7,8696,577,4833,3285,28,21,17440
4/18/2023,8,8696,716,4989,3175,59,17,17652
4/18/2023,9,8692,746,4952,3350,119,17,17876
4/18/2023,10,8690,748,4951,3397,121,12,17919
4/18/2023,11,8691,772,4789,3569,132,13,17966
4/18/2023,12,8696,775,4723,3636,176,18,18024
4/18/2023,13,8694,754,4560,3588,92,17,17705
4/18/2023,14,8695,552,4548,3561,114,0,17470
4/18/2023,15,8697,442,4700,3375,117,7,17338
4/18/2023,16,8696,732,4776,3118,103,4,17429
4/18/2023,17,8690,966,5171,2876,55,1,17759
4/18/2023,18,8686,1149,5646,2612,16,0,18109
4/18/2023,19,8690,1421,5639,2546,4,0,18300
4/18/2023,20,8682,1247,5604,2280,0,0,17813
4/18/2023,21,8679,1135,5740,2088,0,0,17642
4/18/2023,22,8678,965,5587,1822,0,0,17052
4/18/2023,23,8686,593,4947,1950,0,0,16176
4/18/2023,24,8683,305,4444,2174,0,0,15606
4/19/2023,1,8690,200,4129,2440,0,0,15459
4/19/2023,2,8690,464,4148,2344,0,0,15646
4/19/2023,3,8693,615,4100,2311,0,0,15719
4/19/2023,4,8692,933,4100,2037,0,0,15762
4/19/2023,5,8685,1157,4299,2081,0,0,16222
4/19/2023,6,8686,1344,4623,1797,0,2,16452
4/19/2023,7,8686,1554,5511,1795,21,12,17579
4/19/2023,8,8684,1540,5529,1529,55,20,17357
4/19/2023,9,8681,1485,5443,1231,113,22,16975
4/19/2023,10,8685,1780,5608,704,161,18,16956
4/19/2023,11,8688,1853,5509,410,253,23,16736
4/19/2023,12,8689,1751,5445,410,278,28,16601
4/19/2023,13,8690,1713,5382,493,300,28,16606
4/19/2023,14,8696,1419,5067,606,346,29,16163
4/19/2023,15,8700,1527,4996,250,350,28,15851
4/19/2023,16,8699,1549,5176,408,266,26,16124
4/19/2023,17,8704,1694,5235,459,130,22,16244
4/19/2023,18,8709,1615,5401,420,61,15,16221
4/19/2023,19,8710,1554,5321,567,9,1,16162
4/19/2023,20,8707,1846,5602,654,0,0,16809
4/19/2023,21,8702,1829,5636,542,0,0,16709
4/19/2023,22,8706,1574,5482,446,0,0,16208
4/19/2023,23,8705,1525,4976,713,0,0,15919
4/19/2023,24,8709,1125,4573,1172,0,0,15579
4/20/2023,1,8707,381,4372,1540,0,0,15000
4/20/2023,2,8715,139,4397,1738,0,0,14989
4/20/2023,3,8718,332,4447,1869,0,0,15366
4/20/2023,4,8715,666,4378,1773,0,0,15532
4/20/2023,5,8715,1084,4368,2141,0,0,16308
4/20/2023,6,8718,1217,4536,2566,2,0,17039
4/20/2023,7,8716,1216,4678,3051,37,7,17705
4/20/2023,8,8713,1215,4534,2834,133,14,17443
4/20/2023,9,8715,1217,4481,2767,282,9,17471
4/20/2023,10,8711,1218,4730,1898,330,7,16894
4/20/2023,11,8709,778,4836,2305,385,13,17026
4/20/2023,12,8706,772,5086,2291,369,17,17241
4/20/2023,13,8704,609,4756,2007,371,20,16467
4/20/2023,14,8716,720,4613,1911,375,19,16354
4/20/2023,15,8713,858,4677,2081,333,22,16684
4/20/2023,16,8711,1269,5410,1657,258,21,17326
4/20/2023,17,8706,1615,5340,1964,134,17,17776
4/20/2023,18,8708,1522,4659,2118,53,12,17072
4/20/2023,19,8706,1271,4598,2493,9,2,17079
4/20/2023,20,8703,1238,4679,2845,0,0,17465
4/20/2023,21,8712,1236,4645,3131,0,0,17724
4/20/2023,22,8712,900,4806,3113,0,0,17531
4/20/2023,23,8708,406,4600,3181,0,0,16895
4/20/2023,24,8711,157,4454,3065,0,0,16387
4/21/2023,1,8705,157,4232,2860,0,0,15954
4/21/2023,2,8709,157,4297,2461,0,0,15624
4/21/2023,3,8716,158,4679,2168,0,0,15721
4/21/2023,4,8715,365,4733,1902,0,0,15715
4/21/2023,5,8716,494,4459,1987,0,0,15656
4/21/2023,6,8714,765,4599,1910,3,0,15991
4/21/2023,7,8716,696,4945,1841,29,7,16234
4/21/2023,8,8716,901,4784,1573,118,12,16104
4/21/2023,9,8710,969,5329,1068,212,10,16298
4/21/2023,10,8713,1224,5519,807,263,9,16535
4/21/2023,11,8707,1225,4807,1123,322,11,16195
4/21/2023,12,8711,1225,4603,1463,324,16,16342
4/21/2023,13,8712,1225,4714,1340,298,18,16307
4/21/2023,14,8713,936,5184,1072,284,19,16208
4/21/2023,15,8710,874,5504,948,255,17,16308
4/21/2023,16,8712,1193,5639,833,171,11,16559
4/21/2023,17,8713,1248,5383,822,130,11,16307
4/21/2023,18,8712,1229,5246,582,57,6,15832
4/21/2023,19,8708,1234,5389,482,9,0,15822
4/21/2023,20,8710,1308,5712,197,0,0,15927
4/21/2023,21,8711,1388,5542,435,0,0,16076
4/21/2023,22,8713,1227,5303,577,0,0,15820
4/21/2023,23,8716,997,5330,365,0,0,15408
4/21/2023,24,8715,921,5397,252,0,0,15285
4/22/2023,1,8721,386,5540,291,0,0,14938
4/22/2023,2,8720,185,5380,363,0,0,14648
4/22/2023,3,8716,266,5330,372,0,0,14684
4/22/2023,4,8718,373,5315,354,0,0,14760
4/22/2023,5,8712,514,5361,534,0,0,15121
4/22/2023,6,8708,504,5208,889,0,0,15309
4/22/2023,7,8710,505,4936,979,21,0,15151
4/22/2023,8,8711,513,5431,905,69,0,15629
4/22/2023,9,8707,784,5983,894,120,0,16488
4/22/2023,10,8709,871,5836,889,147,0,16452
4/22/2023,11,8711,976,5542,922,192,0,16343
4/22/2023,12,8708,956,5268,913,214,0,16059
4/22/2023,13,8711,962,4888,1190,171,0,15922
4/22/2023,14,8712,1003,4724,1491,127,0,16057
4/22/2023,15,8712,1145,5034,1555,112,0,16558
4/22/2023,16,8707,1187,5580,1250,81,0,16805
4/22/2023,17,8706,1164,5667,1218,84,0,16839
4/22/2023,18,8705,1138,5299,1194,51,0,16387
4/22/2023,19,8708,1139,5328,1184,8,0,16367
4/22/2023,20,8710,1142,5806,1061,0,0,16719
4/22/2023,21,8708,1156,5752,1110,0,0,16726
4/22/2023,22,8720,609,5138,1478,0,0,15945
4/22/2023,23,8712,507,5129,1363,0,0,15711
4/22/2023,24,8708,313,5154,1193,0,0,15368
4/23/2023,1,8709,151,4609,1335,0,0,14804
4/23/2023,2,8705,279,4321,1387,0,0,14692
4/23/2023,3,8705,380,4362,1394,0,0,14841
4/23/2023,4,8703,507,4491,1353,0,0,15054
4/23/2023,5,8705,506,4748,1211,0,0,15170
4/23/2023,6,8705,496,5259,1062,1,0,15523
4/23/2023,7,8704,502,5620,1033,26,0,15885
4/23/2023,8,8704,521,5982,829,80,0,16116
4/23/2023,9,8701,517,5831,833,160,0,16042
4/23/2023,10,8702,501,5313,844,223,0,15583
4/23/2023,11,8699,502,5775,997,215,0,16188
4/23/2023,12,8706,498,5857,1354,216,0,16631
4/23/2023,13,8707,555,5395,1434,184,0,16275
4/23/2023,14,8706,644,5561,1274,212,0,16397
4/23/2023,15,8705,1014,5835,1140,182,0,16876
4/23/2023,16,8703,1262,5900,975,93,0,16933
4/23/2023,17,8702,1557,5819,832,59,0,16969
4/23/2023,18,8709,1448,5585,858,34,0,16634
4/23/2023,19,8712,1405,5703,773,8,0,16601
4/23/2023,20,8712,1407,5632,622,0,0,16373
4/23/2023,21,8705,1441,6065,472,0,0,16683
4/23/2023,22,8714,1079,5848,468,0,0,16109
4/23/2023,23,8712,658,5775,446,0,0,15591
4/23/2023,24,8716,567,5460,338,0,0,15081
4/24/2023,1,8717,532,5168,289,0,0,14706
4/24/2023,2,8719,503,4919,404,0,0,14545
4/24/2023,3,8719,567,5030,398,0,0,14714
4/24/2023,4,8711,842,4702,460,0,0,14715
4/24/2023,5,8714,1327,5122,429,0,0,15592
4/24/2023,6,8714,1645,5713,359,0,0,16431
4/24/2023,7,8715,1885,6136,320,23,0,17079
4/24/2023,8,8715,1817,6122,292,70,0,17016
4/24/2023,9,8712,1681,5989,341,139,0,16862
4/24/2023,10,8711,1654,5853,375,164,0,16757
4/24/2023,11,8716,1795,6132,573,194,0,17410
4/24/2023,12,8711,1808,6113,693,258,0,17583
4/24/2023,13,8714,1716,6113,715,182,0,17440
4/24/2023,14,8715,1714,5809,760,153,0,17151
4/24/2023,15,8712,1871,5446,696,187,0,16912
4/24/2023,16,8703,1999,5633,572,151,0,17058
4/24/2023,17,8705,1884,6014,571,82,0,17256
4/24/2023,18,8714,1784,6155,357,67,0,17077
4/24/2023,19,8710,1795,6229,301,16,0,17051
4/24/2023,20,8706,1913,6316,263,0,0,17198
4/24/2023,21,8703,1783,6303,455,0,0,17244
4/24/2023,22,8702,1742,6011,621,0,0,17076
4/24/2023,23,8702,1073,5353,720,0,0,15848
4/24/2023,24,8707,558,5503,687,0,0,15455
4/25/2023,1,8708,496,5130,675,0,0,15009
4/25/2023,2,8705,495,5259,671,0,0,15130
4/25/2023,3,8706,612,5363,589,0,0,15270
4/25/2023,4,8711,980,5435,528,0,0,15654
4/25/2023,5,8612,1572,5337,440,0,0,15961
4/25/2023,6,8597,1866,5940,426,3,0,16832
4/25/2023,7,8596,2154,6173,424,47,0,17394
4/25/2023,8,8599,1902,6138,358,135,0,17132
4/25/2023,9,8706,1776,5668,578,164,0,16892
4/25/2023,10,8708,1758,5467,733,168,0,16834
4/25/2023,11,8710,1471,5856,921,188,0,17146
4/25/2023,12,8703,1414,5968,878,189,0,17152
4/25/2023,13,8704,1413,5860,775,269,0,17021
4/25/2023,14,8708,1607,5413,832,210,0,16770
4/25/2023,15,8712,1755,5264,831,183,0,16745
4/25/2023,16,8708,1757,5774,743,122,0,17104
4/25/2023,17,8703,1790,6117,611,118,0,17339
4/25/2023,18,8707,1895,6291,437,52,0,17382
4/25/2023,19,8641,1932,6314,358,12,0,17257
4/25/2023,20,7897,2915,6350,288,0,0,17450
4/25/2023,21,7891,2228,6229,230,0,0,16578
4/25/2023,22,7896,2101,6175,178,0,0,16350
4/25/2023,23,7901,1434,5956,127,0,0,15418
4/25/2023,24,7897,975,5746,94,0,0,14712
4/26/2023,1,7898,636,5733,81,0,0,14348
4/26/2023,2,7900,585,5366,88,0,0,13939
4/26/2023,3,7905,828,5257,55,0,0,14045
4/26/2023,4,7903,1232,5475,29,0,0,14639
4/26/2023,5,7910,1393,5402,26,0,0,14731
4/26/2023,6,7911,1604,5900,37,2,0,15454
4/26/2023,7,7909,2268,6149,49,28,0,16403
4/26/2023,8,7910,2258,6214,19,81,0,16482
4/26/2023,9,7911,2116,6119,4,145,0,16295
4/26/2023,10,7913,2019,6032,29,193,0,16186
4/26/2023,11,7913,1920,5979,123,212,0,16147
4/26/2023,12,7909,1900,5887,277,262,0,16235
4/26/2023,13,7902,1855,5768,374,267,0,16166
4/26/2023,14,7909,1933,5799,380,259,0,16280
4/26/2023,15,7914,1965,5629,385,234,0,16127
4/26/2023,16,7914,2004,5755,387,158,0,16218
4/26/2023,17,7910,2019,5731,367,111,0,16138
4/26/2023,18,7911,2019,6081,335,57,0,16403
4/26/2023,19,7911,2143,6216,258,13,0,16541
4/26/2023,20,7909,2531,6284,185,0,0,16909
4/26/2023,21,7908,2366,6186,189,0,0,16649
4/26/2023,22,7898,2192,5968,146,0,0,16204
4/26/2023,23,7891,1379,5861,159,0,0,15290
4/26/2023,24,7896,1182,5263,198,0,0,14539
4/27/2023,1,7899,879,5534,265,0,0,14577
4/27/2023,2,7902,988,5077,274,0,0,14241
4/27/2023,3,7903,1298,5251,282,0,0,14734
4/27/2023,4,7903,1599,5103,257,0,0,14862
4/27/2023,5,7904,2156,5186,285,0,0,15531
4/27/2023,6,7905,2247,5512,323,5,0,15992
4/27/2023,7,7909,2358,5977,365,54,0,16663
4/27/2023,8,7910,2297,5545,377,170,0,16299
4/27/2023,9,7904,2301,5376,397,300,0,16278
4/27/2023,10,7895,1852,5522,432,377,0,16078
4/27/2023,11,7898,1640,5823,532,382,0,16275
4/27/2023,12,7904,1656,5697,672,373,0,16302
4/27/2023,13,7902,1634,5609,730,392,0,16267
4/27/2023,14,7895,1805,5226,664,406,0,15996
4/27/2023,15,7896,1811,5057,667,392,0,15823
4/27/2023,16,7904,2303,4992,565,331,0,16095
4/27/2023,17,7900,1829,5780,703,222,0,16434
4/27/2023,18,7897,1667,6026,835,97,0,16522
4/27/2023,19,7901,1610,6100,937,21,0,16569
4/27/2023,20,7891,1570,5771,1041,0,0,16273
4/27/2023,21,7894,1622,5917,1275,0,0,16708
4/27/2023,22,7893,1265,5559,1767,0,0,16484
4/27/2023,23,7892,579,4815,2084,0,0,15370
4/27/2023,24,7894,517,4639,2194,0,0,15244
4/28/2023,1,7893,320,4605,2591,0,0,15409
4/28/2023,2,7902,236,4795,2665,0,0,15598
4/28/2023,3,7902,522,4735,2533,0,0,15692
4/28/2023,4,7902,779,4762,2454,0,0,15897
4/28/2023,5,7904,1022,4759,2468,0,0,16153
4/28/2023,6,7901,1225,4802,2496,6,0,16430
4/28/2023,7,7899,1352,5164,2339,47,0,16801
4/28/2023,8,7903,1348,5520,1960,125,0,16856
4/28/2023,9,7900,1347,5905,1665,196,0,17013
4/28/2023,10,7901,1544,6127,1525,218,0,17315
4/28/2023,11,7896,1452,5937,1543,243,0,17071
4/28/2023,12,7897,1153,5560,1708,220,0,16538
4/28/2023,13,7899,981,5550,2031,197,0,16658
4/28/2023,14,7902,1108,5250,2336,199,0,16795
4/28/2023,15,7903,883,5140,2669,180,0,16775
4/28/2023,16,7901,924,5415,2881,107,0,17228
4/28/2023,17,7898,925,5649,2956,53,0,17481
4/28/2023,18,7905,925,5732,3055,22,0,17639
4/28/2023,19,7903,932,5546,3257,5,0,17643
4/28/2023,20,7902,933,5432,3427,0,0,17694
4/28/2023,21,7892,591,5252,3526,0,0,17261
4/28/2023,22,7891,527,5009,3407,0,0,16834
4/28/2023,23,7894,424,4884,3238,0,0,16440
4/28/2023,24,7887,366,4530,3087,0,0,15870
4/29/2023,1,7891,220,4410,2801,0,0,15322
4/29/2023,2,7892,132,4657,2433,0,0,15114
4/29/2023,3,7894,133,4879,2278,0,0,15184
4/29/2023,4,7892,129,4791,2281,0,0,15093
4/29/2023,5,7890,127,4854,2122,0,0,14993
4/29/2023,6,7893,198,4638,2168,0,0,14897
4/29/2023,7,7892,336,4957,1791,8,0,14984
4/29/2023,8,7891,543,5687,1661,29,0,15811
4/29/2023,9,7893,566,6179,1459,55,0,16152
4/29/2023,10,7888,611,6156,1474,76,0,16205
4/29/2023,11,7884,899,5565,1522,95,0,15965
4/29/2023,12,7884,884,5825,1407,104,0,16104
4/29/2023,13,7883,893,5806,1324,99,0,16005
4/29/2023,14,7887,925,5859,1262,114,0,16047
4/29/2023,15,7895,928,5630,1218,140,0,15811
4/29/2023,16,7891,886,5573,1325,81,0,15756
4/29/2023,17,7892,887,5347,1364,61,0,15551
4/29/2023,18,7894,889,5724,1299,33,0,15839
4/29/2023,19,7894,889,5791,1173,9,0,15756
4/29/2023,20,7889,889,5959,1484,0,0,16221
4/29/2023,21,7885,888,5235,2032,0,0,16040
4/29/2023,22,7889,887,5073,1963,0,0,15812
4/29/2023,23,7885,537,4697,1936,0,0,15055
4/29/2023,24,7893,289,4821,2015,0,0,15018
4/30/2023,1,7891,132,5294,1739,0,0,15056
4/30/2023,2,7898,132,5362,1406,0,0,14798
4/30/2023,3,7896,260,5282,1165,0,0,14603
4/30/2023,4,7894,358,5261,995,0,0,14508
4/30/2023,5,7899,494,4493,857,0,0,13743
4/30/2023,6,7901,561,4677,805,3,0,13947
4/30/2023,7,7903,682,4803,694,22,0,14104
4/30/2023,8,7901,863,5274,792,29,0,14859
4/30/2023,9,7898,1083,5900,701,29,0,15611
4/30/2023,10,7891,1498,5853,773,70,0,16085
4/30/2023,11,7886,1487,5433,773,84,0,15663
4/30/2023,12,7885,1500,5203,663,70,0,15321
4/30/2023,13,7887,1499,5347,672,60,0,15465
4/30/2023,14,7888,1506,5337,771,81,0,15583
4/30/2023,15,7889,1530,5306,820,85,0,15630
4/30/2023,16,7883,1635,5564,850,76,0,16008
4/30/2023,17,7886,1681,5462,1140,46,0,16215
4/30/2023,18,7892,1696,5502,1204,34,0,16328
4/30/2023,19,7891,1714,5591,1065,13,0,16274
4/30/2023,20,7887,1693,5874,969,0,0,16423
4/30/2023,21,7887,1753,5897,816,0,0,16353
4/30/2023,22,7892,1673,5497,924,0,0,15986
4/30/2023,23,7901,1375,5090,959,0,0,15325
4/30/2023,24,7939,805,5036,884,0,0,14664
5/1/2023,1,8079,307,5236,963,0,0,14585
5/1/2023,2,8120,124,5286,1097,0,0,14627
5/1/2023,3,8080,259,4952,1300,0,0,14591
5/1/2023,4,8195,350,4704,1305,0,0,14554
5/1/2023,5,8304,585,4600,1260,0,0,14749
5/1/2023,6,8308,876,4798,1516,1,0,15499
5/1/2023,7,8359,890,5411,1552,23,0,16235
5/1/2023,8,8478,888,5608,1656,46,0,16676
5/1/2023,9,8475,906,5216,1887,75,0,16559
5/1/2023,10,8474,1017,5576,2149,127,0,17343
5/1/2023,11,8476,1170,5238,2429,214,0,17527
5/1/2023,12,8478,1230,5403,2319,254,0,17684
5/1/2023,13,8478,934,5357,2126,246,0,17141
5/1/2023,14,8482,1197,5436,2242,258,0,17615
5/1/2023,15,8481,1143,5209,2755,252,0,17840
5/1/2023,16,8481,1262,5392,2504,244,0,17883
5/1/2023,17,8504,1301,5415,2465,153,0,17838
5/1/2023,18,8599,1298,5509,2606,58,0,18070
5/1/2023,19,8612,1288,5446,2736,16,0,18098
5/1/2023,20,8612,1284,5443,2993,0,0,18332
5/1/2023,21,8615,1283,5254,3087,0,0,18239
5/1/2023,22,8607,1004,5291,2545,0,0,17447
5/1/2023,23,8611,447,5133,2296,0,0,16487
5/1/2023,24,8607,207,5147,1770,0,0,15731
5/2/2023,1,8609,125,4921,1705,0,0,15360
5/2/2023,2,8626,243,4441,1711,0,0,15021
5/2/2023,3,8649,467,4328,1560,0,0,15004
5/2/2023,4,8646,743,4328,1373,0,0,15090
5/2/2023,5,8595,1134,4637,1317,0,0,15683
5/2/2023,6,8588,1529,4900,1704,6,0,16727
5/2/2023,7,8586,1546,5487,1760,54,0,17433
5/2/2023,8,8581,1551,5661,1871,101,0,17765
5/2/2023,9,8583,1552,5240,1772,138,0,17285
5/2/2023,10,8581,1475,5254,1764,163,0,17237
5/2/2023,11,8578,1441,5258,1810,198,0,17285
5/2/2023,12,8580,1355,5361,1785,222,0,17303
5/2/2023,13,8579,1311,5211,1812,223,0,17136
5/2/2023,14,8583,1649,5110,1576,234,0,17152
5/2/2023,15,8602,1786,4950,1769,205,0,17312
5/2/2023,16,8642,1941,5344,1712,153,0,17792
5/2/2023,17,8659,1862,5910,1339,102,0,17872
5/2/2023,18,8663,1998,6007,1260,52,0,17980
5/2/2023,19,8663,1800,5653,1341,11,0,17468
5/2/2023,20,8664,1777,5913,1229,0,0,17583
5/2/2023,21,8667,1783,5844,1065,0,0,17359
5/2/2023,22,8663,1770,5482,1061,0,0,16976
5/2/2023,23,8676,1053,5373,1130,0,0,16232
5/2/2023,24,8676,557,4979,1241,0,0,15453
5/3/2023,1,8676,278,4887,1191,0,0,15032
5/3/2023,2,8675,125,5419,1100,0,0,15319
5/3/2023,3,8678,247,5204,1165,0,0,15294
5/3/2023,4,8675,366,5366,938,0,0,15345
5/3/2023,5,8625,475,5205,874,0,0,15179
5/3/2023,6,8620,603,5641,848,2,26,15740
5/3/2023,7,8625,945,5672,1262,17,44,16565
5/3/2023,8,8619,928,5504,1807,59,45,16962
5/3/2023,9,8598,925,5338,2233,109,43,17246
5/3/2023,10,8561,925,5260,2566,153,43,17508
5/3/2023,11,8562,1000,5067,2609,181,44,17463
5/3/2023,12,8556,800,5118,2073,202,42,16791
5/3/2023,13,8643,801,4943,2523,210,42,17162
5/3/2023,14,8680,712,4923,2711,164,43,17233
5/3/2023,15,8676,774,5159,2756,136,41,17542
5/3/2023,16,8664,928,5274,2829,117,40,17852
5/3/2023,17,8669,944,5359,2740,84,39,17835
5/3/2023,18,8675,1006,5498,2506,43,39,17767
5/3/2023,19,8677,1139,5800,2287,12,15,17930
5/3/2023,20,8674,1144,5785,2043,0,0,17646
5/3/2023,21,8676,1182,5841,1829,0,0,17528
5/3/2023,22,8678,1154,5758,1603,0,0,17193
5/3/2023,23,8674,784,5481,1397,0,0,16336
5/3/2023,24,8676,489,5085,1241,0,0,15491
5/4/2023,1,8684,154,5094,1063,0,0,14995
5/4/2023,2,8683,245,5165,796,0,18,14907
5/4/2023,3,8683,454,5018,813,0,38,15006
5/4/2023,4,8674,793,4779,783,0,41,15070
5/4/2023,5,8624,1057,4865,683,0,43,15272
5/4/2023,6,8624,1239,5304,554,2,44,15767
5/4/2023,7,8629,1969,5764,418,30,45,16855
5/4/2023,8,8630,2300,5849,256,71,45,17151
5/4/2023,9,8633,2334,5811,156,110,43,17087
5/4/2023,10,8626,2225,5682,128,146,41,16848
5/4/2023,11,8628,2035,5646,177,175,43,16704
5/4/2023,12,8630,1975,5595,270,194,45,16709
5/4/2023,13,8627,2004,5568,367,178,43,16787
5/4/2023,14,8656,1846,5402,421,204,38,16567
5/4/2023,15,8693,1924,5260,409,183,30,16499
5/4/2023,16,8697,1968,5371,420,162,30,16648
5/4/2023,17,8696,2043,5756,381,81,28,16985
5/4/2023,18,8694,2165,5881,252,41,22,17055
5/4/2023,19,8694,2218,5904,175,12,23,17026
5/4/2023,20,8686,2259,5988,143,0,20,17096
5/4/2023,21,8692,2350,5893,157,0,4,17096
5/4/2023,22,8696,2037,5654,200,0,0,16587
5/4/2023,23,8693,1809,4965,167,0,0,15634
5/4/2023,24,8699,1408,4865,168,0,0,15140
5/5/2023,1,8692,498,5231,257,0,0,14678
5/5/2023,2,8701,402,4990,288,0,0,14381
5/5/2023,3,8706,490,5038,260,0,0,14494
5/5/2023,4,8708,495,5149,264,0,0,14616
5/5/2023,5,8708,591,5063,289,0,0,14651
5/5/2023,6,8706,872,5002,329,4,1,14914
5/5/2023,7,8705,1001,5645,305,46,19,15721
5/5/2023,8,8701,1252,5724,148,126,22,15973
5/5/2023,9,8700,1581,5601,102,229,19,16232
5/5/2023,10,8704,1730,5574,123,285,18,16434
5/5/2023,11,8704,1591,5513,123,316,27,16274
5/5/2023,12,8702,1587,5413,120,334,28,16184
5/5/2023,13,8704,1911,5014,244,292,27,16192
5/5/2023,14,8700,1815,5030,299,279,21,16144
5/5/2023,15,8700,1757,5141,316,221,18,16153
5/5/2023,16,8700,1759,5207,351,225,20,16262
5/5/2023,17,8700,1795,5416,513,188,5,16617
5/5/2023,18,8699,1923,5216,648,90,0,16576
5/5/2023,19,8701,1923,5365,690,20,0,16699
5/5/2023,20,8692,1922,5253,823,0,0,16690
5/5/2023,21,8694,1923,5188,1361,0,0,17166
5/5/2023,22,8690,1584,4805,1353,0,0,16432
5/5/2023,23,8693,672,4774,1505,0,0,15644
5/5/2023,24,8696,481,4602,1634,0,0,15413
5/6/2023,1,8701,270,4473,1616,0,0,15060
5/6/2023,2,8702,127,4528,1593,0,0,14950
5/6/2023,3,8704,194,4219,1721,0,0,14838
5/6/2023,4,8709,284,4277,1499,0,0,14769
5/6/2023,5,8708,348,4762,1222,0,0,15040
5/6/2023,6,8711,349,5085,1156,6,0,15307
5/6/2023,7,8710,378,5001,1155,56,0,15300
5/6/2023,8,8707,382,5164,831,175,0,15259
5/6/2023,9,8699,383,5404,658,298,0,15442
5/6/2023,10,8700,383,5402,579,354,0,15418
5/6/2023,11,8703,455,5200,525,362,0,15245
5/6/2023,12,8700,473,5217,476,373,0,15239
5/6/2023,13,8698,720,4900,483,369,0,15170
5/6/2023,14,8692,997,4785,404,362,0,15240
5/6/2023,15,8698,1117,4777,346,310,0,15248
5/6/2023,16,8703,1426,4912,491,263,0,15795
5/6/2023,17,8703,1589,5215,738,177,0,16422
5/6/2023,18,8708,1590,5321,857,85,0,16561
5/6/2023,19,8711,1592,5518,862,21,0,16704
5/6/2023,20,8709,1590,5493,991,0,0,16783
5/6/2023,21,8712,1427,5301,1360,0,0,16800
5/6/2023,22,8710,1064,5032,1462,0,0,16268
5/6/2023,23,8711,534,4831,1546,0,0,15622
5/6/2023,24,8712,378,4717,1051,0,0,14858
5/7/2023,1,8714,245,4630,1150,0,0,14739
5/7/2023,2,8713,155,4028,1425,0,0,14321
5/7/2023,3,8717,156,3719,1575,0,0,14167
5/7/2023,4,8713,156,3822,1402,0,0,14093
5/7/2023,5,8705,220,3712,1344,0,0,13981
5/7/2023,6,8710,315,3847,1105,5,0,13982
5/7/2023,7,8707,377,4214,951,40,0,14289
5/7/2023,8,8703,379,4467,1014,109,0,14672
5/7/2023,9,8698,378,4578,853,171,0,14678
5/7/2023,10,8692,380,5092,977,253,0,15394
5/7/2023,11,8695,460,5260,1347,242,0,16004
5/7/2023,12,8696,471,5225,933,236,0,15561
5/7/2023,13,8696,630,4946,1107,215,0,15594
5/7/2023,14,8692,858,5151,1117,141,0,15959
5/7/2023,15,8636,1188,5664,724,147,0,16359
5/7/2023,16,8695,1181,5846,484,175,0,16381
5/7/2023,17,8699,1181,6016,414,106,0,16416
5/7/2023,18,8699,1187,5984,508,49,0,16427
5/7/2023,19,8701,1188,5766,806,9,0,16470
5/7/2023,20,8693,1190,5516,919,0,0,16318
5/7/2023,21,8699,1188,5403,1145,0,0,16435
5/7/2023,22,8700,1185,5030,1403,0,0,16318
5/7/2023,23,8699,513,4745,1136,0,0,15093
5/7/2023,24,8256,318,5086,1389,0,0,15049
5/8/2023,1,7875,256,5741,1319,0,0,15191
5/8/2023,2,7869,283,5409,1202,0,0,14763
5/8/2023,3,7872,388,5389,1012,0,0,14661
5/8/2023,4,7878,614,4998,991,0,0,14481
5/8/2023,5,7882,850,5160,927,0,0,14819
5/8/2023,6,7886,1278,5174,1012,10,0,15360
5/8/2023,7,7890,1357,5983,687,55,0,15972
5/8/2023,8,7885,1632,6075,392,162,0,16146
5/8/2023,9,7882,1689,5964,335,278,0,16148
5/8/2023,10,7883,1559,5475,329,362,0,15608
5/8/2023,11,7886,1585,5486,346,405,0,15708
5/8/2023,12,7884,1603,5368,413,401,0,15669
5/8/2023,13,7877,1746,5480,380,394,0,15877
5/8/2023,14,7879,1810,5428,416,392,0,15925
5/8/2023,15,7875,1911,5287,509,368,0,15950
5/8/2023,16,7875,2064,5528,609,294,0,16370
5/8/2023,17,7875,2231,6069,617,178,0,16970
5/8/2023,18,7875,2167,5951,636,87,0,16716
5/8/2023,19,7880,2114,5939,784,26,0,16743
5/8/2023,20,7876,2109,5755,1052,1,0,16793
5/8/2023,21,7878,2173,5873,1213,0,0,17137
5/8/2023,22,7874,1616,5335,1266,0,0,16091
5/8/2023,23,7878,830,5378,1487,0,0,15573
5/8/2023,24,7882,510,4894,1744,0,0,15030
5/9/2023,1,7885,206,5388,1641,0,0,15120
5/9/2023,2,7889,279,4952,1582,0,0,14702
5/9/2023,3,7892,391,4764,1403,0,0,14450
5/9/2023,4,7892,657,4964,1369,0,0,14882
5/9/2023,5,7897,915,4955,1284,0,0,15051
5/9/2023,6,7900,1322,5119,1321,10,0,15672
5/9/2023,7,7900,1422,5929,920,59,0,16230
5/9/2023,8,7900,1807,6023,452,165,0,16347
5/9/2023,9,7896,1646,5725,281,288,0,15836
5/9/2023,10,7895,1605,5590,240,375,0,15705
5/9/2023,11,7890,1683,5423,353,420,0,15769
5/9/2023,12,7890,1481,5148,528,424,0,15471
5/9/2023,13,7892,1278,5120,756,421,0,15467
5/9/2023,14,7893,1464,4828,900,414,0,15499
5/9/2023,15,7883,1427,4760,973,390,0,15433
5/9/2023,16,7879,1665,5324,963,309,0,16140
5/9/2023,17,7880,1829,5825,856,207,0,16597
5/9/2023,18,7880,1974,6162,691,95,0,16802
5/9/2023,19,7883,1938,6192,469,26,0,16508
5/9/2023,20,7877,2087,6321,304,1,0,16590
5/9/2023,21,7878,2263,6090,219,0,0,16450
5/9/2023,22,7874,1930,6076,173,0,0,16053
5/9/2023,23,7879,1532,5649,206,0,0,15266
5/9/2023,24,7982,880,5412,208,0,0,14482
5/10/2023,1,8125,485,5414,195,0,0,14219
5/10/2023,2,8129,382,5550,173,0,0,14234
5/10/2023,3,8122,454,5410,135,0,0,14121
5/10/2023,4,8104,634,5500,119,0,0,14357
5/10/2023,5,8105,803,5319,133,0,0,14360
5/10/2023,6,8104,1141,5514,143,17,0,14919
5/10/2023,7,8106,1143,6071,105,70,0,15495
5/10/2023,8,8112,1170,5935,50,158,0,15425
5/10/2023,9,8128,1216,5895,24,270,0,15533
5/10/2023,10,8302,1221,5805,42,347,0,15717
5/10/2023,11,8342,1276,5632,140,402,0,15792
5/10/2023,12,8357,842,5859,225,419,0,15702
5/10/2023,13,8511,807,5462,359,420,0,15559
5/10/2023,14,8522,1163,5030,549,398,0,15662
5/10/2023,15,8496,1333,4907,633,336,0,15705
5/10/2023,16,8476,1401,5205,709,299,0,16090
5/10/2023,17,8469,1644,5477,771,208,0,16569
5/10/2023,18,8466,1716,5418,841,103,0,16544
5/10/2023,19,8464,1718,5554,906,29,0,16671
5/10/2023,20,8460,1638,5668,986,2,0,16754
5/10/2023,21,8456,1462,5620,1114,0,0,16652
5/10/2023,22,8526,987,5344,1235,0,0,16092
5/10/2023,23,8636,573,5172,761,0,0,15142
5/10/2023,24,8639,310,5036,881,0,0,14866
5/11/2023,1,8635,155,4724,1348,0,0,14862
5/11/2023,2,8642,273,4444,1259,0,0,14618
5/11/2023,3,8634,383,4430,1221,0,0,14668
5/11/2023,4,8644,625,4505,874,0,0,14648
5/11/2023,5,8642,842,4657,943,0,0,15084
5/11/2023,6,8637,1137,5072,782,11,0,15639
5/11/2023,7,8658,1192,5966,752,66,0,16634
5/11/2023,8,8669,1245,6065,449,156,0,16584
5/11/2023,9,8668,1241,5993,274,286,0,16462
5/11/2023,10,8662,1305,5681,232,350,0,16230
5/11/2023,11,8662,1405,5483,274,366,0,16190
5/11/2023,12,8663,1603,5174,465,413,0,16318
5/11/2023,13,8665,1670,5061,658,400,0,16454
5/11/2023,14,8659,1688,4861,735,385,0,16328
5/11/2023,15,8650,1896,4857,885,372,0,16660
5/11/2023,16,8652,1814,5358,968,331,0,17123
5/11/2023,17,8657,1934,5605,1040,268,0,17504
5/11/2023,18,8665,1972,5775,885,175,0,17472
5/11/2023,19,8669,1964,6237,791,118,0,17779
5/11/2023,20,8666,1969,6122,873,99,0,17729
5/11/2023,21,8661,2031,6127,996,98,0,17913
5/11/2023,22,8663,1622,5505,1217,98,0,17105
5/11/2023,23,8669,903,5215,1317,98,0,16202
5/11/2023,24,8666,544,5134,1360,98,0,15802
5/12/2023,1,8669,276,4817,1350,98,0,15210
5/12/2023,2,8664,126,4748,1342,7,0,14887
5/12/2023,3,8664,247,4842,963,1,0,14717
5/12/2023,4,8663,478,4797,683,0,0,14621
5/12/2023,5,8659,913,5095,592,0,0,15259
5/12/2023,6,8656,1452,5014,402,9,0,15533
5/12/2023,7,8652,1723,5811,370,56,0,16612
5/12/2023,8,8648,1938,5733,194,148,0,16661
5/12/2023,9,8644,1933,5672,49,267,0,16565
5/12/2023,10,8644,1951,5769,44,351,0,16759
5/12/2023,11,8647,2006,5795,70,343,0,16861
5/12/2023,12,8641,2026,5806,152,367,0,16992
5/12/2023,13,8647,2184,5794,217,372,0,17214
5/12/2023,14,8647,2324,5830,323,359,0,17483
5/12/2023,15,8647,2445,5902,374,345,0,17713
5/12/2023,16,8647,2758,6004,427,252,0,18088
5/12/2023,17,8648,3068,6109,392,167,0,18384
5/12/2023,18,8651,2825,6186,376,82,0,18120
5/12/2023,19,8650,2690,6166,429,26,0,17961
5/12/2023,20,8646,2571,6339,434,0,0,17990
5/12/2023,21,8682,2628,6212,401,0,0,17923
5/12/2023,22,8739,2397,5672,475,0,0,17283
5/12/2023,23,8756,1662,5354,685,0,0,16457
5/12/2023,24,8751,817,5386,754,0,0,15708
5/13/2023,1,8754,444,5436,838,0,0,15472
5/13/2023,2,8762,359,5561,902,0,0,15584
5/13/2023,3,8771,359,5047,931,0,0,15108
5/13/2023,4,8768,358,5100,926,0,0,15152
5/13/2023,5,8771,356,4820,1030,0,0,14977
5/13/2023,6,8764,356,4747,957,9,0,14833
5/13/2023,7,8773,358,4941,947,63,0,15082
5/13/2023,8,8778,372,6024,683,156,0,16013
5/13/2023,9,8786,457,6144,560,246,0,16193
5/13/2023,10,8776,423,6108,511,314,0,16132
5/13/2023,11,8777,390,5398,615,386,0,15566
5/13/2023,12,8777,359,5535,632,378,0,15681
5/13/2023,13,8769,366,5406,762,398,0,15701
5/13/2023,14,8775,515,5296,1042,401,0,16029
5/13/2023,15,8775,664,5159,1285,392,0,16275
5/13/2023,16,8787,978,5674,1415,283,0,17137
5/13/2023,17,8790,978,5635,1450,196,0,17049
5/13/2023,18,8866,976,5817,1422,107,0,17188
5/13/2023,19,8907,976,5736,1378,27,0,17024
5/13/2023,20,8949,973,5564,1512,3,0,17001
5/13/2023,21,8959,972,5596,1923,0,0,17450
5/13/2023,22,8969,485,5241,2145,0,0,16840
5/13/2023,23,8968,362,5090,1455,0,0,15875
5/13/2023,24,8967,219,4607,1514,0,0,15307
5/14/2023,1,8978,126,4319,1517,0,0,14940
5/14/2023,2,9005,125,3905,1555,0,0,14590
5/14/2023,3,9139,125,3838,1180,0,0,14282
5/14/2023,4,9169,125,3966,1128,0,0,14388
5/14/2023,5,9170,126,3984,905,0,0,14185
5/14/2023,6,9175,125,4061,816,12,0,14189
5/14/2023,7,9176,125,4116,1026,66,0,14509
5/14/2023,8,9168,125,4341,925,185,0,14744
5/14/2023,9,9171,125,4394,777,292,0,14759
5/14/2023,10,9169,144,4367,791,394,0,14865
5/14/2023,11,9169,191,4303,843,408,0,14914
5/14/2023,12,9158,280,4229,826,411,0,14904
5/14/2023,13,9153,353,3807,889,408,0,14610
5/14/2023,14,9169,355,3843,591,391,0,14349
5/14/2023,15,9172,354,3846,917,358,0,14647
5/14/2023,16,9169,354,4177,957,286,0,14943
5/14/2023,17,9185,355,4617,1302,191,0,15650
5/14/2023,18,9199,353,5115,1228,95,0,15990
5/14/2023,19,9201,354,5565,1046,27,0,16193
5/14/2023,20,9202,355,5782,921,1,0,16261
5/14/2023,21,9198,354,5780,939,0,0,16271
5/14/2023,22,9202,355,5678,921,0,0,16156
5/14/2023,23,9214,355,5134,845,0,0,15548
5/14/2023,24,9237,287,4402,977,0,0,14903
5/15/2023,1,9234,144,4178,638,0,0,14194
5/15/2023,2,9243,436,4179,440,0,0,14298
5/15/2023,3,9242,467,4154,377,0,0,14240
5/15/2023,4,9240,516,4239,399,0,0,14394
5/15/2023,5,9243,570,4570,313,0,0,14696
5/15/2023,6,9241,618,4851,359,15,0,15084
5/15/2023,7,9244,643,5337,430,66,4,15724
5/15/2023,8,9240,670,5546,232,167,6,15861
5/15/2023,9,9235,673,5468,297,293,3,15969
5/15/2023,10,9235,577,5341,468,387,2,16010
5/15/2023,11,9235,681,5221,548,419,8,16112
5/15/2023,12,9242,758,5207,824,413,5,16449
5/15/2023,13,9236,890,4713,1091,413,8,16351
5/15/2023,14,9243,981,4593,1167,394,26,16404
5/15/2023,15,9234,1102,4689,1052,372,11,16460
5/15/2023,16,9229,1102,4970,1101,321,8,16731
5/15/2023,17,9225,1099,5169,1497,210,16,17216
5/15/2023,18,9219,1098,5295,1571,99,21,17303
5/15/2023,19,9217,1098,5639,1541,26,12,17533
5/15/2023,20,9219,1099,5733,1721,1,11,17784
5/15/2023,21,9217,1096,5398,2016,0,11,17738
5/15/2023,22,9214,598,4996,2179,0,11,16998
5/15/2023,23,9218,282,4461,1689,0,11,15661
5/15/2023,24,9226,128,3946,1588,0,11,14899
5/16/2023,1,9224,128,3899,1371,0,8,14630
5/16/2023,2,9226,128,3696,1223,0,12,14285
5/16/2023,3,9222,128,3704,918,0,9,13981
5/16/2023,4,9228,128,3836,920,0,11,14123
5/16/2023,5,9222,128,4053,1300,0,10,14713
5/16/2023,6,9225,129,4364,1887,10,10,15625
5/16/2023,7,9222,182,4521,2296,46,11,16278
5/16/2023,8,9220,129,5049,1846,116,11,16371
5/16/2023,9,9212,129,5349,1751,205,4,16650
5/16/2023,10,9212,129,5155,1900,271,0,16667
5/16/2023,11,9220,129,4587,2301,327,0,16564
5/16/2023,12,9214,232,4349,2490,351,1,16637
5/16/2023,13,9211,355,4181,2997,291,0,17035
5/16/2023,14,9218,456,4179,2987,262,10,17112
5/16/2023,15,9216,465,4355,3084,178,18,17316
5/16/2023,16,9212,475,4580,2679,156,17,17119
5/16/2023,17,9217,475,4789,2379,143,21,17024
5/16/2023,18,9219,475,5039,2298,72,18,17121
5/16/2023,19,9223,476,5244,2569,18,2,17532
5/16/2023,20,9222,476,5227,2569,0,0,17494
5/16/2023,21,9219,477,5538,2555,0,0,17789
5/16/2023,22,9224,476,4887,2482,0,0,17069
5/16/2023,23,9226,289,3950,2343,0,0,15808
5/16/2023,24,9228,128,3776,1985,0,0,15117
5/17/2023,1,9236,255,3696,1554,0,0,14741
5/17/2023,2,9240,340,3706,1409,0,0,14695
5/17/2023,3,9233,467,3692,1141,0,0,14533
5/17/2023,4,9233,472,3725,1175,0,0,14605
5/17/2023,5,9235,473,3910,1441,0,0,15059
5/17/2023,6,9236,471,4561,1696,13,3,15980
5/17/2023,7,9237,470,5268,1764,58,7,16804
5/17/2023,8,9143,521,5082,1605,160,9,16520
5/17/2023,9,8588,657,4856,1193,277,9,15580
5/17/2023,10,8954,313,4579,795,356,13,15010
5/17/2023,11,9205,231,4748,969,360,15,15528
5/17/2023,12,9209,410,4958,1000,352,20,15949
5/17/2023,13,9214,563,4541,1104,366,20,15808
5/17/2023,14,9215,767,4485,1094,367,24,15952
5/17/2023,15,9239,978,4248,918,346,25,15754
5/17/2023,16,9237,1270,4611,649,291,28,16086
5/17/2023,17,9235,1282,4973,822,202,27,16541
5/17/2023,18,9235,1277,5556,827,104,25,17024
5/17/2023,19,9237,1276,6039,627,30,4,17213
5/17/2023,20,9232,1277,6092,543,4,0,17148
5/17/2023,21,9226,1358,6181,507,0,0,17272
5/17/2023,22,9227,890,5871,404,0,0,16392
5/17/2023,23,9218,365,5499,405,0,0,15487
5/17/2023,24,9230,344,5061,546,0,0,15181
5/18/2023,1,9234,318,4781,599,0,0,14932
5/18/2023,2,9233,296,4936,562,0,0,15027
5/18/2023,3,9236,377,4994,481,0,0,15088
5/18/2023,4,9231,534,5068,431,0,0,15264
5/18/2023,5,9234,794,4995,473,0,0,15496
5/18/2023,6,9138,890,5068,453,17,1,15567
5/18/2023,7,9119,1014,5851,381,72,24,16461
5/18/2023,8,9117,1037,6086,189,179,27,16635
5/18/2023,9,9113,970,5869,243,294,19,16508
5/18/2023,10,9117,977,5791,255,377,20,16537
5/18/2023,11,9113,861,5488,295,404,20,16181
5/18/2023,12,9214,857,5394,420,417,19,16321
5/18/2023,13,9225,1187,5278,471,414,23,16598
5/18/2023,14,9217,1212,4779,585,413,34,16240
5/18/2023,15,9230,883,5014,535,398,30,16090
5/18/2023,16,9239,940,5352,471,319,27,16348
5/18/2023,17,9227,1160,5691,453,216,28,16775
5/18/2023,18,9226,1525,5741,475,103,25,17095
5/18/2023,19,9232,1664,5944,496,28,1,17365
5/18/2023,20,9229,1436,5867,595,2,0,17129
5/18/2023,21,9230,1373,5672,880,0,0,17155
5/18/2023,22,9221,1137,5209,1065,0,0,16632
5/18/2023,23,9224,728,4698,1244,0,0,15894
5/18/2023,24,9226,228,4210,1671,0,0,15335
5/19/2023,1,9223,127,4048,1657,0,0,15055
5/19/2023,2,9224,127,3701,1578,0,0,14630
5/19/2023,3,9228,127,3696,1450,0,0,14501
5/19/2023,4,9231,127,3679,1377,0,0,14414
5/19/2023,5,9227,127,3780,1577,0,0,14711
5/19/2023,6,9228,126,4197,2048,14,0,15613
5/19/2023,7,9226,126,4465,2364,63,7,16251
5/19/2023,8,9224,125,4821,2239,138,11,16558
5/19/2023,9,9221,125,4681,2161,226,3,16417
5/19/2023,10,9228,125,4600,2101,280,1,16335
5/19/2023,11,9226,125,4578,2471,302,2,16704
5/19/2023,12,9229,238,4363,2560,339,0,16729
5/19/2023,13,9231,403,4306,2547,269,4,16760
5/19/2023,14,9228,589,4571,2065,254,6,16713
5/19/2023,15,9230,597,4938,1840,219,3,16827
5/19/2023,16,9228,569,5213,2080,124,18,17232
5/19/2023,17,9232,543,5408,2005,65,59,17312
5/19/2023,18,9230,477,5729,1653,35,57,17181
5/19/2023,19,9228,610,5831,1220,15,52,16956
5/19/2023,20,9225,505,6271,982,0,52,17035
5/19/2023,21,9223,511,6139,926,0,62,16861
5/19/2023,22,9228,411,5600,1053,0,54,16346
5/19/2023,23,9225,250,5080,1246,0,54,15855
5/19/2023,24,9226,158,4456,1242,0,54,15136
5/20/2023,1,9227,158,4483,831,0,54,14753
5/20/2023,2,9226,158,4209,1010,0,54,14657
5/20/2023,3,9226,158,3962,1102,0,52,14500
5/20/2023,4,9228,211,3726,1064,0,52,14281
5/20/2023,5,9237,289,3762,943,0,17,14248
5/20/2023,6,9208,400,4063,718,3,0,14392
5/20/2023,7,8713,381,4614,971,20,0,14699
5/20/2023,8,8712,300,5203,937,55,0,15207
5/20/2023,9,8710,304,5697,1175,84,10,15980
5/20/2023,10,8702,464,5895,1076,91,42,16270
5/20/2023,11,8704,413,5765,1167,100,60,16209
5/20/2023,12,8703,289,5533,1358,161,59,16103
5/20/2023,13,8702,159,4918,1694,180,52,15705
5/20/2023,14,8702,248,4561,1686,204,52,15453
5/20/2023,15,8705,304,4803,1879,185,51,15927
5/20/2023,16,8700,343,5034,1874,98,51,16100
5/20/2023,17,8699,343,5510,1906,70,52,16580
5/20/2023,18,8694,345,5768,1503,65,50,16425
5/20/2023,19,8693,342,5704,1278,15,51,16083
5/20/2023,20,8692,344,5665,1161,1,52,15915
5/20/2023,21,8691,344,5402,1261,0,52,15750
5/20/2023,22,8695,344,5193,1389,0,30,15651
5/20/2023,23,8696,247,4325,1799,0,50,15117
5/20/2023,24,8699,179,4205,1261,0,55,14399
5/21/2023,1,8702,148,3789,1431,0,14,14084
5/21/2023,2,8706,133,3796,970,0,0,13605
5/21/2023,3,8708,126,3624,867,0,0,13325
5/21/2023,4,8713,126,3767,1165,0,0,13771
5/21/2023,5,8717,126,3813,1045,0,0,13701
5/21/2023,6,8722,126,3788,1179,9,0,13824
5/21/2023,7,8724,126,3933,1362,69,33,14247
5/21/2023,8,8723,126,4359,1118,179,54,14559
5/21/2023,9,8718,127,4357,811,276,51,14340
5/21/2023,10,8718,126,4510,821,360,51,14586
5/21/2023,11,8722,209,4622,659,405,51,14668
5/21/2023,12,8723,290,4729,493,417,51,14703
5/21/2023,13,8720,337,4534,520,415,50,14576
5/21/2023,14,8718,338,4712,408,402,49,14627
5/21/2023,15,8716,340,4771,296,345,50,14518
5/21/2023,16,8717,342,5243,716,298,50,15366
5/21/2023,17,8713,341,5694,592,191,50,15581
5/21/2023,18,8711,342,6073,439,87,49,15701
5/21/2023,19,8718,344,5658,352,29,51,15152
5/21/2023,20,8714,343,5508,366,3,50,14984
5/21/2023,21,8718,343,5689,412,0,50,15212
5/21/2023,22,8702,343,5494,524,0,50,15113
5/21/2023,23,8705,214,5366,689,0,50,15024
5/21/2023,24,8714,127,5183,911,0,50,14985
5/22/2023,1,8715,128,4828,978,0,50,14699
5/22/2023,2,8719,128,4591,1133,0,14,14585
5/22/2023,3,8719,128,4546,1153,0,0,14546
5/22/2023,4,8718,128,4506,1190,0,0,14542
5/22/2023,5,8721,128,4497,1314,0,0,14660
5/22/2023,6,8719,128,4209,1470,15,0,14541
5/22/2023,7,8720,128,4396,1314,68,0,14626
5/22/2023,8,8716,127,4728,987,173,0,14731
5/22/2023,9,8718,136,5120,672,285,0,14931
5/22/2023,10,8718,135,4689,411,369,0,14322
5/22/2023,11,8718,227,5177,331,403,0,14856
5/22/2023,12,8717,418,4786,372,415,0,14708
5/22/2023,13,8720,553,4856,308,392,2,14831
5/22/2023,14,8714,708,4712,383,397,31,14945
5/22/2023,15,8714,941,4672,443,389,53,15212
5/22/2023,16,8710,1083,5201,433,325,54,15806
5/22/2023,17,8703,1094,5468,415,223,54,15957
5/22/2023,18,8706,1126,5852,449,110,54,16297
5/22/2023,19,8710,1109,5887,574,31,53,16364
5/22/2023,20,8709,1099,5783,831,5,51,16478
5/22/2023,21,8710,1008,5358,1316,0,50,16442
5/22/2023,22,8714,587,4865,1871,0,51,16088
5/22/2023,23,8723,363,4451,2099,0,15,15651
5/22/2023,24,8720,364,4076,1975,0,0,15135
5/23/2023,1,8724,243,4052,2279,0,2,15300
5/23/2023,2,8722,133,3837,2280,0,10,14982
5/23/2023,3,8724,297,3852,2163,0,11,15047
5/23/2023,4,8723,417,3788,1732,0,11,14671
5/23/2023,5,8721,578,4215,1786,0,11,15311
5/23/2023,6,8719,628,4850,1729,17,14,15957
5/23/2023,7,8720,687,5194,1573,68,28,16270
5/23/2023,8,8718,728,5830,839,160,35,16310
5/23/2023,9,8716,860,6049,405,255,27,16312
5/23/2023,10,8715,1003,6032,178,326,16,16270
5/23/2023,11,8717,1047,5944,101,370,18,16197
5/23/2023,12,8718,1007,5340,142,379,26,15612
5/23/2023,13,8722,1141,5758,146,379,27,16173
5/23/2023,14,8720,1528,5510,145,363,26,16292
5/23/2023,15,8723,1855,5392,218,330,52,16570
5/23/2023,16,8720,2092,5743,217,264,70,17106
5/23/2023,17,8713,2176,5978,256,174,65,17362
5/23/2023,18,8711,2129,5873,328,92,66,17199
5/23/2023,19,8711,2116,5904,352,30,52,17165
5/23/2023,20,8721,2022,5814,422,3,51,17033
5/23/2023,21,8198,2073,6125,563,0,51,17010
5/23/2023,22,7898,1865,5778,779,0,51,16371
5/23/2023,23,7881,1251,5280,899,0,13,15324
5/23/2023,24,7888,832,5241,902,0,0,14863
5/24/2023,1,7895,292,5292,907,0,0,14386
5/24/2023,2,7904,156,5040,878,0,0,13978
5/24/2023,3,7904,156,5169,953,0,0,14182
5/24/2023,4,7904,255,4987,1073,0,0,14219
5/24/2023,5,7903,362,4588,995,0,0,13848
5/24/2023,6,7901,481,4884,1134,13,0,14413
5/24/2023,7,7901,480,5431,1482,35,1,15330
5/24/2023,8,7899,480,5603,1821,63,1,15867
5/24/2023,9,7894,479,5548,2469,117,1,16508
5/24/2023,10,7901,479,5247,2819,145,3,16594
5/24/2023,11,7900,480,5380,2694,153,2,16609
5/24/2023,12,7896,289,4723,2570,291,1,15770
5/24/2023,13,7894,132,4812,2701,317,1,15857
5/24/2023,14,7897,258,4845,2528,400,1,15929
5/24/2023,15,7899,395,4672,2492,410,2,15870
5/24/2023,16,7909,477,4672,2484,366,0,15908
5/24/2023,17,7899,478,5072,3381,259,6,17095
5/24/2023,18,7894,477,5404,3334,122,37,17268
5/24/2023,19,7897,478,5667,3182,31,53,17308
5/24/2023,20,7892,477,5922,2880,3,53,17227
5/24/2023,21,7888,478,6083,2807,0,53,17309
5/24/2023,22,7892,480,5369,2903,0,53,16697
5/24/2023,23,7895,480,4771,2844,0,53,16043
5/24/2023,24,7903,292,4928,2826,0,13,15962
5/25/2023,1,7901,130,5041,2728,0,2,15802
5/25/2023,2,7902,130,4822,2536,0,11,15401
5/25/2023,3,7906,271,4900,2165,0,11,15253
5/25/2023,4,7905,383,4380,1661,0,11,14340
5/25/2023,5,7910,539,4739,1657,0,11,14856
5/25/2023,6,7907,634,5146,1475,17,13,15192
5/25/2023,7,7909,872,5864,1069,74,20,15808
5/25/2023,8,7905,923,5642,867,198,23,15558
5/25/2023,9,7908,828,5442,614,319,20,15131
5/25/2023,10,7906,877,5222,432,395,43,14875
5/25/2023,11,7904,756,4614,496,423,74,14267
5/25/2023,12,7906,951,4714,784,429,75,14859
5/25/2023,13,7903,1324,4379,1078,428,73,15185
5/25/2023,14,7901,1510,4439,1280,430,72,15632
5/25/2023,15,7905,1654,4513,1098,416,68,15654
5/25/2023,16,7905,1737,4898,987,365,71,15963
5/25/2023,17,7906,1733,5521,1212,254,71,16697
5/25/2023,18,7906,1732,5641,1052,121,69,16521
5/25/2023,19,7901,1921,5969,945,29,65,16830
5/25/2023,20,7905,1740,6163,846,4,63,16721
5/25/2023,21,7907,1290,6121,855,0,64,16237
5/25/2023,22,7903,1241,6032,838,0,64,16078
5/25/2023,23,7900,539,5661,799,0,23,14922
5/25/2023,24,7907,252,5330,820,0,11,14320
5/26/2023,1,7906,144,5284,796,0,11,14141
5/26/2023,2,7912,285,5147,757,0,11,14112
5/26/2023,3,7909,348,4945,672,0,11,13885
5/26/2023,4,7915,326,5169,610,0,11,14031
5/26/2023,5,7914,536,5243,590,0,11,14294
5/26/2023,6,7914,684,5373,601,12,35,14619
5/26/2023,7,7911,780,5837,553,71,68,15220
5/26/2023,8,7908,847,5952,227,196,75,15205
5/26/2023,9,7906,835,5861,157,314,80,15153
5/26/2023,10,7910,902,5618,141,386,87,15044
5/26/2023,11,7907,838,5920,161,415,79,15320
5/26/2023,12,7904,847,5722,310,417,78,15278
5/26/2023,13,7901,763,5303,459,424,77,14927
5/26/2023,14,7901,770,5146,625,421,77,14940
5/26/2023,15,7905,996,4884,771,408,74,15038
5/26/2023,16,7907,1232,5234,823,351,72,15619
5/26/2023,17,7910,1494,5685,754,234,72,16149
5/26/2023,18,7922,1710,6020,633,112,79,16476
5/26/2023,19,7921,1817,6143,479,27,66,16453
5/26/2023,20,7919,1644,6201,384,4,65,16217
5/26/2023,21,7910,1566,6168,300,0,65,16009
5/26/2023,22,7917,1529,5610,435,0,26,15517
5/26/2023,23,7975,1006,5099,471,0,11,14562
5/26/2023,24,7999,273,4777,546,0,11,13606
5/27/2023,1,7994,128,4482,740,0,11,13355
5/27/2023,2,8002,128,4076,819,0,11,13036
5/27/2023,3,8070,127,4129,755,0,11,13092
5/27/2023,4,8158,128,4375,601,0,11,13273
5/27/2023,5,8178,167,4622,413,0,11,13391
5/27/2023,6,8176,168,4558,369,14,11,13296
5/27/2023,7,8179,165,4905,367,69,11,13696
5/27/2023,8,8176,151,5414,227,183,11,14162
5/27/2023,9,8172,152,5193,167,301,11,13996
5/27/2023,10,8171,141,5001,179,381,11,13884
5/27/2023,11,8170,139,5058,181,417,11,13976
5/27/2023,12,8168,276,5136,193,424,11,14208
5/27/2023,13,8159,600,4606,307,425,11,14108
5/27/2023,14,8156,960,4843,418,412,11,14800
5/27/2023,15,8155,1182,4673,485,398,11,14904
5/27/2023,16,8154,1289,5074,447,330,13,15307
5/27/2023,17,8159,1596,5703,437,224,11,16130
5/27/2023,18,8167,1689,6019,424,107,11,16417
5/27/2023,19,8168,1456,5561,402,35,11,15633
5/27/2023,20,8166,1354,5486,393,6,11,15416
5/27/2023,21,8251,1198,5645,436,0,11,15541
5/27/2023,22,8327,1077,5263,590,0,11,15268
5/27/2023,23,8345,388,4851,660,0,11,14255
5/27/2023,24,8342,122,4672,717,0,11,13864
5/28/2023,1,8348,123,4485,769,0,11,13736
5/28/2023,2,8337,123,4057,658,0,11,13186
5/28/2023,3,8330,122,3983,528,0,11,12974
5/28/2023,4,8330,123,4197,449,0,11,13110
5/28/2023,5,8365,122,4239,472,0,11,13209
5/28/2023,6,8411,123,4184,394,16,11,13139
5/28/2023,7,8415,123,4441,337,72,11,13399
5/28/2023,8,8409,123,4819,140,174,11,13676
5/28/2023,9,8411,123,4937,41,272,11,13795
5/28/2023,10,8408,207,4831,35,358,11,13850
5/28/2023,11,8409,225,4950,56,411,11,14062
5/28/2023,12,8405,384,5168,120,424,11,14512
5/28/2023,13,8401,914,5092,258,426,11,15102
5/28/2023,14,8409,1496,4826,395,416,11,15553
5/28/2023,15,8415,2115,5018,501,387,11,16447
5/28/2023,16,8410,2216,5244,562,313,11,16756
5/28/2023,17,8404,2221,5618,593,220,11,17067
5/28/2023,18,8408,2245,6046,546,111,11,17367
5/28/2023,19,8409,2241,6076,562,32,11,17331
5/28/2023,20,8406,2274,5654,718,8,11,17071
5/28/2023,21,8419,2246,5222,885,0,11,16783
5/28/2023,22,8421,1795,5001,927,0,11,16155
5/28/2023,23,8420,895,4691,991,0,11,15008
5/28/2023,24,8419,586,4451,972,0,11,14439
5/29/2023,1,8424,179,4203,996,0,11,13813
5/29/2023,2,8428,129,4203,1062,0,11,13833
5/29/2023,3,8428,128,4047,1182,0,11,13796
5/29/2023,4,8430,129,3918,1243,0,11,13731
5/29/2023,5,8426,128,3891,854,0,11,13310
5/29/2023,6,8425,128,4111,1096,10,12,13782
5/29/2023,7,8427,185,4755,1081,69,23,14540
5/29/2023,8,8426,682,5765,566,187,23,15649
5/29/2023,9,8422,1616,5222,342,304,20,15926
5/29/2023,10,8416,2136,4667,248,385,26,15878
5/29/2023,11,8410,2397,4494,256,416,49,16022
5/29/2023,12,8406,2358,4636,317,424,78,16219
5/29/2023,13,8404,2506,4820,413,424,99,16666
5/29/2023,14,8404,2687,4943,497,417,183,17131
5/29/2023,15,8401,2778,5020,624,403,147,17373
5/29/2023,16,8398,3101,5340,757,338,139,18073
5/29/2023,17,8392,3357,5668,788,232,124,18561
5/29/2023,18,8403,3645,5752,737,115,102,18754
5/29/2023,19,8410,3589,5860,622,30,84,18595
5/29/2023,20,8412,3232,5809,714,5,76,18248
5/29/2023,21,8411,2897,5516,903,0,65,17792
5/29/2023,22,8414,2286,5162,1042,0,65,16969
5/29/2023,23,8413,1368,4600,1273,0,65,15719
5/29/2023,24,8413,798,4140,1277,0,65,14693
5/30/2023,1,8415,559,4000,1623,0,30,14627
5/30/2023,2,8411,552,3546,1690,0,11,14210
5/30/2023,3,8414,550,3621,1534,0,11,14130
5/30/2023,4,8410,552,3762,1628,0,11,14363
5/30/2023,5,8407,634,4129,1561,0,11,14742
5/30/2023,6,8408,919,4220,1183,10,14,14754
5/30/2023,7,8408,1459,4771,1254,71,29,15992
5/30/2023,8,8406,2142,4900,799,182,35,16464
5/30/2023,9,8403,2400,5139,526,297,24,16789
5/30/2023,10,8373,2605,5063,381,377,21,16820
5/30/2023,11,8389,2919,4840,357,410,26,16941
5/30/2023,12,8413,3500,5012,252,420,34,17631
5/30/2023,13,8411,3997,4979,263,422,47,18119
5/30/2023,14,8409,3790,5159,292,417,86,18153
5/30/2023,15,8407,3775,5330,348,392,82,18334
5/30/2023,16,8401,4285,5608,392,321,74,19081
5/30/2023,17,8395,4524,5811,381,219,86,19416
5/30/2023,18,8392,4706,5804,364,109,117,19492
5/30/2023,19,8397,4686,5742,518,31,108,19482
5/30/2023,20,8399,4352,5639,631,4,69,19094
5/30/2023,21,8396,3918,5242,879,0,64,18499
5/30/2023,22,8392,3380,4929,1268,0,64,18033
5/30/2023,23,8392,2643,4278,1264,0,25,16602
5/30/2023,24,8395,1520,4418,1440,0,10,15783
5/31/2023,1,8399,698,4580,1367,0,10,15054
5/31/2023,2,8403,605,3979,1303,0,10,14300
5/31/2023,3,8408,605,3710,1584,0,10,14317
5/31/2023,4,8409,632,3715,1497,0,10,14263
5/31/2023,5,8410,990,3998,983,0,10,14391
5/31/2023,6,8409,1835,4070,1026,13,15,15368
5/31/2023,7,8409,2464,4333,924,69,32,16231
5/31/2023,8,8404,2768,4908,766,178,33,17057
5/31/2023,9,8401,3034,5158,585,290,24,17492
5/31/2023,10,8409,3476,5132,478,368,47,17910
5/31/2023,11,8405,4276,4765,390,403,75,18314
5/31/2023,12,8402,4252,4917,421,413,77,18482
5/31/2023,13,8389,4592,5144,464,409,89,19087
5/31/2023,14,8393,4565,5522,492,404,88,19464
5/31/2023,15,8386,4999,5309,465,387,110,19656
5/31/2023,16,8392,5180,5344,418,321,151,19806
5/31/2023,17,8388,5320,5491,448,227,166,20040
5/31/2023,18,8396,4980,5859,417,112,116,19880
5/31/2023,19,8399,4794,5730,507,32,36,19498
5/31/2023,20,8399,4714,5775,517,7,22,19434
5/31/2023,21,8396,5056,5799,524,0,22,19797
5/31/2023,22,8403,4926,5432,457,0,22,19240
5/31/2023,23,8405,4120,4878,518,0,22,17943
5/31/2023,24,8405,3474,4265,551,0,21,16716
6/1/2023,1,8397,3068,3559,512,0,21,15557
6/1/2023,2,8394,2457,3879,465,0,21,15216
6/1/2023,3,8395,2285,3812,290,0,21,14803
6/1/2023,4,8396,2539,3617,169,0,21,14742
6/1/2023,5,8331,2970,3280,52,0,22,14655
6/1/2023,6,8094,3213,3628,132,14,52,15133
6/1/2023,7,8333,3446,4433,156,67,95,16530
6/1/2023,8,8385,3730,5094,96,172,99,17576
6/1/2023,9,8391,4077,5235,38,281,85,18107
6/1/2023,10,8392,4590,5091,43,358,102,18576
6/1/2023,11,8396,4723,4953,50,399,117,18638
6/1/2023,12,8394,5021,4673,136,418,122,18764
6/1/2023,13,8394,4913,4732,297,403,91,18830
6/1/2023,14,8395,5461,4903,436,401,111,19707
6/1/2023,15,8398,5200,5065,511,357,104,19635
6/1/2023,16,8389,5128,5710,610,269,102,20208
6/1/2023,17,8388,5025,5747,571,186,97,20014
6/1/2023,18,8386,4814,5677,482,108,100,19567
6/1/2023,19,8384,4793,5788,439,29,102,19535
6/1/2023,20,8377,4815,5430,547,4,103,19276
6/1/2023,21,8382,5496,5184,596,0,89,19747
6/1/2023,22,8380,4544,5202,695,0,78,18899
6/1/2023,23,8381,3926,4484,843,0,71,17705
6/1/2023,24,8384,3042,4211,942,0,71,16650
6/2/2023,1,8390,2822,4024,953,0,71,16260
6/2/2023,2,8397,2596,3872,905,0,72,15842
6/2/2023,3,8398,2450,3627,738,0,72,15285
6/2/2023,4,8406,2559,3591,732,0,71,15359
6/2/2023,5,8403,2757,3508,759,0,72,15499
6/2/2023,6,8409,3310,3800,683,14,74,16290
6/2/2023,7,8411,3611,4078,519,64,94,16777
6/2/2023,8,8409,4089,4501,237,171,101,17508
6/2/2023,9,8402,4500,4688,129,266,86,18071
6/2/2023,10,8393,4996,4622,222,347,98,18678
6/2/2023,11,8388,5191,4990,305,395,100,19369
6/2/2023,12,8379,5225,5028,468,408,100,19608
6/2/2023,13,8374,5158,5306,695,409,101,20043
6/2/2023,14,8375,4950,5384,902,384,100,20095
6/2/2023,15,8385,5059,5379,1063,337,112,20335
6/2/2023,16,8430,5227,5482,1245,267,114,20765
6/2/2023,17,8450,5118,5412,1337,196,106,20619
6/2/2023,18,8458,4882,5325,1485,94,118,20362
6/2/2023,19,8456,4304,5364,1302,29,109,19564
6/2/2023,20,8454,4404,5185,1260,4,93,19400
6/2/2023,21,8449,4693,5085,1366,0,92,19685
6/2/2023,22,8448,4365,4559,1565,0,58,18995
6/2/2023,23,8456,3533,3944,1643,0,20,17596
6/2/2023,24,8452,3031,3695,1788,0,20,16986
6/3/2023,1,8460,2017,3467,1753,0,19,15716
6/3/2023,2,8465,1380,3560,1763,0,19,15187
6/3/2023,3,8463,941,3582,1765,0,19,14770
6/3/2023,4,8449,762,3746,1794,0,19,14770
6/3/2023,5,8447,1040,3329,1764,0,19,14599
6/3/2023,6,8450,1424,3308,1451,11,19,14663
6/3/2023,7,8449,1677,3461,1061,65,20,14733
6/3/2023,8,8438,1990,3656,1115,165,40,15404
6/3/2023,9,8436,2096,4048,1264,270,68,16182
6/3/2023,10,8427,2350,4460,1275,351,73,16936
6/3/2023,11,8426,2610,4396,1324,398,73,17227
6/3/2023,12,8422,2397,4452,1595,395,73,17334
6/3/2023,13,8417,2234,4557,1914,399,73,17594
6/3/2023,14,8426,2197,4526,2186,411,73,17819
6/3/2023,15,8430,2235,4213,2368,398,73,17717
6/3/2023,16,8435,2330,4555,2294,338,90,18042
6/3/2023,17,8435,2543,4772,2305,237,77,18369
6/3/2023,18,8437,2761,4897,2226,114,104,18539
6/3/2023,19,8431,2515,4887,2202,33,76,18144
6/3/2023,20,8431,2309,4688,2095,6,75,17604
6/3/2023,21,8430,1853,4489,2169,0,92,17033
6/3/2023,22,8425,1162,4513,2133,0,74,16307
6/3/2023,23,8430,665,4332,2233,0,31,15691
6/3/2023,24,8432,179,4155,2186,0,21,14973
6/4/2023,1,8434,135,3624,2153,0,21,14367
6/4/2023,2,8435,132,3218,2042,0,21,13848
6/4/2023,3,8431,132,3425,1787,0,21,13796
6/4/2023,4,8380,132,3521,1629,0,21,13683
6/4/2023,5,8374,132,3512,1458,0,21,13497
6/4/2023,6,8379,132,3391,852,18,21,12793
6/4/2023,7,8384,132,3824,918,71,21,13350
6/4/2023,8,8378,132,4213,929,180,21,13853
6/4/2023,9,8376,132,3766,1065,292,21,13652
6/4/2023,10,8369,250,3895,1265,380,24,14183
6/4/2023,11,8364,483,3660,1435,419,34,14395
6/4/2023,12,8353,827,3681,1752,422,29,15064
6/4/2023,13,8350,953,3681,1672,416,20,15092
6/4/2023,14,8347,1487,3700,1367,410,19,15330
6/4/2023,15,8339,1728,4202,1282,384,19,15954
6/4/2023,16,8340,1938,4978,1303,312,19,16890
6/4/2023,17,8332,2362,5454,1204,210,39,17601
6/4/2023,18,8342,2399,5542,1040,99,69,17491
6/4/2023,19,8345,2659,5512,790,32,72,17410
6/4/2023,20,8358,2819,5311,672,7,69,17236
6/4/2023,21,8356,2678,5095,644,0,70,16843
6/4/2023,22,8356,2361,4606,612,0,65,16000
6/4/2023,23,8362,1951,4526,399,0,21,15259
6/4/2023,24,8366,1249,4527,311,0,19,14472
6/5/2023,1,8368,1022,4266,216,0,19,13891
6/5/2023,2,8367,756,4177,142,0,19,13461
6/5/2023,3,8368,837,4166,132,0,19,13522
6/5/2023,4,8366,1055,3907,167,0,19,13514
6/5/2023,5,8369,1408,3479,143,0,19,13418
6/5/2023,6,8368,1955,3583,204,16,21,14147
6/5/2023,7,8367,2160,4185,210,59,26,15007
6/5/2023,8,8367,2548,4636,129,125,32,15837
6/5/2023,9,8359,2766,4737,72,193,24,16151
6/5/2023,10,8358,3138,4439,66,251,30,16282
6/5/2023,11,8351,3332,4415,67,278,30,16473
6/5/2023,12,8354,3519,4487,96,327,30,16813
6/5/2023,13,8344,3811,4421,128,352,25,17081
6/5/2023,14,8339,4071,4450,173,290,28,17351
6/5/2023,15,8333,4436,4384,302,255,55,17765
6/5/2023,16,8329,4109,4412,397,240,77,17564
6/5/2023,17,8329,4322,4579,476,168,76,17950
6/5/2023,18,8340,4048,5148,461,72,83,18152
6/5/2023,19,8349,4213,5157,522,26,78,18345
6/5/2023,20,8345,4026,5029,645,6,78,18129
6/5/2023,21,8349,4101,4628,693,0,83,17854
6/5/2023,22,8342,3522,4196,794,0,73,16927
6/5/2023,23,8442,2678,3735,943,0,69,15867
6/5/2023,24,8569,1791,3617,864,0,68,14909
6/6/2023,1,8569,787,3566,800,0,29,13751
6/6/2023,2,8571,242,3600,853,0,18,13284
6/6/2023,3,8542,450,3345,962,0,18,13317
6/6/2023,4,8546,818,3283,859,0,18,13524
6/6/2023,5,8540,981,3337,898,0,18,13774
6/6/2023,6,8543,1253,3810,956,11,18,14591
6/6/2023,7,8539,1913,4240,915,30,19,15656
6/6/2023,8,8536,2242,4329,708,106,20,15941
6/6/2023,9,8547,2380,4399,574,187,25,16112
6/6/2023,10,8562,2273,4284,707,252,25,16103
6/6/2023,11,8571,1864,3856,902,352,22,15567
6/6/2023,12,8566,1851,3810,1587,391,22,16227
6/6/2023,13,8560,2045,3861,2114,406,20,17006
6/6/2023,14,8556,2260,3992,2254,374,20,17456
6/6/2023,15,8555,2355,3946,2444,338,24,17662
6/6/2023,16,8540,2411,4307,2751,280,30,18319
6/6/2023,17,8549,2594,4644,2809,195,31,18822
6/6/2023,18,8688,2577,4756,2671,85,33,18810
6/6/2023,19,8759,2855,4747,2317,29,33,18740
6/6/2023,20,8753,2917,4645,1959,6,30,18310
6/6/2023,21,8867,2862,4451,1945,0,29,18154
6/6/2023,22,8926,2277,4067,2012,0,19,17301
6/6/2023,23,8913,1517,3466,1820,0,18,15734
6/6/2023,24,8898,781,3331,1675,0,18,14703
6/7/2023,1,8907,227,3376,1760,0,18,14288
6/7/2023,2,8911,157,3241,1735,0,18,14062
6/7/2023,3,8906,165,3388,1613,0,17,14089
6/7/2023,4,8915,416,3531,1498,0,18,14378
6/7/2023,5,8916,813,3234,1306,0,18,14287
6/7/2023,6,8930,1589,3370,1214,18,19,15140
6/7/2023,7,8933,2018,3852,1051,65,27,15946
6/7/2023,8,8944,2352,4261,568,141,28,16294
6/7/2023,9,8967,2363,4265,384,236,18,16233
6/7/2023,10,8964,2508,4147,505,334,27,16485
6/7/2023,11,8957,2456,3686,422,393,28,15942
6/7/2023,12,8956,2412,3635,1054,408,30,16495
6/7/2023,13,8948,2046,3595,1830,385,30,16834
6/7/2023,14,8968,2023,3591,2303,308,32,17225
6/7/2023,15,8974,2015,3714,2363,274,40,17380
6/7/2023,16,8974,2485,3907,2410,233,44,18053
6/7/2023,17,8970,2394,4291,2497,172,47,18371
6/7/2023,18,8970,2164,4358,2511,91,54,18148
6/7/2023,19,8971,2153,4603,2356,24,33,18140
6/7/2023,20,8972,2132,4760,1863,4,30,17761
6/7/2023,21,8976,2618,4515,1390,0,29,17528
6/7/2023,22,8988,2535,3867,1299,0,23,16712
6/7/2023,23,8995,1776,3530,1085,0,16,15402
6/7/2023,24,8997,1574,3435,665,0,16,14687
6/8/2023,1,8990,740,3517,638,0,16,13901
6/8/2023,2,8990,600,3523,591,0,16,13720
6/8/2023,3,8986,544,3529,522,0,16,13597
6/8/2023,4,8976,685,3383,475,0,16,13535
6/8/2023,5,8969,1069,3251,273,0,16,13578
6/8/2023,6,8968,1781,3333,460,5,21,14568
6/8/2023,7,8962,2644,3849,434,39,52,15980
6/8/2023,8,8958,2937,3758,284,95,54,16086
6/8/2023,9,8965,3140,3693,264,149,43,16254
6/8/2023,10,8961,3225,3781,293,202,54,16516
6/8/2023,11,8960,3464,3768,377,191,59,16819
6/8/2023,12,8965,3901,3785,473,184,58,17366
6/8/2023,13,8961,3545,3793,745,155,60,17259
6/8/2023,14,8902,3208,3808,995,182,59,17154
6/8/2023,15,8957,3108,3613,1157,193,68,17096
6/8/2023,16,8957,3147,3848,1200,139,30,17321
6/8/2023,17,8956,3517,4226,1085,112,29,17925
6/8/2023,18,8957,3351,4368,938,63,29,17706
6/8/2023,19,8953,3269,4536,703,24,28,17513
6/8/2023,20,8949,3315,4508,551,4,29,17356
6/8/2023,21,8947,3342,4368,540,0,29,17226
6/8/2023,22,8951,2869,3898,547,0,23,16288
6/8/2023,23,8955,1921,3675,310,0,17,14878
6/8/2023,24,8956,1291,3621,475,0,16,14359
6/9/2023,1,8965,665,3593,348,0,16,13587
6/9/2023,2,8966,573,3464,309,0,16,13328
6/9/2023,3,8974,573,3325,396,0,16,13284
6/9/2023,4,8979,753,3263,527,0,16,13538
6/9/2023,5,8986,1334,3302,322,0,16,13960
6/9/2023,6,8988,2067,3349,392,14,16,14826
6/9/2023,7,8994,2452,3716,482,57,16,15717
6/9/2023,8,8993,3094,3781,227,125,16,16236
6/9/2023,9,8993,3300,3766,300,174,16,16549
6/9/2023,10,8985,3305,3805,387,184,16,16682
6/9/2023,11,8982,3324,3706,485,158,17,16672
6/9/2023,12,8943,3306,3559,498,198,17,16521
6/9/2023,13,8932,3026,3608,556,237,17,16376
6/9/2023,14,8934,3122,3643,511,284,17,16511
6/9/2023,15,8939,3116,3716,552,268,24,16615
6/9/2023,16,8922,3169,3885,646,236,29,16887
6/9/2023,17,8917,3199,4317,780,175,29,17417
6/9/2023,18,8919,3040,4389,785,87,30,17250
6/9/2023,19,8926,2961,4433,596,33,29,16978
6/9/2023,20,8931,3568,4150,514,9,23,17195
6/9/2023,21,8931,3809,4032,438,0,23,17233
6/9/2023,22,8941,3532,3615,403,0,15,16506
6/9/2023,23,8943,2534,3367,428,0,7,15279
6/9/2023,24,8950,1902,3069,354,0,7,14282
6/10/2023,1,8942,998,3349,581,0,7,13877
6/10/2023,2,8939,603,3333,769,0,7,13651
6/10/2023,3,8939,349,3243,803,0,7,13341
6/10/2023,4,8945,240,2948,705,0,7,12845
6/10/2023,5,8941,371,3043,472,0,7,12834
6/10/2023,6,8935,531,2972,580,17,7,13042
6/10/2023,7,8937,679,3220,521,61,7,13425
6/10/2023,8,8939,1169,3525,358,135,7,14133
6/10/2023,9,8928,1784,3663,295,200,7,14877
6/10/2023,10,8930,2361,3499,264,292,7,15353
6/10/2023,11,8930,2434,3518,349,346,7,15584
6/10/2023,12,8927,2549,3468,485,350,7,15786
6/10/2023,13,8929,2541,3487,699,361,7,16024
6/10/2023,14,8933,2506,3419,874,355,7,16094
6/10/2023,15,8931,2463,3442,1126,328,7,16297
6/10/2023,16,8929,2586,3718,1196,269,10,16708
6/10/2023,17,8928,2743,4279,1131,174,13,17268
6/10/2023,18,8939,3171,4216,970,89,14,17399
6/10/2023,19,8939,3182,4307,839,41,14,17322
6/10/2023,20,8937,2875,4208,891,6,14,16931
6/10/2023,21,8941,3145,3826,926,0,14,16852
6/10/2023,22,8947,3329,3533,842,0,14,16665
6/10/2023,23,8946,2775,3331,848,0,14,15914
6/10/2023,24,8948,1636,3410,799,0,14,14807
6/11/2023,1,8948,341,3542,757,0,15,13603
6/11/2023,2,8957,174,3723,649,0,15,13518
6/11/2023,3,8941,199,3639,541,0,15,13335
6/11/2023,4,8954,239,3527,377,0,15,13112
6/11/2023,5,8975,292,3278,360,0,15,12920
6/11/2023,6,8987,541,3140,418,5,16,13107
6/11/2023,7,8990,1228,3043,83,19,16,13379
6/11/2023,8,8991,1804,3115,271,44,16,14241
6/11/2023,9,8990,2096,3283,445,74,17,14905
6/11/2023,10,8979,2451,3377,569,112,17,15505
6/11/2023,11,8980,2587,3540,543,148,17,15815
6/11/2023,12,8981,2872,3417,589,154,17,16030
6/11/2023,13,8981,2752,3414,620,179,17,15963
6/11/2023,14,8979,2497,3420,824,165,17,15902
6/11/2023,15,8976,2725,3462,1130,119,17,16429
6/11/2023,16,8973,2467,3385,1146,105,17,16093
6/11/2023,17,8973,2435,3647,1202,66,17,16340
6/11/2023,18,8997,2520,3797,1140,41,17,16512
6/11/2023,19,9016,2621,3897,1456,15,17,17022
6/11/2023,20,8988,2531,3886,1714,1,17,17137
6/11/2023,21,8549,2506,3666,1978,0,17,16716
6/11/2023,22,8131,2466,3374,2055,0,17,16043
6/11/2023,23,8141,1809,3052,2032,0,17,15051
6/11/2023,24,8151,635,3053,1971,0,17,13827
6/12/2023,1,8146,326,2953,2044,0,17,13486
6/12/2023,2,8153,325,2900,2162,0,18,13558
6/12/2023,3,8152,459,2882,1964,0,18,13475
6/12/2023,4,8149,680,2938,2106,0,18,13891
6/12/2023,5,8143,1028,2881,1954,0,18,14024
6/12/2023,6,8133,1219,2921,2156,2,18,14449
6/12/2023,7,8124,1823,3274,2431,28,18,15698
6/12/2023,8,8112,2234,3318,2452,58,18,16192
6/12/2023,9,8113,3054,3349,2231,103,18,16868
6/12/2023,10,8106,3165,3404,2251,96,17,17039
6/12/2023,11,8098,3207,3361,2193,109,17,16985
6/12/2023,12,8100,3435,3321,2167,113,17,17153
6/12/2023,13,8104,3093,3373,1988,117,17,16692
6/12/2023,14,8102,3439,3470,1665,102,17,16795
6/12/2023,15,8102,3725,3536,1484,90,30,16967
6/12/2023,16,8103,3797,3846,1477,98,58,17379
6/12/2023,17,8102,3636,4114,1570,90,88,17600
6/12/2023,18,8099,3618,4246,1525,58,90,17636
6/12/2023,19,8099,3499,4252,1407,22,87,17366
6/12/2023,20,8087,3633,4233,1250,5,85,17293
6/12/2023,21,8091,3707,3891,1123,0,47,16859
6/12/2023,22,8095,3461,3511,1032,0,23,16122
6/12/2023,23,8092,2302,3375,1143,0,17,14929
6/12/2023,24,8097,1749,3170,1194,0,18,14228
6/13/2023,1,8101,919,3085,1303,0,9,13417
6/13/2023,2,8103,638,3064,1301,0,4,13110
6/13/2023,3,8104,661,2921,1486,0,12,13184
6/13/2023,4,8108,804,2993,1480,0,18,13403
6/13/2023,5,8112,1340,3262,1414,0,23,14151
6/13/2023,6,8112,2115,3000,1220,12,42,14501
6/13/2023,7,8112,2545,3498,1301,61,46,15563
6/13/2023,8,8116,2506,3657,1101,157,46,15583
6/13/2023,9,8112,2598,3484,1246,223,30,15693
6/13/2023,10,8112,2822,3545,786,299,38,15602
6/13/2023,11,8110,2825,3540,1411,296,44,16226
6/13/2023,12,8110,2833,3744,1367,306,46,16406
6/13/2023,13,8112,3129,3959,1440,265,46,16951
6/13/2023,14,8115,3258,4017,1242,210,46,16888
6/13/2023,15,8115,3317,4074,1078,163,52,16799
6/13/2023,16,8113,3350,4212,1217,165,53,17110
6/13/2023,17,8102,3382,4444,1098,137,30,17193
6/13/2023,18,8108,3462,4452,693,90,30,16835
6/13/2023,19,8107,3491,4585,719,32,30,16964
6/13/2023,20,8103,3229,4494,693,6,31,16556
6/13/2023,21,8104,3445,4459,567,0,31,16606
6/13/2023,22,8098,3571,3996,417,0,23,16105
6/13/2023,23,8098,2654,3653,384,0,18,14807
6/13/2023,24,8094,2117,3350,306,0,18,13885
6/14/2023,1,8092,1956,3239,292,0,18,13597
6/14/2023,2,8086,2096,3030,244,0,18,13474
6/14/2023,3,8091,2159,3047,274,0,18,13589
6/14/2023,4,8095,2157,3080,542,0,18,13892
6/14/2023,5,8093,2221,3081,467,0,18,13880
6/14/2023,6,8096,2565,3110,432,3,18,14224
6/14/2023,7,8096,3068,3552,558,25,18,15317
6/14/2023,8,8093,3266,3747,535,67,18,15726
6/14/2023,9,8091,3190,3814,666,110,18,15889
6/14/2023,10,8101,3163,3882,746,170,18,16080
6/14/2023,11,8103,3335,3945,759,210,44,16396
6/14/2023,12,8101,3682,3917,834,194,46,16774
6/14/2023,13,8089,3787,4101,862,211,46,17096
6/14/2023,14,8079,3631,4341,988,183,45,17267
6/14/2023,15,8078,3277,4587,1075,175,53,17245
6/14/2023,16,8075,3190,4940,1066,135,57,17463
6/14/2023,17,8072,3399,5112,830,116,80,17609
6/14/2023,18,8072,3491,5266,744,88,82,17743
6/14/2023,19,8068,3221,5400,550,38,81,17358
6/14/2023,20,8067,3752,5158,345,5,83,17410
6/14/2023,21,8064,4260,4692,317,0,103,17436
6/14/2023,22,8060,4126,3967,366,0,74,16593
6/14/2023,23,8069,2946,3748,340,0,68,15171
6/14/2023,24,8077,2359,3401,263,0,27,14127
6/15/2023,1,8086,1929,3405,171,0,17,13608
6/15/2023,2,8096,2127,3339,170,0,17,13749
6/15/2023,3,8102,2172,3337,398,0,17,14026
6/15/2023,4,8109,2155,3482,370,0,17,14133
6/15/2023,5,8103,2290,3564,478,0,17,14452
6/15/2023,6,8112,2585,3585,345,8,19,14654
6/15/2023,7,8103,3124,3849,292,33,38,15439
6/15/2023,8,8089,3495,3789,247,56,43,15719
6/15/2023,9,8083,3609,4018,224,105,29,16068
6/15/2023,10,8077,3756,4034,228,167,65,16327
6/15/2023,11,8076,3704,4102,279,220,100,16481
6/15/2023,12,8068,3823,4099,366,214,97,16667
6/15/2023,13,8066,4109,4166,391,211,95,17038
6/15/2023,14,8064,4235,4262,495,188,78,17322
6/15/2023,15,8065,4274,4321,566,200,83,17509
6/15/2023,16,8064,4286,4570,522,175,91,17708
6/15/2023,17,8063,4236,5045,390,88,94,17916
6/15/2023,18,8062,4176,5057,484,63,90,17932
6/15/2023,19,8060,3974,5254,561,27,90,17966
6/15/2023,20,8062,3996,5058,883,6,82,18087
6/15/2023,21,8077,4030,4478,1155,0,80,17820
6/15/2023,22,8087,3013,4188,870,0,72,16230
6/15/2023,23,8099,2612,3793,608,0,28,15140
6/15/2023,24,8093,1724,3707,856,0,17,14397
6/16/2023,1,8089,944,3487,908,0,17,13445
6/16/2023,2,8089,732,3562,880,0,17,13280
6/16/2023,3,8087,728,3382,866,0,17,13080
6/16/2023,4,8087,709,3411,1011,0,17,13235
6/16/2023,5,8085,1015,3465,702,0,17,13284
6/16/2023,6,8080,1664,3649,876,4,17,14290
6/16/2023,7,8073,2320,3983,796,19,17,15208
6/16/2023,8,8068,2672,4035,807,59,17,15658
6/16/2023,9,8068,2923,3980,853,122,23,15969
6/16/2023,10,8059,2974,3914,960,167,63,16137
6/16/2023,11,8059,2910,3929,1197,236,73,16404
6/16/2023,12,8067,3174,4079,1268,246,72,16906
6/16/2023,13,8080,3330,3935,1376,257,67,17045
6/16/2023,14,8088,3037,3978,1632,260,67,17062
6/16/2023,15,8089,2912,4141,1801,221,73,17237
6/16/2023,16,8080,2965,4494,1733,179,79,17530
6/16/2023,17,8069,3524,4622,1542,160,80,17997
6/16/2023,18,8067,3747,4633,1570,93,80,18190
6/16/2023,19,8064,3588,4794,1275,39,81,17841
6/16/2023,20,8059,3617,4822,943,8,81,17530
6/16/2023,21,8050,3841,4447,859,0,86,17283
6/16/2023,22,8045,3404,4071,945,0,75,16540
6/16/2023,23,8039,2585,3371,1080,0,67,15142
6/16/2023,24,8025,1414,3426,1212,0,66,14143
6/17/2023,1,8038,1172,3342,1170,0,65,13787
6/17/2023,2,8041,793,3418,987,0,26,13265
6/17/2023,3,8044,773,3419,927,0,16,13179
6/17/2023,4,8049,719,3340,873,0,16,12997
6/17/2023,5,8058,784,3428,798,0,16,13084
6/17/2023,6,8068,851,3435,798,19,15,13186
6/17/2023,7,8076,1169,3500,636,76,15,13472
6/17/2023,8,8070,1838,3688,292,163,16,14067
6/17/2023,9,8074,2211,3806,247,270,16,14624
6/17/2023,10,8077,2204,3722,364,354,16,14737
6/17/2023,11,8071,2254,3939,514,392,17,15187
6/17/2023,12,8059,2450,3994,593,339,16,15451
6/17/2023,13,8049,2547,3908,638,343,16,15501
6/17/2023,14,8041,2779,3835,685,330,16,15686
6/17/2023,15,8039,2983,3823,714,302,21,15882
6/17/2023,16,8033,3287,4024,763,243,50,16400
6/17/2023,17,8058,3288,4366,805,160,65,16742
6/17/2023,18,8064,3231,4342,720,98,65,16520
6/17/2023,19,8068,3172,4342,585,36,65,16268
6/17/2023,20,8069,3335,4325,554,9,65,16357
6/17/2023,21,8076,3311,4244,427,0,67,16125
6/17/2023,22,8079,3428,3840,336,0,66,15749
6/17/2023,23,8083,2719,3584,260,0,26,14672
6/17/2023,24,8087,1978,3339,260,0,17,13681
6/18/2023,1,8227,1109,3346,276,0,17,12975
6/18/2023,2,8297,558,3193,234,0,16,12298
6/18/2023,3,8287,725,3229,216,0,16,12473
6/18/2023,4,8307,689,3194,164,0,16,12370
6/18/2023,5,8487,544,3257,93,0,16,12397
6/18/2023,6,8535,609,3306,48,15,16,12529
6/18/2023,7,8547,791,3261,35,59,16,12709
6/18/2023,8,8533,1298,3496,46,140,16,13529
6/18/2023,9,8510,2169,3400,21,228,16,14344
6/18/2023,10,8521,2427,3643,12,335,16,14954
6/18/2023,11,8550,2568,3844,15,364,16,15357
6/18/2023,12,8553,2874,3925,86,377,16,15831
6/18/2023,13,8674,2833,3904,182,355,16,15964
6/18/2023,14,8697,3141,3843,151,324,32,16188
6/18/2023,15,8705,3524,3902,198,326,62,16717
6/18/2023,16,8707,3639,4317,286,296,66,17311
6/18/2023,17,8711,3933,4229,248,208,65,17394
6/18/2023,18,8716,4262,4335,148,115,80,17656
6/18/2023,19,8718,4392,4317,150,42,97,17716
6/18/2023,20,8753,4095,4270,235,10,79,17442
6/18/2023,21,8883,4207,4028,353,0,83,17554
6/18/2023,22,8886,3997,3809,425,0,38,17155
6/18/2023,23,8893,2889,3522,469,0,16,15789
6/18/2023,24,8889,1678,3103,590,0,17,14277
6/19/2023,1,8899,1023,3186,546,0,18,13672
6/19/2023,2,8903,937,3198,570,0,18,13626
6/19/2023,3,8902,973,3262,593,0,18,13748
6/19/2023,4,8901,997,3105,711,0,18,13732
6/19/2023,5,8896,1082,2922,605,0,18,13523
6/19/2023,6,8891,1552,3105,481,16,18,14063
6/19/2023,7,8887,2039,3405,870,70,18,15289
6/19/2023,8,8896,2998,3832,574,172,18,16490
6/19/2023,9,8918,3767,3977,390,265,18,17335
6/19/2023,10,8926,4011,3795,409,350,18,17509
6/19/2023,11,8933,4062,3857,510,390,18,17770
6/19/2023,12,8934,4193,3919,637,411,18,18112
6/19/2023,13,8939,4457,3867,698,391,24,18376
6/19/2023,14,8958,4471,3958,838,378,38,18641
6/19/2023,15,8956,4323,4005,1083,370,69,18806
6/19/2023,16,8948,4350,4466,1141,289,105,19299
6/19/2023,17,8962,4278,4847,1121,222,106,19536
6/19/2023,18,8964,4456,4612,1037,117,95,19281
6/19/2023,19,8964,4240,4854,1065,43,85,19251
6/19/2023,20,8963,4065,4945,1221,9,85,19288
6/19/2023,21,8961,4043,4667,1517,0,84,19272
6/19/2023,22,8957,3264,4299,1660,0,33,18213
6/19/2023,23,8957,2601,3479,1802,0,17,16856
6/19/2023,24,8958,1599,3014,1923,0,17,15511
6/20/2023,1,8971,844,3282,2038,0,17,15152
6/20/2023,2,8975,447,3318,2114,0,17,14871
6/20/2023,3,8975,361,3210,2142,0,17,14705
6/20/2023,4,8985,356,3169,2079,0,17,14606
6/20/2023,5,8981,617,3027,2147,0,17,14789
6/20/2023,6,8988,1400,2991,2014,13,18,15424
6/20/2023,7,8991,2238,3417,1624,70,18,16358
6/20/2023,8,8987,2686,3549,1529,165,18,16934
6/20/2023,9,8978,3038,3568,1543,269,18,17414
6/20/2023,10,8971,3279,3621,1550,366,18,17805
6/20/2023,11,8969,3509,3884,1410,403,18,18193
6/20/2023,12,8965,3845,3903,1337,420,19,18489
6/20/2023,13,8958,4261,3932,1210,422,45,18828
6/20/2023,14,8962,4702,4142,1103,414,84,19407
6/20/2023,15,8980,4792,4195,1233,396,108,19704
6/20/2023,16,8980,4374,4737,1315,332,92,19830
6/20/2023,17,8981,4546,4991,1398,234,98,20248
6/20/2023,18,8988,4680,4868,1628,122,98,20384
6/20/2023,19,8988,4676,4932,1608,43,85,20332
6/20/2023,20,8990,4428,4790,1492,9,86,19795
6/20/2023,21,8986,4534,4408,1496,0,96,19520
6/20/2023,22,8995,3764,4044,1589,0,34,18426
6/20/2023,23,8996,2782,3611,1626,0,17,17032
6/20/2023,24,8998,1818,3211,1820,0,17,15864
6/21/2023,1,8994,1426,3075,1853,0,17,15365
6/21/2023,2,9001,1126,3049,1791,0,17,14984
6/21/2023,3,8998,1363,2903,1480,0,17,14761
6/21/2023,4,9002,1364,3038,1612,0,17,15033
6/21/2023,5,8998,1378,3125,1440,0,17,14958
6/21/2023,6,8995,1639,3205,1247,14,17,15117
6/21/2023,7,8997,2298,3543,878,62,26,15804
6/21/2023,8,8999,3532,3826,438,152,25,16972
6/21/2023,9,8990,4203,3715,309,266,27,17510
6/21/2023,10,8986,4281,3933,397,356,33,17986
6/21/2023,11,8992,4370,4105,584,406,47,18504
6/21/2023,12,8997,4590,4174,798,414,68,19041
6/21/2023,13,9004,4900,4097,909,371,105,19386
6/21/2023,14,8990,4918,4201,1161,344,86,19700
6/21/2023,15,8968,4938,4299,1390,337,106,20038
6/21/2023,16,8943,4979,4549,1371,298,138,20278
6/21/2023,17,8910,4951,4758,1152,203,165,20139
6/21/2023,18,8907,4756,4828,1016,120,132,19759
6/21/2023,19,8906,4727,4513,1021,42,126,19335
6/21/2023,20,8900,4960,4367,883,9,132,19251
6/21/2023,21,8900,5048,4267,1036,0,160,19411
6/21/2023,22,8895,4293,3979,1237,0,112,18516
6/21/2023,23,8900,3210,3610,1410,0,27,17157
6/21/2023,24,8901,2640,3205,1556,0,18,16320
6/22/2023,1,8898,1861,3116,1545,0,18,15438
6/22/2023,2,8906,1698,3303,1355,0,18,15280
6/22/2023,3,8979,1720,3466,1181,0,18,15364
6/22/2023,4,8983,1746,3216,1073,0,18,15036
6/22/2023,5,8988,1993,2963,948,0,18,14910
6/22/2023,6,9003,2457,3353,781,13,18,15625
6/22/2023,7,9001,2810,3723,554,63,18,16169
6/22/2023,8,8995,3717,4119,247,136,18,17232
6/22/2023,9,9000,4197,4062,206,199,34,17698
6/22/2023,10,8730,4354,4387,195,291,74,18031
6/22/2023,11,8695,4472,4299,250,314,104,18134
6/22/2023,12,8690,3855,4253,526,355,75,17754
6/22/2023,13,8687,3628,4274,875,341,69,17874
6/22/2023,14,8712,4028,4463,1010,350,86,18649
6/22/2023,15,8783,4187,4566,980,324,121,18961
6/22/2023,16,8809,4670,4928,755,319,141,19622
6/22/2023,17,8960,4924,4850,598,197,146,19675
6/22/2023,18,9034,4819,4695,569,90,119,19326
6/22/2023,19,9210,4339,4716,595,32,125,19017
6/22/2023,20,9213,4613,4583,607,9,158,19183
6/22/2023,21,9209,4955,4389,685,0,185,19423
6/22/2023,22,9219,4446,3646,831,0,163,18305
6/22/2023,23,9221,3771,3439,715,0,123,17269
6/22/2023,24,9244,2852,3144,681,0,54,15975
6/23/2023,1,9263,2263,3038,594,0,18,15176
6/23/2023,2,9263,2370,2995,472,0,17,15117
6/23/2023,3,9261,2569,2916,375,0,17,15138
6/23/2023,4,9327,2758,2889,349,0,17,15340
6/23/2023,5,9330,2987,2644,204,1,17,15183
6/23/2023,6,9332,3233,3005,198,18,17,15803
6/23/2023,7,9340,3438,3495,140,60,17,16490
6/23/2023,8,9338,4204,3536,141,124,32,17375
6/23/2023,9,9332,4524,3748,83,167,62,17916
6/23/2023,10,9326,5117,4088,51,182,111,18875
6/23/2023,11,9322,5251,4191,49,212,130,19155
6/23/2023,12,9323,5563,4399,82,210,174,19751
6/23/2023,13,9324,5599,4106,91,191,118,19429
6/23/2023,14,9315,5496,4034,75,210,101,19231
6/23/2023,15,9317,5022,4196,48,188,74,18845
6/23/2023,16,9333,4961,4473,40,167,80,19054
6/23/2023,17,9363,4574,4848,50,102,81,19018
6/23/2023,18,9364,4563,4871,61,47,81,18987
6/23/2023,19,9362,4696,4878,43,23,109,19111
6/23/2023,20,9357,4662,4658,33,3,98,18811
6/23/2023,21,9362,4981,4414,50,0,133,18940
6/23/2023,22,9363,4256,3981,65,0,89,17754
6/23/2023,23,9367,3266,3558,48,0,69,16308
6/23/2023,24,9367,2703,3276,53,0,110,15509
6/24/2023,1,9373,2786,3087,58,0,42,15346
6/24/2023,2,9377,2248,3062,51,0,0,14738
6/24/2023,3,9384,2175,3006,43,0,0,14608
6/24/2023,4,9387,2127,2954,71,0,0,14539
6/24/2023,5,9387,2219,2751,97,0,0,14454
6/24/2023,6,9388,2345,2846,126,2,0,14707
6/24/2023,7,9381,2594,2728,92,29,0,14824
6/24/2023,8,9380,2601,3238,89,94,1,15403
6/24/2023,9,9376,3041,3567,45,169,23,16221
6/24/2023,10,9371,3835,3703,35,229,51,17224
6/24/2023,11,9371,4537,3797,65,282,75,18127
6/24/2023,12,9362,4624,3767,130,288,82,18253
6/24/2023,13,9365,4619,3685,294,267,77,18307
6/24/2023,14,9357,4738,3898,279,264,93,18629
6/24/2023,15,9346,4858,4167,323,285,126,19105
6/24/2023,16,9329,4862,4329,341,257,126,19244
6/24/2023,17,9337,4676,4678,306,171,110,19278
6/24/2023,18,9338,4698,4748,195,60,81,19120
6/24/2023,19,9341,4690,4547,129,30,87,18824
6/24/2023,20,9340,4781,4457,119,11,156,18864
6/24/2023,21,9347,4711,4201,176,0,164,18599
6/24/2023,22,9347,4472,3762,162,0,86,17829
6/24/2023,23,9353,3619,3306,141,0,26,16445
6/24/2023,24,9362,3114,3129,188,0,0,15793
6/25/2023,1,9370,2493,3115,311,0,0,15289
6/25/2023,2,9372,1833,2918,373,0,0,14496
6/25/2023,3,9373,1671,2813,425,0,0,14282
6/25/2023,4,9368,1673,2743,465,0,0,14249
6/25/2023,5,9372,1673,2761,458,0,0,14264
6/25/2023,6,9369,1826,3023,413,7,0,14638
6/25/2023,7,9363,2085,2910,255,52,0,14665
6/25/2023,8,9368,2428,3326,352,130,0,15604
6/25/2023,9,9373,3166,3554,352,234,0,16679
6/25/2023,10,9367,3980,3554,489,310,1,17701
6/25/2023,11,9361,4295,3520,931,359,23,18489
6/25/2023,12,9360,4293,3888,1113,336,53,19043
6/25/2023,13,9354,4455,4132,1067,351,61,19420
6/25/2023,14,9348,4581,4388,1045,353,83,19798
6/25/2023,15,9342,4591,4650,1056,330,85,20054
6/25/2023,16,9341,4635,5114,1027,263,72,20452
6/25/2023,17,9353,4683,4936,1180,189,79,20420
6/25/2023,18,9354,4593,4755,1441,90,103,20336
6/25/2023,19,9344,4471,4520,1665,30,75,20105
6/25/2023,20,9332,4037,4288,1842,2,62,19563
6/25/2023,21,9322,4410,3941,1759,0,61,19493
6/25/2023,22,9317,4473,3830,1248,0,71,18939
6/25/2023,23,9328,3974,3422,1089,0,47,17860
6/25/2023,24,9332,2848,3280,1208,0,0,16668
6/26/2023,1,9332,2282,3209,1263,0,13,16099
6/26/2023,2,9333,1946,3033,1344,0,17,15673
6/26/2023,3,9328,1917,3041,1188,0,17,15491
6/26/2023,4,9328,1937,2929,1065,0,17,15276
6/26/2023,5,9330,2321,2895,1088,1,19,15654
6/26/2023,6,9323,2577,3172,1229,4,37,16342
6/26/2023,7,9313,3045,3544,1165,39,27,17133
6/26/2023,8,9300,3888,3778,958,77,17,18018
6/26/2023,9,9301,4235,3594,1133,136,39,18438
6/26/2023,10,9305,4201,3628,1164,133,78,18509
6/26/2023,11,9313,4189,3711,1136,198,84,18631
6/26/2023,12,9301,4502,3822,1454,205,70,19354
6/26/2023,13,9306,4722,3827,1369,207,89,19520
6/26/2023,14,9311,4478,3876,1152,234,98,19149
6/26/2023,15,9308,4124,4160,994,225,81,18892
6/26/2023,16,9304,4245,4273,1048,142,87,19099
6/26/2023,17,9305,4535,4411,947,123,99,19420
6/26/2023,18,9305,4273,4377,1041,80,97,19173
6/26/2023,19,9303,4356,4354,932,21,103,19069
6/26/2023,20,9302,3917,4198,1192,2,110,18721
6/26/2023,21,9301,3951,4075,1146,0,116,18589
6/26/2023,22,9301,3631,3812,1171,0,102,18017
6/26/2023,23,9309,3273,3693,1086,0,98,17459
6/26/2023,24,9308,3031,3255,947,0,91,16632
6/27/2023,1,9303,2175,3257,910,0,36,15681
6/27/2023,2,9299,1907,3173,883,0,18,15280
6/27/2023,3,9293,1860,3051,876,0,18,15098
6/27/2023,4,9283,1984,3321,765,0,18,15371
6/27/2023,5,9287,2085,3430,631,0,18,15451
6/27/2023,6,9299,2308,3584,859,3,18,16071
6/27/2023,7,9312,2866,3789,1203,32,18,17220
6/27/2023,8,9316,3289,4118,1262,59,18,18062
6/27/2023,9,9317,3533,4065,1251,112,34,18312
6/27/2023,10,9312,3495,3973,1474,131,72,18457
6/27/2023,11,9310,3746,3924,1639,170,78,18867
6/27/2023,12,9310,4168,3911,1843,211,91,19534
6/27/2023,13,9315,4247,3812,1815,276,113,19578
6/27/2023,14,9314,4008,3726,2007,236,83,19374
6/27/2023,15,9315,3817,4068,2074,232,80,19586
6/27/2023,16,9317,3777,4156,2065,161,83,19559
6/27/2023,17,9312,3988,4503,2027,112,91,20033
6/27/2023,18,9311,4058,4247,2044,65,139,19864
6/27/2023,19,9310,3666,4169,2160,32,140,19477
6/27/2023,20,9319,3367,4160,2044,5,90,18985
6/27/2023,21,9332,3452,3988,1946,0,111,18829
6/27/2023,22,9334,3087,3621,1832,0,98,17972
6/27/2023,23,9340,2488,3255,1818,0,69,16970
6/27/2023,24,9348,1981,2610,1823,0,33,15795
6/28/2023,1,9349,1432,3033,1808,0,18,15640
6/28/2023,2,9361,1353,3003,1919,0,18,15654
6/28/2023,3,9364,1600,2798,1579,0,18,15359
6/28/2023,4,9369,1910,2926,1372,0,18,15595
6/28/2023,5,9379,2136,3580,662,0,19,15776
6/28/2023,6,9386,2364,3617,519,7,40,15933
6/28/2023,7,9388,2695,3862,697,44,45,16731
6/28/2023,8,9396,3353,3841,584,109,44,17327
6/28/2023,9,9401,3482,3892,496,180,29,17480
6/28/2023,10,9412,3736,3592,593,228,36,17597
6/28/2023,11,9425,3805,3344,769,260,43,17646
6/28/2023,12,9429,3665,3703,787,282,39,17905
6/28/2023,13,9434,3884,3817,722,307,43,18207
6/28/2023,14,9431,4490,4047,655,292,42,18957
6/28/2023,15,9414,4468,4467,530,274,48,19201
6/28/2023,16,9396,4895,4758,495,250,63,19857
6/28/2023,17,9393,4874,4907,420,215,83,19892
6/28/2023,18,9384,4665,4844,312,130,84,19419
6/28/2023,19,9383,4734,4677,219,41,84,19138
6/28/2023,20,9391,4540,4556,210,8,106,18811
6/28/2023,21,9388,4495,4415,231,0,93,18622
6/28/2023,22,9406,4320,3873,186,0,93,17878
6/28/2023,23,9422,3480,3545,159,0,71,16677
6/28/2023,24,9419,2582,3093,152,0,35,15281
6/29/2023,1,9421,2126,2961,145,0,18,14671
6/29/2023,2,9430,1829,3120,134,0,18,14531
6/29/2023,3,9481,1927,2944,140,0,18,14510
6/29/2023,4,9490,2099,2887,195,0,18,14689
6/29/2023,5,9337,2395,3417,97,0,18,15264
6/29/2023,6,9203,2462,3653,239,15,21,15593
6/29/2023,7,9200,2626,3809,402,64,19,16120
6/29/2023,8,9417,2922,3750,302,152,18,16561
6/29/2023,9,9435,3569,3710,237,240,18,17209
6/29/2023,10,9424,3856,3605,535,326,19,17765
6/29/2023,11,9366,3968,3720,714,364,19,18151
6/29/2023,12,8911,4514,4078,412,393,19,18327
6/29/2023,13,8898,4698,4186,467,395,19,18663
6/29/2023,14,8907,4793,4040,479,368,35,18622
6/29/2023,15,8929,4366,4145,527,330,75,18372
6/29/2023,16,8941,3904,4667,529,285,88,18414
6/29/2023,17,8943,4256,4940,669,209,100,19117
6/29/2023,18,8950,3678,5101,794,104,102,18729
6/29/2023,19,8949,3864,5070,1079,35,116,19113
6/29/2023,20,8953,3635,4811,1278,7,107,18791
6/29/2023,21,8950,3054,4627,1552,0,107,18290
6/29/2023,22,8945,3333,4106,1680,0,105,18169
6/29/2023,23,8953,2702,3637,1647,0,76,17015
6/29/2023,24,8952,2402,3385,1591,0,25,16355
6/30/2023,1,8953,2041,3472,1467,0,17,15950
6/30/2023,2,8944,1876,3170,1596,0,17,15603
6/30/2023,3,8932,2077,2929,1285,0,17,15240
6/30/2023,4,8923,2312,2966,1221,0,17,15439
6/30/2023,5,8922,2829,2904,899,0,17,15571
6/30/2023,6,8922,2944,2907,749,5,18,15545
6/30/2023,7,8920,2975,3353,753,35,18,16054
6/30/2023,8,8905,3515,4151,661,89,18,17339
6/30/2023,9,8895,4525,4033,411,135,18,18017
6/30/2023,10,8909,4853,4319,389,171,18,18659
6/30/2023,11,8911,4473,4304,441,238,18,18385
6/30/2023,12,8910,4813,4398,486,267,18,18892
6/30/2023,13,8888,4863,4464,547,339,18,19119
6/30/2023,14,8857,4918,4692,586,315,18,19386
6/30/2023,15,8842,4999,4865,497,292,23,19518
6/30/2023,16,8839,5212,5109,472,275,47,19954
6/30/2023,17,8840,5549,5042,563,176,80,20250
6/30/2023,18,8840,5301,5068,414,100,85,19808
6/30/2023,19,8843,5200,5000,323,34,85,19485
6/30/2023,20,8835,5024,4907,313,7,85,19171
6/30/2023,21,8840,4731,4598,420,0,86,18675
6/30/2023,22,8841,4598,4213,542,0,58,18252
6/30/2023,23,8839,3829,3786,819,0,18,17291
6/30/2023,24,8830,2859,3396,1013,0,18,16116
7/1/2023,1,8828,2789,3050,1053,0,18,15738
7/1/2023,2,8825,2477,2930,1270,0,18,15520
7/1/2023,3,8821,1972,2798,1293,0,18,14902
7/1/2023,4,8830,2016,2913,1013,0,18,14790
7/1/2023,5,8830,2226,2864,820,0,18,14758
7/1/2023,6,8835,2365,3027,568,5,18,14818
7/1/2023,7,8839,2535,3087,383,44,26,14914
7/1/2023,8,8835,3072,3321,369,123,31,15751
7/1/2023,9,8836,3420,3689,283,221,31,16480
7/1/2023,10,8831,4372,3892,230,295,36,17656
7/1/2023,11,8822,4965,4172,213,326,46,18544
7/1/2023,12,8810,5248,4558,228,337,43,19224
7/1/2023,13,8815,5367,4320,223,287,37,19049
7/1/2023,14,8813,5392,4428,300,215,40,19188
7/1/2023,15,8810,4912,4384,288,196,66,18656
7/1/2023,16,8805,4541,4662,209,128,98,18443
7/1/2023,17,8801,4797,4665,170,94,98,18625
7/1/2023,18,8797,5005,4533,119,82,98,18634
7/1/2023,19,8796,4507,4469,235,41,89,18137
7/1/2023,20,8796,4571,4290,234,7,85,17983
7/1/2023,21,8792,5024,4134,238,0,39,18227
7/1/2023,22,8805,5203,3739,256,0,31,18034
7/1/2023,23,8808,4630,3553,353,0,31,17375
7/1/2023,24,8812,3770,3417,365,0,31,16395
7/2/2023,1,8820,3202,3385,283,0,22,15712
7/2/2023,2,8817,2598,3224,257,0,18,14914
7/2/2023,3,8810,2183,3275,157,0,18,14443
7/2/2023,4,8806,2209,3331,126,0,18,14490
7/2/2023,5,8799,2318,2927,156,0,18,14218
7/2/2023,6,8796,2574,2973,204,4,17,14568
7/2/2023,7,8793,2774,2907,294,30,26,14824
7/2/2023,8,8793,3003,2911,368,57,31,15163
7/2/2023,9,8794,3168,3474,389,106,31,15962
7/2/2023,10,8786,3825,3589,232,150,31,16613
7/2/2023,11,8788,4235,3647,201,128,31,17030
7/2/2023,12,8781,4664,3686,192,162,31,17516
7/2/2023,13,8787,4451,4007,165,188,31,17629
7/2/2023,14,8786,4641,4135,196,177,31,17966
7/2/2023,15,8777,4678,4348,251,146,53,18253
7/2/2023,16,8762,4596,4967,204,142,82,18753
7/2/2023,17,8772,5001,5151,106,104,84,19218
7/2/2023,18,8777,5050,5173,87,66,85,19238
7/2/2023,19,8782,5072,5138,97,33,85,19207
7/2/2023,20,8772,5114,4925,111,5,68,18995
7/2/2023,21,8775,5120,4560,147,0,33,18635
7/2/2023,22,8769,5049,3925,167,0,36,17946
7/2/2023,23,8773,4609,3390,175,0,40,16987
7/2/2023,24,8776,3700,3276,164,0,43,15959
7/3/2023,1,8788,3163,3185,140,0,35,15311
7/3/2023,2,8785,2936,3070,115,0,35,14941
7/3/2023,3,8785,2675,3031,138,0,31,14660
7/3/2023,4,8786,2762,2848,160,0,30,14586
7/3/2023,5,8804,2752,2765,183,0,32,14536
7/3/2023,6,8819,2824,2796,146,4,33,14622
7/3/2023,7,8814,2782,2938,96,28,37,14695
7/3/2023,8,8802,3050,3460,85,63,45,15505
7/3/2023,9,8791,3456,3860,64,125,38,16334
7/3/2023,10,8787,4234,3769,73,169,51,17083
7/3/2023,11,8787,4816,3790,127,192,64,17776
7/3/2023,12,8775,5088,4253,184,248,70,18618
7/3/2023,13,8767,5363,4368,198,293,72,19061
7/3/2023,14,8765,5443,4467,342,270,72,19359
7/3/2023,15,8766,5283,4921,434,273,72,19749
7/3/2023,16,8768,4909,5243,475,268,73,19736
7/3/2023,17,8769,5103,5612,481,170,77,20212
7/3/2023,18,8772,5388,5540,512,119,113,20444
7/3/2023,19,8783,5317,5437,499,38,126,20200
7/3/2023,20,8793,5277,5101,410,8,127,19716
7/3/2023,21,8805,5396,4627,395,0,114,19337
7/3/2023,22,8817,5201,4036,376,0,116,18546
7/3/2023,23,8822,4751,3615,267,0,82,17537
7/3/2023,24,8821,3874,3049,196,0,74,16014
7/4/2023,1,8819,3532,3059,126,0,63,15599
7/4/2023,2,8814,3246,2892,50,0,58,15060
7/4/2023,3,8813,3232,2880,52,0,59,15036
7/4/2023,4,8809,3281,2761,72,0,62,14985
7/4/2023,5,8800,3355,2516,14,0,62,14747
7/4/2023,6,8806,3481,2710,36,5,61,15099
7/4/2023,7,8798,3722,3680,106,52,69,16427
7/4/2023,8,8790,4592,3956,29,145,75,17587
7/4/2023,9,8793,5362,4142,7,259,64,18627
7/4/2023,10,8811,5720,4327,11,351,61,19281
7/4/2023,11,8809,5906,4526,45,391,67,19744
7/4/2023,12,8808,5938,4736,91,371,76,20020
7/4/2023,13,8801,5927,4833,152,386,110,20209
7/4/2023,14,8810,5939,4956,248,382,119,20454
7/4/2023,15,8559,5930,5007,334,346,115,20291
7/4/2023,16,8210,6067,5310,428,261,126,20402
7/4/2023,17,8276,5926,5276,468,148,115,20209
7/4/2023,18,8343,5518,5103,451,124,112,19651
7/4/2023,19,8356,5898,5279,334,35,113,20015
7/4/2023,20,8359,6133,5241,305,7,142,20187
7/4/2023,21,8355,6159,5104,306,0,123,20047
7/4/2023,22,8343,6129,4753,362,0,123,19710
7/4/2023,23,8342,5628,3678,522,0,125,18295
7/4/2023,24,8336,5118,2989,532,0,131,17106
7/5/2023,1,8339,4711,2846,575,0,123,16594
7/5/2023,2,8337,3813,2783,693,0,114,15740
7/5/2023,3,8347,3694,2568,767,0,115,15491
7/5/2023,4,8344,3761,2444,665,0,114,15328
7/5/2023,5,8355,3819,2526,522,0,115,15337
7/5/2023,6,8369,3851,2878,529,7,116,15750
7/5/2023,7,8383,4571,3557,471,52,122,17156
7/5/2023,8,8378,5536,3536,233,156,128,17967
7/5/2023,9,8366,6145,4058,121,262,112,19064
7/5/2023,10,8376,6277,4228,168,344,117,19510
7/5/2023,11,8363,6339,5146,90,391,113,20442
7/5/2023,12,8346,6363,4996,161,404,117,20387
7/5/2023,13,8317,6255,4920,287,380,117,20276
7/5/2023,14,8311,6352,5124,374,363,117,20641
7/5/2023,15,8297,6569,5246,504,315,116,21047
7/5/2023,16,8287,6688,5163,706,277,119,21240
7/5/2023,17,8291,6707,5300,604,210,116,21228
7/5/2023,18,8308,6814,5557,401,109,119,21308
7/5/2023,19,8323,6905,5432,316,31,122,21129
7/5/2023,20,8337,6684,5122,404,6,122,20675
7/5/2023,21,8337,6489,4932,573,0,122,20453
7/5/2023,22,8347,6183,4641,710,0,117,19998
7/5/2023,23,8353,5259,4398,776,0,67,18853
7/5/2023,24,8359,5277,3631,792,0,50,18109
7/6/2023,1,8410,5126,3172,729,0,46,17483
7/6/2023,2,8472,4532,3170,704,0,42,16920
7/6/2023,3,8475,4285,3109,530,0,43,16442
7/6/2023,4,8480,4175,3059,477,0,44,16235
7/6/2023,5,8480,4338,3142,480,0,44,16484
7/6/2023,6,8483,4358,3769,447,7,43,17107
7/6/2023,7,8487,5036,3918,332,45,49,17867
7/6/2023,8,8485,6039,3913,203,131,73,18844
7/6/2023,9,8476,6255,4163,414,212,104,19624
7/6/2023,10,8484,6303,4323,529,263,109,20011
7/6/2023,11,8501,6571,4678,453,292,109,20604
7/6/2023,12,8585,6519,4879,499,306,107,20895
7/6/2023,13,8631,6412,4881,459,322,113,20818
7/6/2023,14,8643,6220,4596,389,323,112,20283
7/6/2023,15,8643,5730,4796,406,273,110,19958
7/6/2023,16,8636,6202,5467,212,267,110,20894
7/6/2023,17,8666,6426,5739,180,136,109,21256
7/6/2023,18,8690,6088,5454,364,64,106,20766
7/6/2023,19,8705,6056,5282,424,34,107,20608
7/6/2023,20,8884,6142,5150,569,7,105,20857
7/6/2023,21,8890,6122,5043,433,0,111,20599
7/6/2023,22,8971,5972,4951,406,0,66,20366
7/6/2023,23,9100,4805,4554,593,0,55,19107
7/6/2023,24,9077,4449,3688,585,0,55,17854
7/7/2023,1,9076,4343,3093,813,0,47,17372
7/7/2023,2,9228,3954,3033,993,0,43,17251
7/7/2023,3,9273,3238,3202,1142,0,43,16898
7/7/2023,4,9282,2949,2935,1138,0,45,16349
7/7/2023,5,9277,3106,3221,1034,0,44,16682
7/7/2023,6,9290,3161,3427,911,6,43,16838
7/7/2023,7,9301,3690,3840,739,48,50,17668
7/7/2023,8,9316,4081,4048,606,128,67,18246
7/7/2023,9,9334,4292,4204,554,183,65,18632
7/7/2023,10,9342,4611,4271,552,249,73,19098
7/7/2023,11,9353,4582,4437,497,296,73,19238
7/7/2023,12,9362,5191,4392,438,300,90,19773
7/7/2023,13,9374,5464,4462,488,333,123,20244
7/7/2023,14,9322,5449,4474,533,331,128,20237
7/7/2023,15,9388,5812,4667,499,330,125,20821
7/7/2023,16,9395,5569,4830,466,278,129,20667
7/7/2023,17,9403,5505,4932,420,203,130,20593
7/7/2023,18,9380,5740,5044,324,114,129,20731
7/7/2023,19,9352,5894,5074,246,33,128,20727
7/7/2023,20,9318,5986,4492,234,6,126,20162
7/7/2023,21,9312,5199,4248,298,0,78,19135
7/7/2023,22,9313,4582,4148,383,0,61,18487
7/7/2023,23,9335,3986,4004,481,0,70,17876
7/7/2023,24,9355,3620,3720,541,0,74,17310
7/8/2023,1,9372,2992,3635,520,0,65,16584
7/8/2023,2,9388,2452,3494,412,0,61,15807
7/8/2023,3,9411,2248,3332,449,0,59,15499
7/8/2023,4,9414,2157,3207,552,0,59,15389
7/8/2023,5,9429,2225,3120,662,0,59,15495
7/8/2023,6,9427,2410,3180,626,11,60,15714
7/8/2023,7,9406,2532,3557,505,54,67,16121
7/8/2023,8,9388,2705,3522,340,132,73,16160
7/8/2023,9,9373,2930,3750,305,217,63,16638
7/8/2023,10,9361,3570,3871,344,272,68,17486
7/8/2023,11,9346,4226,3862,450,278,69,18231
7/8/2023,12,9350,4461,3984,463,294,71,18623
7/8/2023,13,9340,4624,4008,331,285,70,18658
7/8/2023,14,9335,4671,3970,409,235,72,18692
7/8/2023,15,9340,4377,4472,433,211,71,18904
7/8/2023,16,9338,4257,4898,449,180,72,19194
7/8/2023,17,9366,4286,5136,513,140,71,19512
7/8/2023,18,9433,3812,5307,371,94,72,19089
7/8/2023,19,9558,4228,5062,284,31,73,19236
7/8/2023,20,9578,4080,4901,244,5,74,18882
7/8/2023,21,9607,4397,4212,328,0,68,18612
7/8/2023,22,9635,3645,4085,237,0,69,17671
7/8/2023,23,9642,3131,4085,269,0,76,17203
7/8/2023,24,9647,3063,3779,251,0,74,16814
7/9/2023,1,9648,1982,3829,238,0,68,15765
7/9/2023,2,9616,1619,3604,281,0,61,15181
7/9/2023,3,9634,1310,3399,329,0,60,14732
7/9/2023,4,9644,1013,3336,361,0,60,14414
7/9/2023,5,9633,905,3100,382,0,61,14081
7/9/2023,6,9628,1071,3135,375,4,60,14273
7/9/2023,7,9621,1432,3249,248,29,67,14646
7/9/2023,8,9606,2149,3378,132,63,72,15400
7/9/2023,9,9597,3046,3650,91,111,56,16551
7/9/2023,10,9589,3360,3585,117,185,63,16899
7/9/2023,11,9596,3665,3783,181,194,65,17484
7/9/2023,12,9609,3859,3638,438,180,66,17790
7/9/2023,13,9605,4041,3881,587,220,65,18399
7/9/2023,14,9594,4246,4089,562,244,64,18799
7/9/2023,15,9595,4557,4440,673,204,65,19534
7/9/2023,16,9614,4499,4797,800,173,65,19948
7/9/2023,17,9653,4834,5094,670,96,65,20412
7/9/2023,18,9687,5115,5316,528,57,68,20771
7/9/2023,19,9664,5239,5368,332,31,69,20703
7/9/2023,20,9646,4936,4650,260,6,69,19567
7/9/2023,21,9630,4788,4324,265,0,60,19067
7/9/2023,22,9563,4564,4047,275,0,66,18515
7/9/2023,23,9625,3894,3448,263,0,74,17304
7/9/2023,24,9620,3267,3192,303,0,74,16456
7/10/2023,1,9628,2703,2935,322,0,66,15654
7/10/2023,2,9626,2230,2902,309,0,60,15127
7/10/2023,3,9630,2132,2829,306,0,59,14956
7/10/2023,4,9599,2177,2799,270,0,59,14904
7/10/2023,5,9588,2263,2813,413,0,59,15136
7/10/2023,6,9591,2344,3193,552,3,59,15742
7/10/2023,7,9598,2958,3148,577,31,68,16380
7/10/2023,8,9630,3374,3385,427,108,73,16997
7/10/2023,9,9643,4687,3589,365,195,58,18537
7/10/2023,10,9633,5010,3623,365,280,66,18977
7/10/2023,11,9612,4915,3679,460,311,74,19051
7/10/2023,12,9598,5082,3956,550,303,74,19563
7/10/2023,13,9564,5244,3972,703,273,74,19830
7/10/2023,14,9545,5248,4112,816,299,74,20094
7/10/2023,15,9414,5470,4509,987,298,70,20748
7/10/2023,16,9520,5565,4951,1148,242,69,21495
7/10/2023,17,9514,5523,5215,1315,189,64,21820
7/10/2023,18,9536,5710,5180,1251,110,63,21850
7/10/2023,19,9542,5716,5108,1141,45,66,21618
7/10/2023,20,9543,5619,4986,1161,9,66,21384
7/10/2023,21,9529,5180,4566,1446,0,66,20787
7/10/2023,22,9620,4416,4354,1777,0,57,20224
7/10/2023,23,9779,3429,3543,2035,0,67,18853
7/10/2023,24,9429,2904,3297,1969,0,73,17672
7/11/2023,1,9706,1869,2786,1931,0,66,16358
7/11/2023,2,9790,1653,3077,1842,0,62,16424
7/11/2023,3,9821,1654,2752,1801,0,62,16090
7/11/2023,4,9815,1653,2973,1688,0,62,16191
7/11/2023,5,9806,1737,3194,1403,0,61,16201
7/11/2023,6,9794,1967,3141,1408,6,60,16376
7/11/2023,7,9789,2525,3287,1168,46,70,16885
7/11/2023,8,9788,3145,3798,837,144,72,17784
7/11/2023,9,9775,4300,3789,910,255,58,19087
7/11/2023,10,9771,4369,4006,1226,347,58,19777
7/11/2023,11,9756,4292,4181,1629,384,71,20313
7/11/2023,12,9748,4716,4294,1773,381,75,20987
7/11/2023,13,9764,4699,4345,2022,391,72,21293
7/11/2023,14,9775,4517,4471,2205,363,66,21397
7/11/2023,15,9788,4535,4532,2492,344,66,21757
7/11/2023,16,9779,4406,4728,2302,263,72,21550
7/11/2023,17,9786,4157,4916,2155,135,92,21241
7/11/2023,18,9801,4192,4979,1527,69,122,20690
7/11/2023,19,9820,4655,5081,1248,20,113,20937
7/11/2023,20,9825,4783,5019,861,4,115,20607
7/11/2023,21,9844,5179,4736,843,0,115,20717
7/11/2023,22,9845,4524,4211,845,0,122,19547
7/11/2023,23,9848,3774,3920,789,0,83,18414
7/11/2023,24,9855,2526,3773,635,0,64,16853
7/12/2023,1,9869,1723,3440,634,0,49,15715
7/12/2023,2,9939,1614,3034,715,0,56,15358
7/12/2023,3,10066,1698,3065,776,0,58,15663
7/12/2023,4,10077,1821,3006,881,0,58,15843
7/12/2023,5,10083,2123,2700,633,0,57,15596
7/12/2023,6,10083,2653,2704,444,9,58,15951
7/12/2023,7,10088,2904,3330,456,60,61,16899
7/12/2023,8,10093,2929,3822,267,125,66,17302
7/12/2023,9,10102,3244,3989,159,190,60,17744
7/12/2023,10,10097,3271,4185,123,242,64,17982
7/12/2023,11,10099,3662,4257,148,258,70,18494
7/12/2023,12,10077,3747,4383,154,299,72,18732
7/12/2023,13,10071,4265,4661,201,337,69,19604
7/12/2023,14,10062,4718,4855,189,336,64,20224
7/12/2023,15,10053,4950,4889,130,288,61,20371
7/12/2023,16,10085,5041,5311,79,233,57,20806
7/12/2023,17,10063,5492,5240,90,136,53,21074
7/12/2023,18,10157,4876,5003,67,43,56,20202
7/12/2023,19,10162,4536,5087,95,24,54,19958
7/12/2023,20,10167,4285,4796,228,3,62,19541
7/12/2023,21,10163,4220,4561,410,0,57,19411
7/12/2023,22,10172,3409,4177,723,0,56,18537
7/12/2023,23,10212,2898,3690,859,0,64,17723
7/12/2023,24,10234,1899,3512,891,0,71,16607
7/13/2023,1,10236,1498,2844,1396,0,62,16036
7/13/2023,2,10237,875,2988,1827,0,56,15983
7/13/2023,3,10248,746,2725,2258,0,59,16036
7/13/2023,4,10264,711,2801,2528,0,58,16362
7/13/2023,5,10282,983,3331,1664,0,57,16317
7/13/2023,6,10293,1613,3536,1421,2,59,16924
7/13/2023,7,10298,2124,3222,1806,21,67,17538
7/13/2023,8,10272,2226,3314,1875,90,70,17847
7/13/2023,9,10260,2339,3640,1778,139,55,18211
7/13/2023,10,10244,2599,4145,1667,200,56,18911
7/13/2023,11,10234,3363,4550,1328,262,67,19804
7/13/2023,12,10226,4090,4731,1031,262,70,20410
7/13/2023,13,10223,4544,4671,841,257,70,20606
7/13/2023,14,10211,4192,4813,848,271,67,20402
7/13/2023,15,10210,3785,4852,797,264,71,19979
7/13/2023,16,10211,3720,4957,802,244,72,20006
7/13/2023,17,10222,4041,5256,698,173,73,20463
7/13/2023,18,10265,4281,5334,653,112,72,20717
7/13/2023,19,10304,4623,5236,417,35,72,20687
7/13/2023,20,10312,4710,4896,282,6,70,20276
7/13/2023,21,10329,4555,4584,284,0,58,19810
7/13/2023,22,10331,4034,4362,346,0,61,19134
7/13/2023,23,10332,2947,4022,416,0,70,17787
7/13/2023,24,10322,2389,3510,448,0,69,16738
7/14/2023,1,10308,1737,3318,422,0,64,15849
7/14/2023,2,10289,1244,2998,439,0,55,15025
7/14/2023,3,10280,1213,3170,340,0,56,15059
7/14/2023,4,10269,1542,3237,321,0,54,15423
7/14/2023,5,10264,1751,3219,287,0,55,15576
7/14/2023,6,10267,2042,3284,232,8,56,15889
7/14/2023,7,10246,2707,3415,212,51,67,16698
7/14/2023,8,10259,3164,3762,162,132,71,17550
7/14/2023,9,10274,4071,3894,203,244,63,18749
7/14/2023,10,10284,4020,4110,511,300,68,19293
7/14/2023,11,10292,3995,4213,796,309,74,19679
7/14/2023,12,10285,3993,4326,1123,325,74,20126
7/14/2023,13,10293,4031,4338,1107,374,74,20217
7/14/2023,14,10294,4024,4511,1053,385,73,20340
7/14/2023,15,10282,4029,4701,1019,335,71,20437
7/14/2023,16,10255,4572,5103,754,260,72,21016
7/14/2023,17,10248,5014,5138,592,194,73,21259
7/14/2023,18,10235,4735,5206,612,86,34,20908
7/14/2023,19,10225,4003,5397,727,29,31,20412
7/14/2023,20,10209,4343,5002,849,10,31,20444
7/14/2023,21,10185,4402,4788,925,0,46,20346
7/14/2023,22,10167,3986,4483,1056,0,65,19757
7/14/2023,23,10173,2779,4126,1159,0,70,18307
7/14/2023,24,10178,1948,3890,1245,0,72,17333
7/15/2023,1,10206,1441,3394,1428,0,68,16537
7/15/2023,2,10232,1002,3417,1372,0,60,16083
7/15/2023,3,10257,922,3226,1361,0,60,15826
7/15/2023,4,10259,906,3141,1262,0,58,15626
7/15/2023,5,10253,1080,3183,1290,0,59,15865
7/15/2023,6,10241,1407,2879,1401,11,58,15997
7/15/2023,7,10224,1795,3298,784,49,60,16210
7/15/2023,8,10210,2451,3798,433,82,71,17045
7/15/2023,9,10187,2724,3875,406,165,64,17421
7/15/2023,10,10165,3007,3933,472,212,67,17856
7/15/2023,11,10157,3461,4134,494,243,72,18561
7/15/2023,12,10150,3728,4131,644,216,70,18939
7/15/2023,13,10138,3893,4249,696,190,62,19228
7/15/2023,14,10120,3968,4786,739,143,47,19803
7/15/2023,15,10115,4026,4528,681,145,75,19570
7/15/2023,16,10122,4033,4611,627,116,75,19584
7/15/2023,17,10132,3883,5012,712,90,75,19904
7/15/2023,18,10144,3873,5037,539,47,74,19714
7/15/2023,19,10128,3883,5102,470,19,75,19677
7/15/2023,20,10141,4002,4900,413,4,74,19534
7/15/2023,21,10175,4236,4331,397,0,67,19206
7/15/2023,22,10191,3473,4295,499,0,73,18531
7/15/2023,23,10191,2829,3955,448,0,74,17497
7/15/2023,24,10185,2282,3365,444,0,73,16349
7/16/2023,1,10184,1818,3072,544,0,66,15684
7/16/2023,2,10183,1393,3152,695,0,59,15482
7/16/2023,3,10176,1396,3110,715,0,58,15455
7/16/2023,4,10175,943,3154,600,0,60,14932
7/16/2023,5,10162,1210,3335,435,0,55,15197
7/16/2023,6,10151,1684,3095,354,2,18,15304
7/16/2023,7,10146,2094,3059,239,25,31,15594
7/16/2023,8,10124,2409,3234,125,72,36,16000
7/16/2023,9,10102,2488,3526,137,99,36,16388
7/16/2023,10,10098,2994,3877,193,141,45,17348
7/16/2023,11,10110,3303,3993,288,204,49,17947
7/16/2023,12,10147,3469,4294,512,256,51,18729
7/16/2023,13,10174,3300,4363,965,268,60,19130
7/16/2023,14,10187,3480,4413,1412,275,55,19822
7/16/2023,15,10193,3443,4660,1638,301,71,20306
7/16/2023,16,10181,3614,5057,1833,236,75,20996
7/16/2023,17,10161,3875,5078,1947,169,76,21306
7/16/2023,18,10162,3868,4985,1880,117,75,21087
7/16/2023,19,10147,3874,4912,1564,44,76,20617
7/16/2023,20,10144,3695,4762,1347,10,75,20033
7/16/2023,21,10136,3597,4669,1440,4,76,19922
7/16/2023,22,10127,2891,4303,1616,4,75,19016
7/16/2023,23,10111,2457,4072,1448,4,70,18162
7/16/2023,24,10106,1923,3843,1201,4,74,17151
7/17/2023,1,10106,1573,3630,1008,4,65,16386
7/17/2023,2,10097,1361,3312,954,4,61,15789
7/17/2023,3,9652,1366,3354,1168,4,60,15604
7/17/2023,4,9620,1424,3164,1325,4,61,15598
7/17/2023,5,9637,1595,3093,1301,4,61,15691
7/17/2023,6,9653,2020,3338,1078,10,61,16160
7/17/2023,7,9666,2503,3665,801,53,67,16755
7/17/2023,8,9678,2896,3709,954,138,75,17450
7/17/2023,9,9684,3352,3811,1058,209,67,18181
7/17/2023,10,9685,3800,3915,1133,269,73,18875
7/17/2023,11,9678,4562,4067,949,305,76,19637
7/17/2023,12,9661,5397,4172,1025,320,76,20651
7/17/2023,13,9655,5629,4393,1190,344,92,21303
7/17/2023,14,9644,5355,4269,1336,344,121,21069
7/17/2023,15,9632,4501,4515,1475,326,128,20577
7/17/2023,16,9618,5032,4893,1403,289,94,21329
7/17/2023,17,9609,5730,5044,1125,196,89,21793
7/17/2023,18,9607,5550,4931,731,118,87,21024
7/17/2023,19,9607,5385,4830,554,47,82,20505
7/17/2023,20,9618,5261,4974,457,10,82,20402
7/17/2023,21,9638,5464,4895,360,0,83,20440
7/17/2023,22,9647,4800,4464,347,0,82,19340
7/17/2023,23,9655,4080,4027,303,0,41,18106
7/17/2023,24,9662,3273,3616,311,0,31,16893
7/18/2023,1,9678,2422,3280,322,0,25,15727
7/18/2023,2,9680,2245,3120,302,0,20,15367
7/18/2023,3,9676,2210,3019,329,0,18,15252
7/18/2023,4,9675,2167,2918,305,0,21,15086
7/18/2023,5,9674,2362,3060,223,0,31,15350
7/18/2023,6,9674,2646,3153,227,3,21,15724
7/18/2023,7,9670,3421,3536,205,28,55,16915
7/18/2023,8,9661,4574,3712,93,92,62,18194
7/18/2023,9,9657,5395,3527,93,184,63,18919
7/18/2023,10,9645,5615,3665,131,285,55,19396
7/18/2023,11,9638,5609,3866,151,332,54,19650
7/18/2023,12,9631,5774,4111,240,297,65,20118
7/18/2023,13,9621,5689,4536,357,328,70,20601
7/18/2023,14,9631,5636,4471,495,302,80,20615
7/18/2023,15,9646,5264,4544,569,352,119,20494
7/18/2023,16,9647,5301,4840,594,292,121,20795
7/18/2023,17,9643,5658,5188,534,191,115,21329
7/18/2023,18,9657,5810,5109,347,103,119,21145
7/18/2023,19,9659,5904,4924,208,38,85,20818
7/18/2023,20,9664,5357,4848,140,7,82,20098
7/18/2023,21,9657,5280,4661,114,0,82,19794
7/18/2023,22,9192,5264,4299,117,0,82,18954
7/18/2023,23,8925,4809,3862,159,0,41,17796
7/18/2023,24,8920,4111,3623,134,0,31,16819
7/19/2023,1,8927,3367,3210,143,0,23,15670
7/19/2023,2,8903,2877,3034,171,0,18,15003
7/19/2023,3,8817,2859,2964,147,0,18,14805
7/19/2023,4,8822,2799,2928,127,0,23,14699
7/19/2023,5,8823,2921,3055,122,0,47,14968
7/19/2023,6,8833,3409,2929,168,6,53,15398
7/19/2023,7,8829,3839,3547,110,51,59,16435
7/19/2023,8,8810,4525,3603,35,143,61,17177
7/19/2023,9,8792,4744,3712,14,254,48,17564
7/19/2023,10,8788,5374,3656,18,331,47,18214
7/19/2023,11,8782,5692,3912,76,351,54,18867
7/19/2023,12,8775,5859,3981,184,326,77,19202
7/19/2023,13,8760,5987,4437,215,340,107,19846
7/19/2023,14,8771,5937,4364,182,346,110,19710
7/19/2023,15,8779,5766,4701,190,300,108,19844
7/19/2023,16,8784,5710,4856,189,302,105,19946
7/19/2023,17,8782,5939,4963,183,223,105,20195
7/19/2023,18,8778,6112,4866,154,127,103,20140
7/19/2023,19,8782,5569,5011,123,38,81,19604
7/19/2023,20,8792,5335,4884,137,8,87,19243
7/19/2023,21,8795,5501,4911,175,0,82,19464
7/19/2023,22,8796,5304,4669,166,0,80,19015
7/19/2023,23,8790,4945,4034,231,0,82,18082
7/19/2023,24,8785,3911,3602,333,0,43,16674
7/20/2023,1,8780,2788,3604,520,0,21,15713
7/20/2023,2,8799,2183,3317,726,0,17,15042
7/20/2023,3,8797,2219,3055,872,0,17,14960
7/20/2023,4,8785,2513,2704,971,0,17,14990
7/20/2023,5,8781,2733,2767,1269,0,17,15567
7/20/2023,6,8783,2945,3010,1334,5,19,16096
7/20/2023,7,8772,3209,3448,1259,50,48,16786
7/20/2023,8,8760,3633,3754,1092,125,58,17422
7/20/2023,9,8752,4295,3870,1001,243,44,18205
7/20/2023,10,8752,4836,3910,1085,346,57,18986
7/20/2023,11,8748,5358,4152,1132,389,59,19838
7/20/2023,12,8743,5595,4341,1232,390,59,20360
7/20/2023,13,8729,5671,4508,1433,371,61,20773
7/20/2023,14,8723,5762,4838,1463,369,98,21253
7/20/2023,15,8720,6027,5195,1241,295,136,21614
7/20/2023,16,8732,6126,5133,1005,233,161,21390
7/20/2023,17,8733,6149,5205,815,126,119,21147
7/20/2023,18,8736,5623,4845,619,63,110,19996
7/20/2023,19,8736,5180,4829,507,18,112,19382
7/20/2023,20,8731,5256,4778,386,5,113,19269
7/20/2023,21,8723,4729,4780,867,0,59,19158
7/20/2023,22,8711,4407,4114,863,0,56,18151
7/20/2023,23,8716,4141,3688,748,0,57,17350
7/20/2023,24,8692,3398,3372,751,0,59,16272
7/21/2023,1,8687,2510,3092,1319,0,53,15661
7/21/2023,2,8698,1809,2694,1425,0,49,14675
7/21/2023,3,8699,1479,2710,1329,0,47,14264
7/21/2023,4,8698,1637,2808,1719,0,45,14907
7/21/2023,5,8697,1944,3196,1621,0,42,15500
7/21/2023,6,8717,2264,3446,1522,4,45,15998
7/21/2023,7,8726,2804,3727,1273,41,49,16620
7/21/2023,8,8732,3804,3720,1116,111,65,17548
7/21/2023,9,8741,3747,3632,1394,212,51,17777
7/21/2023,10,8783,4047,3597,1520,258,52,18257
7/21/2023,11,8807,4023,3784,1526,314,53,18507
7/21/2023,12,8809,4551,3988,1414,331,48,19141
7/21/2023,13,8822,4665,4162,1377,347,53,19426
7/21/2023,14,8818,4705,4257,1285,274,73,19412
7/21/2023,15,8808,4979,4227,1334,306,98,19752
7/21/2023,16,8801,4801,4617,1312,277,105,19913
7/21/2023,17,8797,5022,4737,1259,211,103,20129
7/21/2023,18,8808,5282,4805,986,111,110,20102
7/21/2023,19,8800,5627,4790,648,34,132,20031
7/21/2023,20,8798,5029,4771,492,7,89,19186
7/21/2023,21,8796,5063,4857,445,0,48,19209
7/21/2023,22,8803,4661,4266,471,0,31,18232
7/21/2023,23,8811,3405,3945,397,0,31,16589
7/21/2023,24,8838,3052,3463,394,0,31,15778
7/22/2023,1,8846,2317,3209,379,0,24,14775
7/22/2023,2,8842,2122,2960,433,0,17,14374
7/22/2023,3,8834,1864,2843,415,0,17,13973
7/22/2023,4,8827,1518,2909,406,0,17,13677
7/22/2023,5,8818,1490,2803,354,0,17,13482
7/22/2023,6,8819,1694,2862,294,4,18,13691
7/22/2023,7,8813,1953,3096,234,51,25,14172
7/22/2023,8,8807,2195,3568,130,160,30,14890
7/22/2023,9,8794,2881,3721,167,280,30,15873
7/22/2023,10,8797,3183,3684,270,372,30,16336
7/22/2023,11,8794,3896,3798,400,407,30,17325
7/22/2023,12,8795,4088,3915,496,415,31,17740
7/22/2023,13,8795,4094,4273,573,417,30,18182
7/22/2023,14,8811,4514,4445,571,390,30,18761
7/22/2023,15,8816,4757,4552,564,375,30,19094
7/22/2023,16,8820,5175,4926,453,317,30,19721
7/22/2023,17,8815,5417,5036,324,239,30,19861
7/22/2023,18,8825,5532,5007,273,107,29,19773
7/22/2023,19,8820,5190,4749,222,36,29,19046
7/22/2023,20,8824,4855,4704,301,7,29,18720
7/22/2023,21,8810,3932,4460,349,0,29,17580
7/22/2023,22,8812,3606,4134,371,0,29,16952
7/22/2023,23,8842,3351,3696,405,0,29,16323
7/22/2023,24,8851,2551,3518,370,0,29,15319
7/23/2023,1,8864,1920,3367,376,0,22,14549
7/23/2023,2,8863,1625,2992,375,0,16,13871
7/23/2023,3,8869,1541,2771,448,0,16,13645
7/23/2023,4,8878,1562,2703,329,0,16,13488
7/23/2023,5,8875,1631,3070,202,0,16,13794
7/23/2023,6,8880,1751,2988,213,8,17,13857
7/23/2023,7,8874,1769,2815,101,43,24,13626
7/23/2023,8,8854,2020,3153,129,145,29,14330
7/23/2023,9,8850,2640,3503,121,257,30,15401
7/23/2023,10,8832,3519,3727,175,348,30,16631
7/23/2023,11,8820,3838,3843,318,372,30,17221
7/23/2023,12,8854,4410,4041,521,386,30,18242
7/23/2023,13,8871,4718,4062,561,280,30,18522
7/23/2023,14,8853,5021,4094,621,272,30,18891
7/23/2023,15,8807,5065,4377,635,285,47,19216
7/23/2023,16,8778,4636,4758,862,279,78,19391
7/23/2023,17,8766,4649,5247,626,212,84,19584
7/23/2023,18,8778,5167,5091,499,100,84,19719
7/23/2023,19,8790,5271,5096,230,28,85,19500
7/23/2023,20,8801,5488,4887,231,3,72,19482
7/23/2023,21,8796,5598,4746,332,0,31,19503
7/23/2023,22,8787,4830,4238,460,0,31,18346
7/23/2023,23,8770,3506,4210,556,0,31,17073
7/23/2023,24,8762,2995,3514,720,0,31,16022
7/24/2023,1,8766,2263,3490,783,0,22,15324
7/24/2023,2,8778,1753,3405,630,0,18,14584
7/24/2023,3,8787,1922,3110,503,0,18,14340
7/24/2023,4,8789,2218,2917,427,0,18,14369
7/24/2023,5,8798,2625,2966,289,0,18,14696
7/24/2023,6,8799,2971,3266,250,5,18,15309
7/24/2023,7,8802,3503,3443,195,50,34,16027
7/24/2023,8,8792,4063,3550,80,134,45,16664
7/24/2023,9,8783,5002,3748,95,209,36,17873
7/24/2023,10,8768,5591,4028,101,294,44,18826
7/24/2023,11,8765,5833,4450,172,327,60,19607
7/24/2023,12,8742,5908,4556,327,342,102,19977
7/24/2023,13,8710,5948,4336,481,378,103,19956
7/24/2023,14,8695,5853,4313,610,368,113,19952
7/24/2023,15,8686,5853,4452,616,351,107,20065
7/24/2023,16,8692,6035,4520,564,265,105,20181
7/24/2023,17,8713,5644,4658,480,211,106,19812
7/24/2023,18,8725,5729,4869,399,74,103,19899
7/24/2023,19,8736,5856,4938,331,28,109,19998
7/24/2023,20,8752,5761,4570,245,4,110,19442
7/24/2023,21,8775,5810,4294,112,0,88,19079
7/24/2023,22,8783,5625,4056,114,0,44,18622
7/24/2023,23,8795,4987,3869,193,0,31,17875
7/24/2023,24,8786,4214,3523,216,0,31,16770
7/25/2023,1,8788,3453,3027,195,0,25,15488
7/25/2023,2,8783,3234,3052,158,0,19,15246
7/25/2023,3,8785,3197,2973,260,0,18,15233
7/25/2023,4,8094,3337,3064,210,0,18,14723
7/25/2023,5,7926,3792,3044,132,0,18,14912
7/25/2023,6,7926,3940,3272,83,6,18,15245
7/25/2023,7,7924,4574,3502,62,40,32,16134
7/25/2023,8,7911,5097,3535,71,130,41,16785
7/25/2023,9,7898,5114,3660,33,231,43,16979
7/25/2023,10,7890,5710,3906,29,317,75,17927
7/25/2023,11,7888,6105,4479,79,359,102,19012
7/25/2023,12,7897,6414,4508,191,381,97,19488
7/25/2023,13,7915,6551,4315,248,323,98,19450
7/25/2023,14,7952,6747,4473,263,262,104,19801
7/25/2023,15,8003,6812,4835,307,240,101,20298
7/25/2023,16,8012,6813,5171,286,278,134,20694
7/25/2023,17,8006,6438,5293,343,201,201,20482
7/25/2023,18,8047,6328,5212,360,91,167,20205
7/25/2023,19,8073,6181,5007,324,29,97,19711
7/25/2023,20,8070,6192,4900,421,5,61,19649
7/25/2023,21,8072,6129,4506,648,0,31,19386
7/25/2023,22,8112,5574,3993,1027,0,31,18737
7/25/2023,23,7853,4775,3564,1218,0,31,17441
7/25/2023,24,7309,4646,3369,1153,0,30,16507
7/26/2023,1,7310,4223,2889,1220,0,25,15667
7/26/2023,2,7315,3515,2839,1401,0,18,15088
7/26/2023,3,7329,3411,2920,1273,0,18,14951
7/26/2023,4,7336,3421,3105,1203,0,18,15083
7/26/2023,5,7342,3753,3050,1097,0,18,15260
7/26/2023,6,7343,3859,3214,983,3,23,15425
7/26/2023,7,7341,4654,3316,961,36,49,16357
7/26/2023,8,7323,5387,3679,807,109,59,17364
7/26/2023,9,7315,5679,3640,962,202,81,17879
7/26/2023,10,7315,5678,3650,1465,270,114,18492
7/26/2023,11,7311,5275,3941,2005,304,112,18948
7/26/2023,12,7333,5170,4088,2424,318,109,19442
7/26/2023,13,7342,5031,4162,2681,330,104,19650
7/26/2023,14,7338,5201,4385,2498,310,98,19830
7/26/2023,15,7363,5443,4313,2411,250,107,19887
7/26/2023,16,7456,5171,4579,2431,183,103,19923
7/26/2023,17,7501,5366,4692,2268,108,104,20039
7/26/2023,18,7522,5237,4792,1802,33,103,19489
7/26/2023,19,7525,5871,5249,1346,12,101,20104
7/26/2023,20,7517,5608,4933,1531,1,97,19687
7/26/2023,21,7521,4734,4677,1597,0,93,18622
7/26/2023,22,7506,4926,4084,1548,0,88,18152
7/26/2023,23,7492,4766,3852,1327,0,49,17486
7/26/2023,24,7496,4696,3542,1108,0,31,16873
7/27/2023,1,7507,4542,3268,1116,0,25,16458
7/27/2023,2,7516,4194,2988,1428,0,19,16145
7/27/2023,3,7533,3913,2875,1369,0,18,15708
7/27/2023,4,7552,3972,2931,1003,0,18,15476
7/27/2023,5,7557,4566,2958,759,0,18,15858
7/27/2023,6,7590,4845,2849,770,1,21,16076
7/27/2023,7,7606,5123,3173,815,11,48,16776
7/27/2023,8,7613,5197,3516,858,54,55,17293
7/27/2023,9,7611,4973,3861,910,101,74,17530
7/27/2023,10,7620,5790,3769,810,112,111,18212
7/27/2023,11,7616,6126,3913,770,159,133,18717
7/27/2023,12,7599,6051,4284,1051,148,183,19316
7/27/2023,13,7583,5611,4581,896,216,127,19014
7/27/2023,14,7579,6073,4818,554,224,109,19357
7/27/2023,15,7579,6236,4926,357,283,104,19485
7/27/2023,16,7573,6310,5098,361,253,124,19719
7/27/2023,17,7573,6618,5410,349,192,175,20317
7/27/2023,18,7578,6561,5280,396,92,118,20025
7/27/2023,19,7592,6396,5076,426,28,102,19620
7/27/2023,20,7594,6162,4906,436,4,98,19200
7/27/2023,21,7605,6117,4760,656,0,94,19232
7/27/2023,22,7614,6033,4167,837,0,94,18745
7/27/2023,23,7619,5576,3754,864,0,85,17898
7/27/2023,24,7615,5111,3414,964,0,87,17191
7/28/2023,1,7622,4953,3155,891,0,74,16695
7/28/2023,2,7627,4735,2936,815,0,71,16184
7/28/2023,3,7627,4636,2941,762,0,70,16036
7/28/2023,4,7623,4265,2965,759,0,70,15682
7/28/2023,5,7757,4244,3072,865,0,72,16010
7/28/2023,6,7785,4142,3098,1155,2,72,16254
7/28/2023,7,7774,4525,3591,1024,41,95,17050
7/28/2023,8,7758,5588,3671,686,134,110,17947
7/28/2023,9,7928,5954,3725,590,195,97,18489
7/28/2023,10,8148,6208,3814,485,235,99,18989
7/28/2023,11,8180,6096,3903,539,263,97,19078
7/28/2023,12,8187,6187,4608,438,287,101,19808
7/28/2023,13,8187,6366,5233,365,319,187,20657
7/28/2023,14,8198,6243,5032,472,318,139,20402
7/28/2023,15,8209,6233,5046,600,282,95,20465
7/28/2023,16,8223,6089,5116,680,252,93,20453
7/28/2023,17,8215,6270,5342,506,138,104,20575
7/28/2023,18,8219,5857,5080,618,63,102,19939
7/28/2023,19,8216,5613,5171,422,29,99,19550
7/28/2023,20,8227,6210,4873,393,4,89,19796
7/28/2023,21,8226,6285,4934,302,0,131,19878
7/28/2023,22,8227,6103,4249,377,0,166,19122
7/28/2023,23,8346,5529,3823,442,0,100,18240
7/28/2023,24,8374,5123,3449,625,0,82,17653
7/29/2023,1,8387,4611,3399,526,0,27,16950
7/29/2023,2,8384,4292,3272,554,0,16,16518
7/29/2023,3,8379,3975,3083,731,0,16,16184
7/29/2023,4,8380,3733,2917,740,0,16,15786
7/29/2023,5,8376,3432,3108,616,0,16,15548
7/29/2023,6,8383,3374,2919,574,2,16,15268
7/29/2023,7,8383,3985,2896,799,13,22,16098
7/29/2023,8,8390,4000,3215,711,43,29,16388
7/29/2023,9,8393,4603,3450,733,44,29,17252
7/29/2023,10,8405,4748,3377,1127,72,29,17758
7/29/2023,11,8403,4323,3483,1511,116,30,17866
7/29/2023,12,8407,3661,3953,1698,125,31,17875
7/29/2023,13,8429,3448,3598,1890,131,31,17527
7/29/2023,14,8459,3287,3390,2281,148,35,17600
7/29/2023,15,8506,3267,3546,2401,166,62,17948
7/29/2023,16,8522,3208,3996,2227,171,91,18215
7/29/2023,17,8518,3428,4402,2068,181,97,18694
7/29/2023,18,8517,3563,4388,1845,117,99,18529
7/29/2023,19,8511,4291,4398,1144,50,99,18493
7/29/2023,20,8502,4725,4231,637,5,84,18184
7/29/2023,21,8501,4076,4227,518,0,38,17360
7/29/2023,22,8492,3925,3497,390,0,56,16360
7/29/2023,23,8497,3450,3241,280,0,59,15527
7/29/2023,24,8490,2707,3196,218,0,55,14666
7/30/2023,1,8495,2133,2972,240,0,43,13883
7/30/2023,2,8494,2079,2736,246,0,40,13595
7/30/2023,3,8498,1747,2789,302,0,41,13377
7/30/2023,4,8506,1706,2902,316,0,41,13471
7/30/2023,5,8512,1901,2982,262,0,44,13701
7/30/2023,6,8525,2054,2865,248,1,42,13735
7/30/2023,7,8542,2207,2851,204,40,52,13896
7/30/2023,8,8564,2553,2742,48,107,46,14060
7/30/2023,9,8577,2809,3192,101,232,50,14961
7/30/2023,10,8580,3218,3293,194,277,54,15616
7/30/2023,11,8595,3452,3433,323,294,56,16153
7/30/2023,12,8575,3455,3778,472,310,56,16646
7/30/2023,13,8572,3481,3887,670,289,55,16954
7/30/2023,14,8572,3162,3877,942,242,56,16851
7/30/2023,15,8559,3128,4112,1114,242,85,17240
7/30/2023,16,8548,3473,4298,1195,282,109,17905
7/30/2023,17,8535,3924,4536,1055,225,108,18383
7/30/2023,18,8528,4135,4516,953,146,109,18387
7/30/2023,19,8530,4088,4420,812,81,112,18043
7/30/2023,20,8525,3839,4340,745,59,111,17619
7/30/2023,21,8527,4071,4271,589,55,106,17619
7/30/2023,22,8564,3846,3596,593,3,70,16672
7/30/2023,23,8598,2877,3445,461,0,56,15437
7/30/2023,24,8621,2427,3379,340,0,53,14820
7/31/2023,1,8641,2065,3122,488,0,44,14360
7/31/2023,2,8676,2047,2935,663,0,39,14360
7/31/2023,3,8681,1715,2974,692,0,30,14092
7/31/2023,4,8670,1702,3257,712,0,16,14357
7/31/2023,5,8659,2026,3091,852,0,14,14642
7/31/2023,6,8659,2737,2705,892,4,16,15013
7/31/2023,7,8656,2952,2912,757,35,37,15349
7/31/2023,8,8647,3156,3371,582,103,41,15900
7/31/2023,9,8647,3659,3552,526,188,32,16604
7/31/2023,10,8657,3810,3567,642,237,37,16950
7/31/2023,11,8659,3937,3993,764,311,79,17743
7/31/2023,12,8665,4085,4077,802,315,83,18027
7/31/2023,13,8674,4068,4371,823,302,84,18322
7/31/2023,14,8660,4354,4519,748,282,83,18646
7/31/2023,15,8468,4866,4720,678,299,80,19111
7/31/2023,16,8408,4867,4888,600,251,79,19093
7/31/2023,17,8690,4908,5102,416,188,84,19388
7/31/2023,18,8722,5205,5129,337,132,89,19614
7/31/2023,19,8905,4847,4969,226,26,81,19054
7/31/2023,20,8912,4512,4818,175,2,80,18499
7/31/2023,21,8897,4660,4320,212,0,78,18167
7/31/2023,22,8904,4511,3901,186,0,80,17582
7/31/2023,23,9081,3607,3643,161,0,38,16530
7/31/2023,24,9201,2983,3189,174,0,26,15573
8/1/2023,1,9264,2454,2953,268,0,18,14957
8/1/2023,2,9270,2141,2921,285,0,13,14630
8/1/2023,3,9269,1824,2962,231,0,13,14299
8/1/2023,4,9268,1916,3016,193,0,13,14406
8/1/2023,5,9279,2053,3043,179,0,18,14572
8/1/2023,6,9291,2329,3125,191,2,15,14953
8/1/2023,7,9302,2718,3387,160,31,16,15614
8/1/2023,8,9291,3259,3523,137,106,20,16336
8/1/2023,9,9277,3526,3817,65,198,26,16909
8/1/2023,10,9358,3825,3630,18,247,26,17104
8/1/2023,11,9388,4319,3771,34,278,26,17816
8/1/2023,12,9388,4570,4053,55,273,26,18365
8/1/2023,13,9349,4500,4167,106,292,26,18440
8/1/2023,14,9336,4388,4357,130,318,26,18555
8/1/2023,15,9307,4599,4535,206,280,36,18963
8/1/2023,16,9295,4952,4879,228,278,69,19701
8/1/2023,17,9301,5007,4951,248,195,78,19780
8/1/2023,18,9336,4731,4866,149,112,78,19272
8/1/2023,19,9388,4579,4785,111,31,78,18972
8/1/2023,20,9391,4599,4836,179,2,78,19085
8/1/2023,21,9399,4747,4575,254,0,37,19012
8/1/2023,22,9416,4731,3845,263,0,27,18282
8/1/2023,23,9438,3541,3582,314,0,27,16902
8/1/2023,24,9460,2716,3353,400,0,20,15949
8/2/2023,1,9469,2049,3092,520,0,14,15144
8/2/2023,2,9476,1855,2921,562,0,14,14828
8/2/2023,3,9483,1416,2908,529,0,14,14350
8/2/2023,4,9474,1499,3022,484,0,14,14493
8/2/2023,5,9420,1898,3125,431,0,14,14888
8/2/2023,6,9380,2500,3121,462,2,16,15481
8/2/2023,7,9358,2771,3317,557,41,38,16082
8/2/2023,8,9349,3151,3510,633,127,49,16819
8/2/2023,9,9380,3161,3593,488,208,45,16875
8/2/2023,10,9370,3480,3482,618,223,53,17226
8/2/2023,11,9354,3630,3533,899,259,53,17728
8/2/2023,12,9341,3967,3670,1033,273,52,18336
8/2/2023,13,9327,4320,4054,1030,295,53,19079
8/2/2023,14,9330,4399,4568,1086,258,55,19696
8/2/2023,15,9345,4866,4519,1261,240,54,20285
8/2/2023,16,9357,4635,4703,1193,222,60,20170
8/2/2023,17,9362,4721,4817,1164,153,90,20307
8/2/2023,18,9366,4818,4902,1031,80,98,20295
8/2/2023,19,9343,4913,4947,909,29,102,20243
8/2/2023,20,9325,4732,4872,1066,1,112,20108
8/2/2023,21,9309,4264,4636,1307,0,145,19661
8/2/2023,22,9310,3877,3855,1607,0,129,18778
8/2/2023,23,9314,3021,3306,1783,0,125,17549
8/2/2023,24,9315,2651,3090,1779,0,120,16955
8/3/2023,1,9310,2064,3041,1660,0,113,16188
8/3/2023,2,9311,2223,2691,1381,0,107,15713
8/3/2023,3,9315,1931,2954,1205,0,102,15507
8/3/2023,4,9321,2135,2904,1034,0,63,15457
8/3/2023,5,9319,2374,2575,849,0,54,15171
8/3/2023,6,9328,2824,2573,751,0,48,15524
8/3/2023,7,9345,3064,3048,780,18,43,16298
8/3/2023,8,9361,3846,3554,653,92,47,17553
8/3/2023,9,9376,4856,3485,563,201,43,18524
8/3/2023,10,9382,5307,3566,592,313,43,19203
8/3/2023,11,9385,5546,3764,801,336,43,19875
8/3/2023,12,9364,5546,3858,1080,336,66,20250
8/3/2023,13,9356,5360,4210,1260,350,96,20632
8/3/2023,14,9356,5134,4333,1404,376,90,20693
8/3/2023,15,9285,4926,4374,1514,360,90,20549
8/3/2023,16,9353,5170,4627,1479,276,81,20986
8/3/2023,17,9332,5412,4856,1544,156,81,21381
8/3/2023,18,9338,5542,4887,1440,74,90,21371
8/3/2023,19,9333,5414,4703,1382,17,81,20930
8/3/2023,20,9344,5471,4467,1303,1,81,20667
8/3/2023,21,9361,5242,4437,1207,0,81,20328
8/3/2023,22,9378,4587,3762,1271,0,86,19084
8/3/2023,23,9417,4199,3494,1144,0,119,18373
8/3/2023,24,9432,4218,3261,742,0,57,17710
8/4/2023,1,9441,3574,2893,824,0,20,16752
8/4/2023,2,9456,3021,2733,867,0,14,16091
8/4/2023,3,9461,2959,2631,1020,0,14,16085
8/4/2023,4,9457,2952,2356,944,0,14,15723
8/4/2023,5,9449,3053,2565,865,0,14,15946
8/4/2023,6,9437,3170,3104,902,1,14,16628
8/4/2023,7,9441,3286,3225,787,36,14,16789
8/4/2023,8,9423,4296,3409,564,111,22,17825
8/4/2023,9,9426,4984,3363,506,195,26,18500
8/4/2023,10,9420,5016,3407,583,270,27,18723
8/4/2023,11,9408,5416,3475,616,278,27,19220
8/4/2023,12,9419,5560,3581,695,288,27,19570
8/4/2023,13,9428,5474,4114,870,352,27,20265
8/4/2023,14,9435,5511,4342,1035,296,27,20646
8/4/2023,15,9430,5549,4318,1174,198,37,20706
8/4/2023,16,9423,5573,4469,1261,206,74,21006
8/4/2023,17,9422,5588,4834,1173,164,81,21262
8/4/2023,18,9441,5614,4709,1272,103,81,21220
8/4/2023,19,9454,5139,4567,1185,31,81,20457
8/4/2023,20,9470,4984,4280,941,2,81,19758
8/4/2023,21,9486,4828,4224,916,0,81,19535
8/4/2023,22,9488,4411,3614,900,0,81,18494
8/4/2023,23,9495,3505,3234,938,0,81,17253
8/4/2023,24,9494,2617,3007,1078,0,30,16226
8/5/2023,1,9500,2374,2635,915,0,14,15438
8/5/2023,2,9509,2364,2509,740,0,14,15136
8/5/2023,3,9517,1988,2518,601,0,14,14638
8/5/2023,4,9505,1626,2767,797,0,14,14709
8/5/2023,5,9488,2076,2645,785,0,14,15008
8/5/2023,6,9486,2346,2552,891,3,14,15292
8/5/2023,7,9474,2475,2589,436,48,14,15036
8/5/2023,8,9456,2805,2975,249,118,23,15626
8/5/2023,9,9457,2931,3324,186,249,27,16174
8/5/2023,10,9473,3373,3527,148,317,27,16865
8/5/2023,11,9473,3284,3508,120,343,27,16755
8/5/2023,12,9491,3755,3730,154,334,27,17491
8/5/2023,13,9485,3544,4021,226,337,27,17640
8/5/2023,14,9477,3834,4121,238,331,50,18051
8/5/2023,15,9460,4217,4283,256,294,78,18588
8/5/2023,16,9427,4605,4321,295,247,79,18974
8/5/2023,17,9413,4520,4497,328,190,80,19028
8/5/2023,18,9423,4399,4539,316,96,80,18853
8/5/2023,19,9443,4194,4454,362,29,80,18562
8/5/2023,20,9452,3816,4295,380,1,37,17981
8/5/2023,21,9474,3553,4169,422,0,27,17645
8/5/2023,22,9499,3193,3578,458,0,27,16755
8/5/2023,23,9502,2703,3100,608,0,27,15940
8/5/2023,24,9511,2235,2872,714,0,18,15350
8/6/2023,1,9543,1647,2714,857,0,14,14775
8/6/2023,2,9572,1220,2761,936,0,14,14503
8/6/2023,3,9588,1123,2543,1161,0,14,14429
8/6/2023,4,9589,1123,2416,1104,0,14,14246
8/6/2023,5,9582,1003,2528,1344,0,14,14471
8/6/2023,6,9559,1044,2605,1667,3,14,14892
8/6/2023,7,9523,1129,2611,1490,43,14,14810
8/6/2023,8,9502,1532,2784,1290,137,31,15276
8/6/2023,9,9490,2091,3099,1334,237,65,16316
8/6/2023,10,9480,2441,3007,1510,338,77,16853
8/6/2023,11,9475,2676,2966,1539,322,77,17055
8/6/2023,12,9472,2797,3094,1531,292,80,17266
8/6/2023,13,9474,2773,3652,1509,271,79,17758
8/6/2023,14,9479,2786,3758,1440,286,78,17827
8/6/2023,15,9496,2851,3665,1467,254,78,17811
8/6/2023,16,9517,3003,3879,1511,188,81,18179
8/6/2023,17,9523,3084,3768,1795,110,78,18358
8/6/2023,18,9507,3172,3664,1774,48,81,18246
8/6/2023,19,9491,2983,3600,1415,16,80,17585
8/6/2023,20,9476,2581,4024,1442,1,85,17609
8/6/2023,21,9474,2524,4114,1507,0,123,17742
8/6/2023,22,9471,2386,3783,1637,0,59,17336
8/6/2023,23,9467,2103,3126,1960,0,27,16683
8/6/2023,24,9466,1610,2996,1984,0,19,16075
8/7/2023,1,9464,939,3264,1786,0,15,15468
8/7/2023,2,9363,958,3374,1551,0,14,15260
8/7/2023,3,8858,1098,3579,1537,0,14,15086
8/7/2023,4,8851,984,3093,1441,0,14,14383
8/7/2023,5,8852,920,3380,1242,0,14,14408
8/7/2023,6,8856,1197,3506,1098,0,14,14671
8/7/2023,7,8853,1521,3306,1247,9,15,14951
8/7/2023,8,8850,2046,3371,1398,47,24,15736
8/7/2023,9,8837,2662,3366,1390,99,27,16381
8/7/2023,10,8816,3704,3658,1352,116,27,17673
8/7/2023,11,8808,4214,3949,1497,134,27,18629
8/7/2023,12,8800,4507,3960,1508,147,27,18949
8/7/2023,13,8792,4446,3838,1505,147,27,18755
8/7/2023,14,8787,4279,3876,1648,174,27,18791
8/7/2023,15,8759,4223,3758,2114,176,27,19057
8/7/2023,16,8739,3975,4008,2433,160,27,19342
8/7/2023,17,8767,3750,4077,2862,92,27,19575
8/7/2023,18,8782,3586,4152,3049,48,27,19644
8/7/2023,19,8758,3540,4318,3050,20,27,19713
8/7/2023,20,8763,3934,4250,2816,1,27,19791
8/7/2023,21,8756,4065,4099,2677,0,27,19624
8/7/2023,22,8761,3063,3542,2726,0,27,18119
8/7/2023,23,8776,2489,3572,2553,0,27,17417
8/7/2023,24,8784,1608,3546,2481,0,18,16437
8/8/2023,1,8789,1439,3354,2249,0,14,15845
8/8/2023,2,8784,1275,3203,2305,0,14,15581
8/8/2023,3,8780,1086,3018,2461,0,14,15359
8/8/2023,4,8798,1051,3019,2504,0,14,15386
8/8/2023,5,8826,1263,3226,2319,0,14,15648
8/8/2023,6,8829,1560,3392,2299,1,16,16097
8/8/2023,7,8826,2079,3494,2337,30,23,16789
8/8/2023,8,8820,2562,3400,2019,79,31,16911
8/8/2023,9,8819,2901,3466,1767,136,28,17117
8/8/2023,10,8817,3599,3725,1567,239,27,17974
8/8/2023,11,8820,3860,3667,1548,270,27,18192
8/8/2023,12,8826,4099,3630,1574,288,27,18444
8/8/2023,13,8834,4249,3948,1702,283,27,19043
8/8/2023,14,8853,4248,4223,1739,269,38,19370
8/8/2023,15,8888,4534,4530,1541,242,64,19799
8/8/2023,16,8934,4701,4646,1331,198,77,19887
8/8/2023,17,8967,4734,5047,1031,157,78,20014
8/8/2023,18,8992,4563,4987,838,83,78,19541
8/8/2023,19,8996,4393,4755,727,25,79,18975
8/8/2023,20,8999,4579,4541,741,1,79,18940
8/8/2023,21,9011,4471,4191,745,0,79,18497
8/8/2023,22,9009,4203,3659,792,0,79,17742
8/8/2023,23,8994,3653,3356,800,0,40,16843
8/8/2023,24,8963,2662,3073,764,0,16,15478
8/9/2023,1,8954,1660,3054,773,0,14,14455
8/9/2023,2,8961,1589,3027,698,0,14,14289
8/9/2023,3,8956,1636,3036,734,0,14,14376
8/9/2023,4,8956,1605,2970,837,0,13,14381
8/9/2023,5,8957,1764,3070,848,0,13,14652
8/9/2023,6,8959,2202,3118,750,1,13,15043
8/9/2023,7,8974,2827,3140,618,38,13,15610
8/9/2023,8,8999,3470,3415,307,139,22,16352
8/9/2023,9,9008,4200,3578,190,255,26,17257
8/9/2023,10,9015,4560,3884,134,341,26,17960
8/9/2023,11,9009,4875,3838,204,382,33,18341
8/9/2023,12,8999,5066,4069,433,398,65,19030
8/9/2023,13,8982,4927,4200,793,394,77,19373
8/9/2023,14,8967,4730,4196,1062,389,79,19423
8/9/2023,15,8966,4889,4381,1189,342,80,19847
8/9/2023,16,8948,5065,4757,1323,272,88,20453
8/9/2023,17,8942,5324,4925,1151,180,105,20627
8/9/2023,18,8928,5346,4893,956,93,84,20300
8/9/2023,19,8918,5030,4840,955,26,81,19850
8/9/2023,20,8928,5025,4567,979,1,82,19582
8/9/2023,21,8941,4878,4323,1057,0,82,19281
8/9/2023,22,8954,4498,3797,972,0,85,18306
8/9/2023,23,8961,3395,3526,987,0,72,16941
8/9/2023,24,8981,2938,3621,814,0,20,16374
8/10/2023,1,8993,2523,3438,739,0,14,15707
8/10/2023,2,9003,2166,3149,823,0,14,15155
8/10/2023,3,9006,2248,3284,644,0,14,15196
8/10/2023,4,9014,2446,3234,588,0,14,15296
8/10/2023,5,9016,2512,3164,639,0,14,15345
8/10/2023,6,9017,2718,3176,821,2,14,15748
8/10/2023,7,8991,2988,3447,715,20,14,16175
8/10/2023,8,8972,3743,3718,434,83,21,16971
8/10/2023,9,8957,4358,3882,338,169,27,17731
8/10/2023,10,8963,4613,3929,425,240,27,18197
8/10/2023,11,8962,4815,4326,535,229,47,18914
8/10/2023,12,9042,4941,3897,638,243,75,18836
8/10/2023,13,9106,3710,3836,1065,276,77,18070
8/10/2023,14,9122,3333,3742,1489,212,79,17977
8/10/2023,15,9147,3636,4213,1361,144,79,18580
8/10/2023,16,9159,4652,4352,1123,146,79,19511
8/10/2023,17,9165,4842,4461,1111,196,79,19854
8/10/2023,18,9155,4535,4551,781,90,79,19191
8/10/2023,19,9128,4898,4388,645,24,79,19162
8/10/2023,20,9067,4985,4546,508,1,80,19187
8/10/2023,21,9116,4825,4109,566,0,95,18711
8/10/2023,22,9233,3975,3640,865,0,80,17793
8/10/2023,23,9266,2799,3065,1067,0,38,16235
8/10/2023,24,9290,2163,2834,1138,0,20,15445
8/11/2023,1,9323,1305,3019,1007,0,13,14667
8/11/2023,2,9356,1315,3190,691,0,13,14565
8/11/2023,3,9371,1467,2999,575,0,13,14425
8/11/2023,4,9389,1603,2932,529,0,13,14466
8/11/2023,5,9393,1720,2950,436,0,13,14512
8/11/2023,6,9414,2133,2899,458,1,13,14918
8/11/2023,7,9406,2375,3019,283,35,13,15131
8/11/2023,8,9400,2721,3394,166,136,21,15838
8/11/2023,9,9429,3485,3460,189,246,26,16835
8/11/2023,10,9436,4013,3442,183,336,26,17436
8/11/2023,11,9449,4351,3500,165,372,26,17863
8/11/2023,12,9473,4259,3508,204,363,26,17833
8/11/2023,13,9487,4076,3826,269,365,26,18049
8/11/2023,14,9474,3892,4025,406,330,27,18154
8/11/2023,15,9454,3792,4278,479,323,27,18353
8/11/2023,16,9486,3939,4534,417,287,26,18689
8/11/2023,17,9483,4096,4910,341,191,26,19047
8/11/2023,18,9492,4295,4735,345,77,26,18970
8/11/2023,19,9497,4255,4642,560,25,27,19006
8/11/2023,20,9502,4218,4626,598,0,27,18971
8/11/2023,21,9509,4269,4171,1074,0,27,19050
8/11/2023,22,9517,3896,3808,1254,0,21,18496
8/11/2023,23,9541,3018,3145,1499,0,19,17222
8/11/2023,24,9546,1858,3452,1598,0,17,16471
8/12/2023,1,9559,811,3524,1561,0,12,15467
8/12/2023,2,9565,682,3253,1332,0,12,14844
8/12/2023,3,9559,626,3000,1422,0,12,14619
8/12/2023,4,9547,599,2842,1401,0,13,14402
8/12/2023,5,9528,635,2904,1509,0,13,14589
8/12/2023,6,9522,781,3000,1674,1,14,14992
8/12/2023,7,9514,1131,2858,1714,16,15,15248
8/12/2023,8,9505,1922,3230,1602,72,21,16352
8/12/2023,9,9500,2611,3305,1739,110,34,17299
8/12/2023,10,9495,3290,3299,1467,177,67,17795
8/12/2023,11,9498,3227,3406,1519,246,81,17977
8/12/2023,12,9488,3676,3582,1495,199,81,18521
8/12/2023,13,9470,4146,3652,1455,158,81,18962
8/12/2023,14,9379,4156,3997,1260,232,81,19105
8/12/2023,15,9244,4280,4208,1331,188,81,19332
8/12/2023,16,9245,4514,4288,1312,172,81,19612
8/12/2023,17,9253,4866,4558,1147,92,86,20002
8/12/2023,18,9212,5197,4373,809,55,125,19771
8/12/2023,19,9203,4865,4332,709,19,95,19223
8/12/2023,20,9207,4236,4266,876,0,118,18703
8/12/2023,21,9214,4382,4022,1054,0,98,18770
8/12/2023,22,9218,3761,3767,1030,0,79,17855
8/12/2023,23,9229,3394,3537,1016,0,79,17255
8/12/2023,24,9237,2607,3576,781,0,32,16233
8/13/2023,1,9218,1695,3636,568,0,13,15130
8/13/2023,2,9256,1056,3488,410,0,13,14223
8/13/2023,3,9244,897,3355,497,0,14,14007
8/13/2023,4,9243,783,3204,726,0,14,13970
8/13/2023,5,9241,738,3312,787,0,14,14092
8/13/2023,6,9223,733,3148,977,1,14,14096
8/13/2023,7,9203,985,3006,976,34,14,14218
8/13/2023,8,9178,1706,3391,751,128,22,15176
8/13/2023,9,9167,2591,3502,661,234,27,16182
8/13/2023,10,9161,2907,3266,707,284,35,16360
8/13/2023,11,9150,3509,3313,720,253,67,17012
8/13/2023,12,9206,3592,3352,733,252,80,17215
8/13/2023,13,9329,3518,3335,724,224,81,17211
8/13/2023,14,9374,3441,3835,753,266,81,17750
8/13/2023,15,9387,3590,3791,815,250,81,17914
8/13/2023,16,9396,3538,3803,753,259,81,17830
8/13/2023,17,9404,3751,4120,728,172,81,18256
8/13/2023,18,9407,4314,4214,529,93,81,18638
8/13/2023,19,9416,4263,4198,452,24,81,18434
8/13/2023,20,9413,4377,4182,525,0,101,18598
8/13/2023,21,9408,4534,3777,427,0,86,18232
8/13/2023,22,9433,4720,3511,292,0,37,17993
8/13/2023,23,9458,3811,3387,216,0,27,16899
8/13/2023,24,9446,2735,3292,182,0,20,15675
8/14/2023,1,9440,1966,3260,205,0,15,14886
8/14/2023,2,9429,1864,3089,206,0,14,14602
8/14/2023,3,9434,2019,2986,200,0,14,14653
8/14/2023,4,9429,2355,3158,226,0,14,15182
8/14/2023,5,9428,2517,3010,230,0,14,15199
8/14/2023,6,9434,2852,2826,262,1,14,15389
8/14/2023,7,9441,3200,3335,285,40,15,16316
8/14/2023,8,9452,3351,3389,227,133,20,16572
8/14/2023,9,9458,3845,3676,136,231,27,17373
8/14/2023,10,9462,4099,3627,121,257,38,17604
8/14/2023,11,9461,4657,3451,203,305,71,18148
8/14/2023,12,9457,4710,3422,246,272,78,18185
8/14/2023,13,9451,4894,3603,224,246,79,18497
8/14/2023,14,9447,5028,4082,262,228,93,19140
8/14/2023,15,9441,5109,3964,325,204,98,19141
8/14/2023,16,9423,5157,4296,457,172,88,19593
8/14/2023,17,9408,5205,4659,594,141,37,20044
8/14/2023,18,9395,5117,4407,621,70,23,19633
8/14/2023,19,9389,4849,4147,635,20,23,19063
8/14/2023,20,9383,4634,4211,703,0,23,18954
8/14/2023,21,9391,4804,3827,974,0,23,19019
8/14/2023,22,9404,4009,3510,1170,0,23,18116
8/14/2023,23,9422,3129,3202,1603,0,23,17379
8/14/2023,24,9444,1709,3034,1811,0,15,16013
8/15/2023,1,9466,1456,3042,1566,0,10,15540
8/15/2023,2,9480,1536,2934,1501,0,10,15461
8/15/2023,3,9490,1286,2852,1621,0,10,15259
8/15/2023,4,9497,1200,2921,1567,0,10,15195
8/15/2023,5,9498,1595,2945,1492,0,12,15542
8/15/2023,6,9492,2420,2842,1333,0,14,16101
8/15/2023,7,9487,2742,3160,1273,18,10,16690
8/15/2023,8,9477,3036,3334,1300,64,14,17225
8/15/2023,9,9450,3526,3529,1073,113,23,17714
8/15/2023,10,9416,3981,3627,875,196,23,18118
8/15/2023,11,9396,4342,3657,745,187,23,18350
8/15/2023,12,9403,4377,3777,661,198,23,18439
8/15/2023,13,9413,4589,3860,702,231,32,18827
8/15/2023,14,9434,4514,3808,701,226,64,18747
8/15/2023,15,9451,4547,3972,717,195,75,18957
8/15/2023,16,9446,4696,3914,970,177,74,19277
8/15/2023,17,9452,4084,4233,1278,108,74,19229
8/15/2023,18,9468,4144,4311,1208,56,78,19265
8/15/2023,19,9485,3864,4341,840,15,82,18627
8/15/2023,20,9488,4396,4183,645,0,86,18798
8/15/2023,21,9487,4927,3911,489,0,77,18891
8/15/2023,22,9490,4758,3462,348,0,95,18153
8/15/2023,23,9473,4021,3130,344,0,76,17044
8/15/2023,24,9458,3055,3038,403,0,68,16022
8/16/2023,1,9465,2395,2962,408,0,19,15249
8/16/2023,2,9467,1873,2898,485,0,10,14733
8/16/2023,3,9479,1806,2870,462,0,10,14627
8/16/2023,4,9478,2007,2758,542,0,10,14795
8/16/2023,5,9491,2295,2863,588,0,10,15247
8/16/2023,6,9498,2629,2713,500,0,11,15351
8/16/2023,7,9506,3162,3283,437,25,15,16428
8/16/2023,8,9504,3927,3407,151,125,18,17132
8/16/2023,9,9501,4546,3861,51,228,23,18210
8/16/2023,10,9500,4687,3845,33,318,23,18406
8/16/2023,11,9490,4764,3897,78,342,23,18594
8/16/2023,12,9482,5072,3852,159,337,29,18931
8/16/2023,13,9469,5234,4041,259,347,58,19408
8/16/2023,14,9446,5216,3950,399,339,75,19425
8/16/2023,15,9421,5078,4206,569,324,74,19672
8/16/2023,16,9403,5136,4035,691,290,74,19629
8/16/2023,17,9388,5435,4332,864,194,76,20289
8/16/2023,18,9374,5491,4074,939,88,73,20039
8/16/2023,19,9378,5539,3933,1001,19,76,19946
8/16/2023,20,9379,5044,3653,1133,0,31,19240
8/16/2023,21,9385,4854,3571,1399,0,23,19232
8/16/2023,22,9391,4162,3408,1693,0,23,18677
8/16/2023,23,9395,2841,2937,1982,0,23,17178
8/16/2023,24,9390,1760,3029,2333,0,16,16528
8/17/2023,1,9390,1072,2783,2360,0,17,15622
8/17/2023,2,9400,605,2701,2330,0,49,15085
8/17/2023,3,9393,526,2972,2297,0,63,15251
8/17/2023,4,9392,525,3002,2280,0,63,15262
8/17/2023,5,9392,761,2670,2381,0,63,15267
8/17/2023,6,9388,1360,2619,2277,1,64,15709
8/17/2023,7,9385,1765,2929,2360,33,70,16542
8/17/2023,8,9391,2156,3273,2572,104,74,17570
8/17/2023,9,9063,2530,3539,2888,166,37,18223
8/17/2023,10,8861,2817,3477,3115,192,23,18485
8/17/2023,11,8862,3024,3855,3346,219,23,19329
8/17/2023,12,8847,3065,3763,3445,269,23,19412
8/17/2023,13,8829,2942,3961,3351,277,23,19383
8/17/2023,14,8836,3319,4103,3385,225,23,19891
8/17/2023,15,8826,3347,4090,3277,153,23,19716
8/17/2023,16,8825,3733,4014,3226,168,23,19989
8/17/2023,17,8835,3626,4107,3286,129,23,20006
8/17/2023,18,8840,3450,3975,3191,42,23,19521
8/17/2023,19,8836,3481,4087,2803,6,23,19236
8/17/2023,20,8822,3780,3821,2558,1,23,19005
8/17/2023,21,8821,3453,3591,2372,0,23,18260
8/17/2023,22,8827,2918,3500,2174,0,23,17442
8/17/2023,23,8832,2655,3095,2268,0,23,16873
8/17/2023,24,8836,1767,2644,2365,0,15,15627
8/18/2023,1,8832,426,2892,2555,0,10,14715
8/18/2023,2,8839,133,2807,2853,0,10,14642
8/18/2023,3,8847,133,2609,2466,0,10,14065
8/18/2023,4,8853,132,2631,2448,0,10,14074
8/18/2023,5,8853,132,2782,2831,0,10,14608
8/18/2023,6,8855,325,2697,2771,0,10,14658
8/18/2023,7,8860,729,2883,2865,24,10,15371
8/18/2023,8,8868,1140,3191,3180,119,17,16515
8/18/2023,9,8869,1501,2902,3442,210,22,16946
8/18/2023,10,8894,1603,3097,3273,265,22,17154
8/18/2023,11,8906,1834,3580,3048,228,23,17619
8/18/2023,12,8917,2047,3457,3000,225,23,17669
8/18/2023,13,8930,2147,3640,2805,281,23,17826
8/18/2023,14,8932,2005,3691,2491,277,23,17419
8/18/2023,15,8927,1849,3776,2439,244,23,17258
8/18/2023,16,8926,2358,3691,2259,175,23,17432
8/18/2023,17,8930,2624,3749,2345,143,23,17814
8/18/2023,18,8934,2618,3881,1995,58,23,17509
8/18/2023,19,8951,2652,4022,1484,15,23,17147
8/18/2023,20,8964,2706,3873,1147,0,23,16713
8/18/2023,21,8965,2731,3519,1114,0,23,16352
8/18/2023,22,8977,2004,3250,1014,0,23,15268
8/18/2023,23,8995,1201,2956,1060,0,23,14235
8/18/2023,24,9002,975,2986,963,0,16,13942
8/19/2023,1,9012,659,2904,709,0,10,13294
8/19/2023,2,9020,416,2763,542,0,10,12751
8/19/2023,3,9025,488,2672,489,0,10,12684
8/19/2023,4,9029,493,2698,481,0,10,12711
8/19/2023,5,9034,502,2764,623,0,10,12933
8/19/2023,6,9042,532,2762,827,1,10,13174
8/19/2023,7,9039,618,3380,878,29,10,13954
8/19/2023,8,9036,1142,3525,613,124,16,14456
8/19/2023,9,9035,1358,3392,454,235,22,14496
8/19/2023,10,9034,1696,3311,414,307,22,14784
8/19/2023,11,9034,1911,3449,475,374,22,15265
8/19/2023,12,9023,2200,3021,501,414,22,15181
8/19/2023,13,9033,2281,3339,342,358,22,15375
8/19/2023,14,9046,2277,3279,455,402,22,15481
8/19/2023,15,9055,2278,3453,832,377,22,16017
8/19/2023,16,9055,2275,3464,1036,301,22,16153
8/19/2023,17,9052,2275,3932,1167,209,23,16658
8/19/2023,18,9051,2271,4013,1081,90,23,16529
8/19/2023,19,9045,2286,4133,1035,19,23,16541
8/19/2023,20,9049,2099,4202,1158,0,23,16531
8/19/2023,21,9054,2217,4148,1293,0,23,16735
8/19/2023,22,9053,1752,3508,1466,0,23,15802
8/19/2023,23,9054,1070,2962,1569,0,23,14678
8/19/2023,24,9058,601,2846,1590,0,23,14118
8/20/2023,1,9060,291,2754,1102,0,14,13221
8/20/2023,2,9059,162,2764,1142,0,11,13138
8/20/2023,3,9057,162,2729,933,0,11,12892
8/20/2023,4,9062,162,2726,887,0,11,12848
8/20/2023,5,9068,162,2861,871,0,11,12973
8/20/2023,6,9072,162,2780,1457,1,11,13483
8/20/2023,7,9071,276,2808,1575,29,11,13770
8/20/2023,8,9080,709,3354,1107,99,18,14367
8/20/2023,9,9086,1615,3783,797,162,34,15477
8/20/2023,10,9093,2101,3618,730,288,65,15895
8/20/2023,11,9091,2374,3736,820,335,73,16429
8/20/2023,12,9085,2809,3712,821,349,72,16848
8/20/2023,13,9081,3424,4176,906,365,74,18026
8/20/2023,14,9078,3790,4201,1056,342,73,18540
8/20/2023,15,9083,3735,4219,1051,243,74,18405
8/20/2023,16,9079,4161,3811,939,147,80,18217
8/20/2023,17,9079,4382,3736,789,104,73,18163
8/20/2023,18,9080,4106,4082,645,51,73,18037
8/20/2023,19,9071,3795,4568,563,12,74,18083
8/20/2023,20,9064,4557,4479,560,0,74,18734
8/20/2023,21,9060,4838,4397,642,0,70,19007
8/20/2023,22,9061,4567,3966,886,0,24,18504
8/20/2023,23,9074,3690,3546,981,0,23,17314
8/20/2023,24,9075,2738,3161,1064,0,15,16053
8/21/2023,1,9081,2289,2997,1009,0,10,15386
8/21/2023,2,9075,1749,2893,1216,0,23,14956
8/21/2023,3,9044,1723,2945,1044,0,40,14796
8/21/2023,4,9011,2209,2808,946,0,39,15013
8/21/2023,5,9021,2727,2694,746,0,34,15222
8/21/2023,6,9021,3307,2951,906,0,29,16214
8/21/2023,7,9020,3845,3445,843,10,33,17196
8/21/2023,8,9010,4368,3530,657,56,43,17664
8/21/2023,9,9006,4605,3587,617,129,38,17982
8/21/2023,10,9000,4626,3534,572,179,41,17952
8/21/2023,11,8988,5187,3505,523,287,49,18539
8/21/2023,12,8986,5077,3482,447,327,48,18367
8/21/2023,13,8977,5045,3806,409,372,50,18659
8/21/2023,14,8981,5046,3895,523,349,50,18844
8/21/2023,15,8982,5018,3966,675,329,49,19019
8/21/2023,16,8979,5017,3953,1003,278,47,19277
8/21/2023,17,8978,4902,4355,1062,168,45,19510
8/21/2023,18,8987,4842,4176,1093,74,44,19216
8/21/2023,19,8990,4318,4230,1010,17,31,18596
8/21/2023,20,8992,4280,4114,1127,0,23,18536
8/21/2023,21,8992,4275,4075,1191,0,23,18556
8/21/2023,22,8995,4171,3614,1151,0,23,17954
8/21/2023,23,9015,3406,3498,1049,0,23,16991
8/21/2023,24,9015,2186,3330,887,0,14,15432
8/22/2023,1,9032,1807,3316,771,0,11,14937
8/22/2023,2,9041,1502,2802,924,0,11,14280
8/22/2023,3,9037,1439,2756,920,0,11,14163
8/22/2023,4,9029,1547,2813,910,0,11,14310
8/22/2023,5,9049,1895,2854,936,0,11,14745
8/22/2023,6,9099,2545,3035,921,2,11,15613
8/22/2023,7,9124,3033,3230,751,38,11,16187
8/22/2023,8,9146,3235,3562,409,127,27,16506
8/22/2023,9,9143,3578,3576,170,223,40,16730
8/22/2023,10,9141,3834,3452,164,326,47,16964
8/22/2023,11,9188,4038,3483,192,402,52,17355
8/22/2023,12,9245,4089,3428,160,402,49,17373
8/22/2023,13,9329,4098,3594,136,387,45,17589
8/22/2023,14,9338,4208,3889,139,368,44,17986
8/22/2023,15,9345,4100,3879,175,349,41,17889
8/22/2023,16,9345,4109,4181,219,288,42,18184
8/22/2023,17,9337,4574,4307,212,195,39,18664
8/22/2023,18,9329,5019,4319,207,89,41,19004
8/22/2023,19,9334,4635,4146,226,15,28,18384
8/22/2023,20,9342,4172,4281,140,0,27,17962
8/22/2023,21,9387,4297,4175,108,0,27,17994
8/22/2023,22,9509,4231,3761,96,0,28,17625
8/22/2023,23,9537,3595,3509,196,0,28,16865
8/22/2023,24,9547,2766,3059,225,0,19,15616
8/23/2023,1,9552,1973,3389,229,0,17,15160
8/23/2023,2,9568,1344,3302,214,0,17,14445
8/23/2023,3,9574,1236,3134,307,0,17,14268
8/23/2023,4,9579,1332,2852,510,0,17,14290
8/23/2023,5,9624,1543,3125,631,0,17,14940
8/23/2023,6,9648,1971,3099,787,0,17,15522
8/23/2023,7,9651,2205,3245,1075,14,17,16207
8/23/2023,8,9651,2579,3119,1071,54,25,16499
8/23/2023,9,9647,2919,3172,1157,111,27,17033
8/23/2023,10,9639,3148,3179,1040,169,30,17205
8/23/2023,11,9581,3266,3193,1053,198,52,17343
8/23/2023,12,9573,3277,2995,1269,194,55,17363
8/23/2023,13,9567,3271,3309,935,197,55,17334
8/23/2023,14,9569,2980,3581,1299,162,55,17646
8/23/2023,15,9570,2654,3401,1565,206,56,17452
8/23/2023,16,9575,2355,3964,1366,161,54,17475
8/23/2023,17,9570,2486,4655,1262,119,54,18146
8/23/2023,18,9569,2917,4380,1235,53,52,18206
8/23/2023,19,9572,2623,4364,1358,10,29,17956
8/23/2023,20,9579,2878,4394,1151,0,27,18029
8/23/2023,21,9567,2840,4130,1279,0,27,17843
8/23/2023,22,9576,2294,3638,1354,0,27,16889
8/23/2023,23,9579,2164,3092,1350,0,27,16212
8/23/2023,24,9576,1580,2984,1217,0,17,15374
8/24/2023,1,9581,1136,2838,1119,0,14,14688
8/24/2023,2,9576,1097,2691,965,0,14,14343
8/24/2023,3,9579,1294,2711,915,0,14,14513
8/24/2023,4,9567,1465,2944,1006,0,14,14996
8/24/2023,5,9544,1595,3224,874,0,14,15251
8/24/2023,6,9535,2018,3368,913,0,14,15848
8/24/2023,7,9532,2472,3517,1025,2,14,16562
8/24/2023,8,9525,3341,3382,982,18,22,17270
8/24/2023,9,9523,3744,3419,981,62,27,17756
8/24/2023,10,9510,3978,3383,1115,79,27,18092
8/24/2023,11,9505,4085,3627,877,78,27,18199
8/24/2023,12,9507,4437,3742,845,103,27,18661
8/24/2023,13,9513,4243,3550,987,144,27,18464
8/24/2023,14,9509,4025,3833,1041,131,27,18566
8/24/2023,15,9522,4183,4175,913,117,27,18937
8/24/2023,16,9531,4269,4313,756,79,27,18975
8/24/2023,17,9535,4214,4550,738,53,27,19117
8/24/2023,18,9530,4430,4607,573,24,27,19191
8/24/2023,19,9519,4481,4609,483,6,27,19125
8/24/2023,20,9510,4642,4279,569,0,27,19027
8/24/2023,21,9505,4555,4266,686,0,27,19039
8/24/2023,22,9485,4277,3677,681,0,27,18147
8/24/2023,23,9497,3427,3425,579,0,27,16955
8/24/2023,24,9490,2672,3326,686,0,18,16192
8/25/2023,1,9502,1974,3349,352,0,13,15190
8/25/2023,2,9504,1974,3044,447,0,13,14982
8/25/2023,3,9502,2026,2886,514,0,14,14942
8/25/2023,4,9505,2094,2874,572,0,14,15059
8/25/2023,5,9504,2271,2741,565,0,14,15095
8/25/2023,6,9504,2851,3011,757,0,14,16137
8/25/2023,7,9495,3433,3401,751,3,16,17099
8/25/2023,8,9494,4303,3456,517,18,22,17810
8/25/2023,9,9495,4773,3366,403,72,42,18151
8/25/2023,10,9500,4973,3528,385,128,75,18589
8/25/2023,11,9497,5091,3540,469,184,79,18860
8/25/2023,12,9498,5106,3676,532,191,78,19081
8/25/2023,13,9499,5087,3671,480,175,78,18990
8/25/2023,14,9501,5036,3877,487,182,79,19162
8/25/2023,15,9492,4798,4028,448,143,37,18946
8/25/2023,16,9491,4567,4208,442,103,27,18838
8/25/2023,17,9487,4323,4453,321,82,27,18693
8/25/2023,18,9484,4345,4651,190,50,27,18747
8/25/2023,19,9481,4473,4639,217,8,34,18852
8/25/2023,20,9482,4506,4558,190,0,75,18811
8/25/2023,21,9483,4598,4276,184,0,78,18619
8/25/2023,22,9480,4572,3796,163,0,78,18089
8/25/2023,23,9480,3884,3527,221,0,77,17189
8/25/2023,24,9477,2933,3322,254,0,71,16057
8/26/2023,1,9473,2043,3105,233,0,25,14879
8/26/2023,2,9475,1637,3109,224,0,18,14463
8/26/2023,3,9470,1106,3006,303,0,20,13905
8/26/2023,4,9401,1060,3053,437,0,14,13965
8/26/2023,5,9454,1188,2791,506,0,15,13954
8/26/2023,6,9448,1459,3138,530,1,14,14590
8/26/2023,7,9440,1654,3194,719,18,15,15040
8/26/2023,8,9432,2347,3239,639,93,22,15772
8/26/2023,9,9432,2950,3402,558,183,27,16552
8/26/2023,10,9433,3591,3399,633,259,27,17342
8/26/2023,11,9435,3690,3512,746,241,27,17651
8/26/2023,12,9435,3522,3422,862,263,27,17531
8/26/2023,13,9443,3342,3378,976,305,27,17471
8/26/2023,14,9441,3210,3720,1161,337,27,17896
8/26/2023,15,9444,3394,3822,1285,328,27,18300
8/26/2023,16,9457,3224,3957,1486,240,27,18391
8/26/2023,17,9462,3415,4011,1862,174,27,18951
8/26/2023,18,9472,3111,3824,2144,82,27,18660
8/26/2023,19,9476,2943,3949,2103,13,27,18511
8/26/2023,20,9476,2823,3611,2300,0,27,18237
8/26/2023,21,9486,2819,3078,2187,0,27,17597
8/26/2023,22,9487,2090,3134,2072,0,47,16830
8/26/2023,23,9499,1445,3098,1894,0,92,16028
8/26/2023,24,9501,679,2676,1932,0,94,14882
8/27/2023,1,9500,372,2656,1787,0,90,14405
8/27/2023,2,9508,351,2465,1573,0,87,13984
8/27/2023,3,9506,351,2472,1361,0,81,13771
8/27/2023,4,9510,346,2584,1183,0,24,13647
8/27/2023,5,9514,334,2702,1068,0,15,13633
8/27/2023,6,9518,334,2835,1042,0,13,13742
8/27/2023,7,9514,434,2972,928,29,13,13890
8/27/2023,8,9503,734,3305,523,136,21,14222
8/27/2023,9,9498,1308,3084,265,248,26,14429
8/27/2023,10,9494,2037,2859,240,330,26,14986
8/27/2023,11,9489,2434,3017,313,309,26,15588
8/27/2023,12,9497,2463,3075,431,355,27,15848
8/27/2023,13,9492,2631,3405,317,351,27,16223
8/27/2023,14,9479,2935,3522,277,370,27,16610
8/27/2023,15,9470,2898,3790,253,355,26,16792
8/27/2023,16,9465,3248,4171,373,312,26,17595
8/27/2023,17,9457,3718,4398,517,212,26,18328
8/27/2023,18,9459,4026,4496,491,90,30,18592
8/27/2023,19,9457,3699,4352,428,14,38,17988
8/27/2023,20,9446,3958,4108,457,0,39,18008
8/27/2023,21,9452,4050,4046,490,0,38,18076
8/27/2023,22,9454,3524,3613,503,0,42,17136
8/27/2023,23,9446,2803,3417,523,0,36,16225
8/27/2023,24,9470,2218,3063,468,0,19,15238
8/28/2023,1,9482,1294,3013,392,0,13,14194
8/28/2023,2,9496,1212,3038,270,0,13,14029
8/28/2023,3,9494,1399,2702,210,0,13,13818
8/28/2023,4,9488,1561,2887,220,0,13,14169
8/28/2023,5,9495,1561,2915,262,0,13,14246
8/28/2023,6,9494,1830,3431,336,0,13,15104
8/28/2023,7,9492,2477,3612,365,33,13,15992
8/28/2023,8,9493,3024,3541,262,137,29,16486
8/28/2023,9,9491,3290,3376,131,264,59,16611
8/28/2023,10,9482,3476,3612,123,337,81,17111
8/28/2023,11,9474,3906,3617,122,377,89,17585
8/28/2023,12,9460,4738,3714,139,376,102,18529
8/28/2023,13,9451,4598,3929,129,414,105,18626
8/28/2023,14,9447,4345,4060,156,405,104,18517
8/28/2023,15,9451,4608,4246,175,386,88,18954
8/28/2023,16,9453,4584,4471,149,309,83,19049
8/28/2023,17,9457,4739,4420,134,202,90,19042
8/28/2023,18,9456,5027,4533,90,83,110,19299
8/28/2023,19,9456,5092,4277,88,12,213,19138
8/28/2023,20,9449,4856,3977,98,0,239,18619
8/28/2023,21,9446,4835,3707,111,0,231,18330
8/28/2023,22,9442,4387,3556,112,0,237,17734
8/28/2023,23,9452,3727,3396,110,0,235,16920
8/28/2023,24,9458,2982,3098,151,0,177,15866
8/29/2023,1,9458,2056,3053,177,0,63,14807
8/29/2023,2,9466,1847,3098,158,0,16,14585
8/29/2023,3,9466,1506,3215,166,0,16,14369
8/29/2023,4,9466,1484,3233,172,0,16,14371
8/29/2023,5,9461,1746,2896,166,0,16,14285
8/29/2023,6,9463,2276,2959,182,0,16,14896
8/29/2023,7,9458,2405,3317,227,22,16,15445
8/29/2023,8,9460,2649,3354,278,99,33,15873
8/29/2023,9,9462,3554,3536,194,207,71,17024
8/29/2023,10,9461,3900,3535,217,309,72,17494
8/29/2023,11,9461,4123,3435,323,334,53,17729
8/29/2023,12,9455,4087,3497,464,342,75,17920
8/29/2023,13,9443,4348,3712,601,336,89,18529
8/29/2023,14,9424,4539,3703,687,352,82,18787
8/29/2023,15,9408,4353,3954,898,306,76,18995
8/29/2023,16,9398,4322,4395,966,272,77,19430
8/29/2023,17,9377,4251,4310,1057,164,80,19239
8/29/2023,18,9373,4252,4317,1070,60,81,19153
8/29/2023,19,9374,4305,4307,1061,6,81,19134
8/29/2023,20,9363,4624,4189,945,0,81,19202
8/29/2023,21,9349,4656,3984,939,0,81,19009
8/29/2023,22,9381,4223,3699,767,0,81,18151
8/29/2023,23,9378,3427,3100,939,0,40,16884
8/29/2023,24,9363,2224,2985,1292,0,22,15886
8/30/2023,1,9351,1313,2996,1828,0,18,15506
8/30/2023,2,9360,865,2694,2382,0,17,15318
8/30/2023,3,9380,486,2546,2506,0,18,14936
8/30/2023,4,9389,438,2595,2486,0,18,14926
8/30/2023,5,9394,619,2559,2628,0,17,15217
8/30/2023,6,9402,975,3063,2738,0,17,16195
8/30/2023,7,9404,1287,3130,2656,22,17,16516
8/30/2023,8,9403,1526,3195,2701,103,24,16952
8/30/2023,9,9400,1968,3460,2435,164,29,17456
8/30/2023,10,9334,2404,3653,2414,140,29,17974
8/30/2023,11,9374,2831,3579,2391,160,29,18364
8/30/2023,12,9403,2986,3680,2200,156,29,18454
8/30/2023,13,9411,2811,3653,2151,187,29,18242
8/30/2023,14,9420,2816,3655,2021,181,29,18122
8/30/2023,15,9429,3174,3727,1854,133,29,18346
8/30/2023,16,9430,3280,4083,1763,115,29,18700
8/30/2023,17,9430,3213,4218,1750,81,30,18722
8/30/2023,18,9436,3127,3934,1705,43,32,18277
8/30/2023,19,9439,3127,3919,1398,10,32,17925
8/30/2023,20,9439,3736,4151,1125,0,32,18483
8/30/2023,21,9436,3023,3945,1104,0,32,17540
8/30/2023,22,9440,2862,3532,1208,0,32,17074
8/30/2023,23,9438,2150,3123,1252,0,52,16015
8/30/2023,24,9438,1618,2816,1220,0,79,15171
8/31/2023,1,9442,1279,2837,928,0,78,14564
8/31/2023,2,9435,896,2912,847,0,79,14169
8/31/2023,3,9431,861,2734,657,0,79,13762
8/31/2023,4,9432,1091,2689,546,0,79,13837
8/31/2023,5,9424,1354,2851,660,0,79,14368
8/31/2023,6,9421,1750,2758,600,0,93,14622
8/31/2023,7,9426,2062,3169,742,26,81,15506
8/31/2023,8,9425,2195,3116,477,123,94,15430
8/31/2023,9,9429,2294,3550,210,251,86,15820
8/31/2023,10,9432,2281,3297,164,362,89,15625
8/31/2023,11,9449,2551,3548,128,405,81,16162
8/31/2023,12,9460,2553,3636,94,415,82,16240
8/31/2023,13,9455,3048,3755,132,419,89,16898
8/31/2023,14,9445,3249,3637,212,410,94,17047
8/31/2023,15,9439,3178,3826,219,377,87,17126
8/31/2023,16,9421,3436,4112,192,312,83,17556
8/31/2023,17,9418,3748,4286,178,204,42,17876
8/31/2023,18,9426,4166,4295,174,81,31,18173
8/31/2023,19,9432,4236,4315,165,10,32,18190
8/31/2023,20,9422,4162,3986,247,0,32,17849
8/31/2023,21,9429,3823,3961,292,0,31,17536
8/31/2023,22,9443,3278,3659,338,0,31,16749
8/31/2023,23,9450,2326,3390,385,0,40,15591
8/31/2023,24,9462,1533,3191,421,0,76,14683
9/1/2023,1,9466,1270,3053,484,0,82,14355
9/1/2023,2,9487,1235,2918,532,0,74,14246
9/1/2023,3,9507,894,2891,586,0,72,13950
9/1/2023,4,9512,862,3116,639,0,72,14201
9/1/2023,5,9503,1183,3004,626,0,72,14388
9/1/2023,6,9493,1675,2966,599,0,28,14761
9/1/2023,7,9484,1657,3341,566,31,13,15092
9/1/2023,8,9478,1895,3626,513,129,15,15656
9/1/2023,9,9479,2425,3779,320,248,17,16268
9/1/2023,10,9479,2912,3701,296,342,24,16754
9/1/2023,11,9470,3237,3536,347,383,29,17002
9/1/2023,12,9460,3495,3508,336,405,30,17234
9/1/2023,13,9447,3954,3591,399,395,30,17816
9/1/2023,14,9432,3797,3717,477,404,36,17863
9/1/2023,15,9420,3834,3935,487,364,30,18070
9/1/2023,16,9427,4081,4064,538,290,30,18430
9/1/2023,17,9436,4289,4320,434,198,30,18707
9/1/2023,18,9454,4422,4431,412,75,29,18823
9/1/2023,19,9465,4201,4284,571,9,30,18560
9/1/2023,20,9452,3583,4130,725,0,30,17920
9/1/2023,21,9425,3316,4052,1113,0,39,17945
9/1/2023,22,9416,2893,3539,1374,0,69,17291
9/1/2023,23,9413,2113,3275,1493,0,81,16375
9/1/2023,24,9406,1305,3317,1614,0,72,15714
9/2/2023,1,9406,343,2837,1759,0,67,14412
9/2/2023,2,9406,35,2979,1917,0,66,14403
9/2/2023,3,9416,3,2629,1933,0,66,14047
9/2/2023,4,9418,2,2755,1986,0,66,14227
9/2/2023,5,9404,0,2794,1942,0,66,14206
9/2/2023,6,9404,1,3166,1919,0,70,14560
9/2/2023,7,9413,165,2691,1871,24,68,14232
9/2/2023,8,9420,558,2907,1604,117,68,14674
9/2/2023,9,9441,1089,3293,1750,188,70,15831
9/2/2023,10,9452,1879,3394,1862,231,79,16897
9/2/2023,11,9434,2035,3150,2028,253,83,16983
9/2/2023,12,9414,2290,3224,1867,309,83,17187
9/2/2023,13,9410,3110,3764,1751,272,84,18391
9/2/2023,14,9400,3078,3510,2236,211,96,18531
9/2/2023,15,9390,2821,3332,2276,180,88,18087
9/2/2023,16,9380,2918,3416,2422,129,76,18341
9/2/2023,17,9384,2228,3606,2525,82,81,17906
9/2/2023,18,9402,2081,3991,2516,46,92,18128
9/2/2023,19,9400,1739,4246,2366,8,87,17846
9/2/2023,20,9400,1632,4289,2194,0,94,17609
9/2/2023,21,9412,1294,3981,2202,0,78,16967
9/2/2023,22,9426,1014,3529,2150,0,78,16197
9/2/2023,23,9438,863,3199,2140,0,80,15720
9/2/2023,24,9453,490,3280,1979,0,68,15270
9/3/2023,1,9477,220,2821,1869,0,27,14414
9/3/2023,2,9493,189,2650,1849,0,14,14195
9/3/2023,3,9505,34,2546,1423,0,14,13522
9/3/2023,4,9503,0,2606,1338,0,14,13461
9/3/2023,5,9504,0,2626,1649,0,14,13793
9/3/2023,6,9504,1,3048,1952,0,14,14519
9/3/2023,7,9506,388,3005,1917,22,14,14852
9/3/2023,8,9500,1037,3151,1591,127,14,15420
9/3/2023,9,9496,1987,3120,1333,245,14,16195
9/3/2023,10,9488,2587,3169,1342,340,29,16955
9/3/2023,11,9482,2974,3279,1432,397,68,17632
9/3/2023,12,9476,3410,3486,1492,410,80,18354
9/3/2023,13,9470,3709,3652,1514,391,80,18816
9/3/2023,14,9468,3738,3672,1929,330,80,19217
9/3/2023,15,9487,3696,3937,2325,326,80,19851
9/3/2023,16,9505,3475,4006,2618,245,80,19929
9/3/2023,17,9522,3418,4168,2571,139,80,19898
9/3/2023,18,9523,3434,4364,2438,58,80,19897
9/3/2023,19,9508,3291,4219,2392,5,34,19449
9/3/2023,20,9498,3341,4010,2512,0,27,19388
9/3/2023,21,9503,3273,3790,2578,0,27,19171
9/3/2023,22,9489,3412,3631,2418,0,27,18977
9/3/2023,23,9487,3064,3334,2359,0,27,18271
9/3/2023,24,9483,2293,3458,2140,0,17,17391
9/4/2023,1,9476,1926,3238,1932,0,14,16586
9/4/2023,2,9469,1591,3354,1733,0,14,16161
9/4/2023,3,9468,1211,3359,1717,0,14,15769
9/4/2023,4,9482,1110,3195,1716,0,14,15517
9/4/2023,5,9489,1422,3184,1584,0,14,15693
9/4/2023,6,9503,1950,2879,1484,0,14,15830
9/4/2023,7,9519,2578,2781,934,20,14,15846
9/4/2023,8,9521,2933,2841,556,110,13,15974
9/4/2023,9,9526,3149,3090,750,228,13,16756
9/4/2023,10,9534,4199,3458,656,329,21,18197
9/4/2023,11,9548,4671,3405,567,390,53,18634
9/4/2023,12,9549,4932,3439,662,412,66,19060
9/4/2023,13,9534,5248,3736,852,411,80,19861
9/4/2023,14,9537,5346,3949,1131,401,89,20453
9/4/2023,15,9529,5321,4139,1317,369,90,20765
9/4/2023,16,9513,5351,4364,1324,290,108,20950
9/4/2023,17,9494,5399,4751,1127,181,132,21084
9/4/2023,18,9498,5448,4819,896,68,143,20872
9/4/2023,19,9486,5115,5125,873,7,178,20784
9/4/2023,20,9470,4942,4532,904,0,132,19980
9/4/2023,21,9479,4789,4151,844,0,94,19357
9/4/2023,22,9481,4025,3666,950,0,76,18198
9/4/2023,23,9491,3230,3435,1169,0,75,17400
9/4/2023,24,9503,2850,3337,1237,0,26,16953
9/5/2023,1,9526,2836,3176,1222,0,10,16770
9/5/2023,2,9531,2958,3038,1246,0,10,16783
9/5/2023,3,9535,3164,2872,1129,0,10,16710
9/5/2023,4,9528,3144,2878,1062,0,12,16624
9/5/2023,5,9509,3221,2963,922,0,22,16637
9/5/2023,6,9499,3573,3291,830,0,28,17221
9/5/2023,7,9500,4238,3558,707,19,31,18053
9/5/2023,8,9494,4818,3762,479,122,31,18706
9/5/2023,9,9474,5168,4133,193,241,20,19229
9/5/2023,10,9457,5528,4151,120,334,28,19618
9/5/2023,11,9452,5831,4444,135,385,39,20286
9/5/2023,12,9441,5984,4322,238,377,48,20410
9/5/2023,13,9437,6143,4435,446,397,89,20947
9/5/2023,14,9418,6369,4475,607,389,98,21356
9/5/2023,15,9408,6624,4623,800,360,103,21918
9/5/2023,16,9404,7049,4648,830,288,155,22374
9/5/2023,17,9417,7136,4747,790,186,153,22429
9/5/2023,18,9436,7078,4909,646,66,105,22240
9/5/2023,19,9454,6776,4866,603,4,98,21801
9/5/2023,20,9469,6645,4509,742,0,96,21461
9/5/2023,21,9466,5994,3935,996,0,97,20488
9/5/2023,22,9466,5422,3505,1218,0,97,19708
9/5/2023,23,9468,4476,3050,1330,0,78,18402
9/5/2023,24,9462,3580,2898,1528,0,81,17549
9/6/2023,1,9448,3396,2815,1565,0,72,17296
9/6/2023,2,9442,3359,2837,1599,0,80,17317
9/6/2023,3,9433,3599,2807,1550,0,66,17455
9/6/2023,4,9433,3588,2948,1378,0,67,17414
9/6/2023,5,9437,3755,2921,1197,0,65,17375
9/6/2023,6,9435,4093,3057,983,0,66,17634
9/6/2023,7,9437,4685,3434,841,14,66,18477
9/6/2023,8,9436,5264,3334,770,113,66,18983
9/6/2023,9,9439,5302,3385,709,223,66,19124
9/6/2023,10,9437,5329,3469,1018,296,71,19620
9/6/2023,11,9437,5453,3581,1404,334,82,20291
9/6/2023,12,9051,5739,3988,1918,335,92,21123
9/6/2023,13,8659,5692,4391,2033,332,95,21202
9/6/2023,14,8664,6198,4471,1723,327,96,21479
9/6/2023,15,8654,6085,4773,1623,289,94,21518
9/6/2023,16,8633,5976,5084,1543,176,94,21506
9/6/2023,17,8623,6511,4920,1707,85,95,21941
9/6/2023,18,8616,6263,4726,1514,66,96,21281
9/6/2023,19,8606,5982,4750,1216,25,94,20673
9/6/2023,20,8591,6090,4584,883,0,86,20234
9/6/2023,21,8568,6315,4484,730,0,81,20178
9/6/2023,22,8573,5598,3976,905,0,79,19131
9/6/2023,23,8595,5223,3438,916,0,78,18250
9/6/2023,24,8616,4869,3206,936,0,72,17699
9/7/2023,1,8626,5002,2978,737,0,69,17412
9/7/2023,2,8624,4954,2850,606,0,67,17101
9/7/2023,3,8627,4747,2826,623,0,66,16889
9/7/2023,4,8647,4496,2984,581,0,67,16775
9/7/2023,5,8664,4639,2891,555,0,68,16817
9/7/2023,6,8673,4688,2969,613,0,67,17010
9/7/2023,7,8673,5069,3379,609,7,66,17803
9/7/2023,8,8676,5545,3363,549,35,67,18235
9/7/2023,9,8681,5764,3419,516,66,67,18513
9/7/2023,10,8243,5954,4107,518,89,80,18991
9/7/2023,11,7876,6218,4453,569,159,87,19362
9/7/2023,12,7846,6289,4614,703,189,95,19736
9/7/2023,13,7828,6340,4709,650,258,104,19889
9/7/2023,14,7808,6416,4488,523,297,101,19633
9/7/2023,15,7810,5894,4522,609,275,102,19212
9/7/2023,16,7812,6138,4901,1074,205,102,20232
9/7/2023,17,7812,6485,4461,1181,163,100,20202
9/7/2023,18,7812,5695,4437,1768,99,96,19907
9/7/2023,19,7802,5858,4586,1738,63,101,20148
9/7/2023,20,7812,5869,4467,1800,17,86,20051
9/7/2023,21,7806,5388,4040,1668,0,80,18982
9/7/2023,22,7813,5210,3733,1328,0,81,18165
9/7/2023,23,7837,4744,3194,1209,0,81,17065
9/7/2023,24,7847,4005,3109,968,0,73,16002
9/8/2023,1,7921,3619,3211,765,0,23,15539
9/8/2023,2,8016,3683,2929,577,0,13,15218
9/8/2023,3,8095,3825,2925,452,0,13,15310
9/8/2023,4,8094,3862,2950,391,0,13,15310
9/8/2023,5,8106,4087,2861,346,0,13,15413
9/8/2023,6,8095,4556,3066,356,0,13,16086
9/8/2023,7,8087,5015,3636,376,5,13,17132
9/8/2023,8,8091,5560,3540,326,38,13,17568
9/8/2023,9,8091,5283,3485,330,85,13,17287
9/8/2023,10,8095,5082,3509,320,166,22,17194
9/8/2023,11,8096,4916,3713,276,244,25,17270
9/8/2023,12,8096,4721,3870,260,229,25,17201
9/8/2023,13,8111,4852,3691,315,166,31,17166
9/8/2023,14,8232,4786,3884,338,143,49,17432
9/8/2023,15,8203,4740,3889,306,140,52,17330
9/8/2023,16,8082,4692,4513,282,127,51,17747
9/8/2023,17,8085,5199,4384,305,78,50,18101
9/8/2023,18,8257,4366,4410,399,39,52,17523
9/8/2023,19,8469,3721,4190,447,15,49,16891
9/8/2023,20,8580,4311,3834,402,14,33,17174
9/8/2023,21,8588,4372,3708,290,14,26,16998
9/8/2023,22,8592,4107,3482,239,4,26,16450
9/8/2023,23,8592,3297,3169,267,0,26,15351
9/8/2023,24,8573,2618,2881,271,0,19,14362
9/9/2023,1,8573,2225,3187,179,0,14,14178
9/9/2023,2,8316,1975,3225,121,0,13,13650
9/9/2023,3,8229,1922,3300,117,0,13,13581
9/9/2023,4,8225,1669,3099,128,0,13,13134
9/9/2023,5,8269,1913,3159,170,0,13,13524
9/9/2023,6,8313,2079,3177,187,0,13,13769
9/9/2023,7,8313,2336,3196,225,4,13,14087
9/9/2023,8,8313,2740,3200,176,70,13,14512
9/9/2023,9,8318,2887,3231,181,173,13,14803
9/9/2023,10,8321,2883,3167,151,214,22,14758
9/9/2023,11,8320,3074,3433,114,231,26,15198
9/9/2023,12,8308,3483,3443,69,251,26,15580
9/9/2023,13,8291,3845,3419,56,252,27,15890
9/9/2023,14,8292,3690,3694,109,247,26,16058
9/9/2023,15,8294,3068,3748,186,217,26,15539
9/9/2023,16,8279,3528,3923,224,137,27,16118
9/9/2023,17,8273,3548,3925,210,71,27,16054
9/9/2023,18,8343,3858,3945,182,25,27,16380
9/9/2023,19,8513,3896,3813,196,0,27,16445
9/9/2023,20,8515,4024,3518,174,0,27,16258
9/9/2023,21,8542,3684,3262,169,0,27,15684
9/9/2023,22,8632,3245,3234,113,0,27,15251
9/9/2023,23,8646,2860,3126,79,0,27,14738
9/9/2023,24,8648,2515,3132,94,0,19,14408
9/10/2023,1,8651,2176,3085,63,0,15,13990
9/10/2023,2,8661,1832,3076,87,0,15,13671
9/10/2023,3,8657,1701,2971,155,0,15,13499
9/10/2023,4,8658,1272,3119,116,0,15,13180
9/10/2023,5,8655,1343,3091,94,0,15,13198
9/10/2023,6,8652,1421,3034,152,0,15,13274
9/10/2023,7,8649,1446,2993,172,7,15,13282
9/10/2023,8,8636,1721,3020,173,32,15,13597
9/10/2023,9,8634,2164,3377,102,75,15,14367
9/10/2023,10,8612,2713,3454,58,126,22,14985
9/10/2023,11,8601,3613,3436,42,150,28,15870
9/10/2023,12,8592,4048,3335,39,206,30,16250
9/10/2023,13,8597,3927,3348,48,245,30,16195
9/10/2023,14,8593,3935,3699,56,210,28,16521
9/10/2023,15,8588,3691,3891,91,170,27,16458
9/10/2023,16,8578,3764,3931,155,137,27,16592
9/10/2023,17,8582,3879,4036,196,74,27,16794
9/10/2023,18,8576,3883,4019,175,36,27,16716
9/10/2023,19,8584,3968,4084,173,2,27,16838
9/10/2023,20,8569,4201,3889,153,0,27,16839
9/10/2023,21,8584,4106,3505,149,0,27,16371
9/10/2023,22,8584,3694,3453,184,0,27,15942
9/10/2023,23,8582,3115,3173,186,0,27,15083
9/10/2023,24,8582,2546,3174,186,0,19,14507
9/11/2023,1,8588,2125,3052,246,0,16,14027
9/11/2023,2,8588,2023,3033,303,0,15,13962
9/11/2023,3,8587,1857,2941,264,0,15,13664
9/11/2023,4,8583,1955,2813,273,0,15,13639
9/11/2023,5,8581,2458,2631,156,0,15,13841
9/11/2023,6,8585,3153,3087,219,0,15,15059
9/11/2023,7,8589,4095,3144,200,16,15,16059
9/11/2023,8,8742,4148,3285,171,105,15,16466
9/11/2023,9,8678,4397,3413,103,223,15,16829
9/11/2023,10,8583,4955,3507,69,315,23,17452
9/11/2023,11,8574,5005,3659,51,339,26,17654
9/11/2023,12,8567,5202,3798,68,318,28,17981
9/11/2023,13,8568,4905,3826,89,366,27,17781
9/11/2023,14,8553,5030,3837,127,366,35,17948
9/11/2023,15,8549,5068,3991,133,311,36,18088
9/11/2023,16,8544,5223,4141,150,229,37,18324
9/11/2023,17,8546,5325,4172,130,128,59,18360
9/11/2023,18,8545,5496,4061,87,37,87,18313
9/11/2023,19,8552,5527,4006,97,1,86,18269
9/11/2023,20,8552,5398,3917,152,0,75,18094
9/11/2023,21,8551,5336,3848,145,0,74,17954
9/11/2023,22,8555,4570,3557,158,0,44,16884
9/11/2023,23,8555,3894,3255,242,0,23,15969
9/11/2023,24,8554,3220,3108,364,0,15,15261
9/12/2023,1,8615,2718,3152,428,0,11,14924
9/12/2023,2,8782,2050,3125,480,0,11,14448
9/12/2023,3,9055,1999,3077,456,0,11,14598
9/12/2023,4,9164,2281,3017,606,0,11,15079
9/12/2023,5,9147,2353,2662,756,0,11,14929
9/12/2023,6,9240,2771,3314,690,0,11,16026
9/12/2023,7,9270,3416,3419,855,11,11,16982
9/12/2023,8,9260,3821,3488,957,33,11,17570
9/12/2023,9,9254,4005,3470,1011,72,11,17823
9/12/2023,10,9248,4160,3503,993,88,18,18010
9/12/2023,11,9239,3994,3422,1064,139,23,17881
9/12/2023,12,9253,3618,3786,1250,183,23,18113
9/12/2023,13,9365,3814,3942,1171,187,24,18503
9/12/2023,14,9365,3946,3912,980,164,23,18390
9/12/2023,15,9393,4176,3964,862,140,23,18558
9/12/2023,16,9399,4399,4214,724,92,23,18851
9/12/2023,17,9399,4004,4347,907,63,23,18743
9/12/2023,18,9409,4233,4272,802,26,23,18765
9/12/2023,19,9411,4442,4275,808,3,23,18962
9/12/2023,20,9422,4298,4108,938,0,23,18789
9/12/2023,21,9443,3762,4029,1021,0,23,18278
9/12/2023,22,9544,2551,3934,900,0,23,16952
9/12/2023,23,9556,1702,3826,653,0,27,15764
9/12/2023,24,9563,1043,3672,758,0,23,15059
9/13/2023,1,9570,785,2948,889,0,22,14214
9/13/2023,2,9590,738,2874,1022,0,19,14243
9/13/2023,3,9598,738,2925,879,0,19,14159
9/13/2023,4,9601,843,3352,860,0,19,14675
9/13/2023,5,9600,1174,3481,884,0,19,15158
9/13/2023,6,9604,1544,3368,956,0,19,15491
9/13/2023,7,9605,1731,3637,997,18,19,16007
9/13/2023,8,9605,1893,3917,924,112,19,16470
9/13/2023,9,9604,2215,3894,854,220,19,16806
9/13/2023,10,9604,1999,3796,946,227,24,16596
9/13/2023,11,9608,2008,4070,971,237,31,16925
9/13/2023,12,9616,2211,4106,946,287,31,17197
9/13/2023,13,9620,2787,4113,931,268,51,17770
9/13/2023,14,9637,2864,3970,1023,228,80,17802
9/13/2023,15,9640,2873,3927,1081,191,84,17796
9/13/2023,16,9640,2987,4035,1096,183,84,18025
9/13/2023,17,9648,3076,3998,1053,118,84,17977
9/13/2023,18,9659,3074,3619,1015,44,83,17494
9/13/2023,19,9671,3078,3913,794,3,83,17542
9/13/2023,20,9687,3050,4174,713,0,83,17707
9/13/2023,21,9697,2131,3847,656,0,83,16414
9/13/2023,22,9696,1665,3660,685,0,39,15745
9/13/2023,23,9701,1599,3366,584,0,5,15255
9/13/2023,24,9710,1258,3026,500,0,0,14494
9/14/2023,1,9718,1161,3058,401,0,2,14340
9/14/2023,2,9729,1161,3109,340,0,22,14361
9/14/2023,3,9723,1262,3039,304,0,23,14351
9/14/2023,4,9722,1317,2842,365,0,29,14275
9/14/2023,5,9729,1956,2686,223,0,34,14628
9/14/2023,6,9742,2007,2945,348,0,41,15083
9/14/2023,7,9744,2113,3597,427,24,45,15950
9/14/2023,8,9755,2004,3630,292,125,43,15849
9/14/2023,9,9763,1992,3686,158,223,33,15855
9/14/2023,10,9768,2013,3870,152,263,39,16105
9/14/2023,11,9776,1934,4136,179,277,57,16359
9/14/2023,12,9784,2100,4187,192,285,59,16607
9/14/2023,13,9788,2277,4261,208,236,59,16829
9/14/2023,14,9790,2422,4187,234,234,68,16935
9/14/2023,15,9797,2569,4162,266,297,44,17135
9/14/2023,16,9798,2548,4434,242,267,43,17332
9/14/2023,17,9790,2745,4496,181,176,45,17433
9/14/2023,18,9775,2890,4515,173,54,44,17451
9/14/2023,19,9768,2766,4364,165,1,44,17108
9/14/2023,20,9755,2704,4147,187,0,45,16838
9/14/2023,21,9762,2509,4147,223,0,45,16686
9/14/2023,22,9765,2326,3915,231,0,46,16283
9/14/2023,23,9779,2067,3619,245,0,45,15755
9/14/2023,24,9782,1485,3351,261,0,45,14924
9/15/2023,1,9793,668,3208,281,0,37,13987
9/15/2023,2,9799,374,3151,258,0,48,13630
9/15/2023,3,9799,336,3308,225,0,29,13697
9/15/2023,4,9786,402,3385,198,0,19,13790
9/15/2023,5,9794,689,3764,209,0,18,14474
9/15/2023,6,9796,1268,3831,198,0,18,15111
9/15/2023,7,9800,1321,4058,232,15,18,15444
9/15/2023,8,9791,1354,4003,228,90,18,15484
9/15/2023,9,9769,1166,4168,169,196,24,15492
9/15/2023,10,9750,1115,4286,134,271,32,15588
9/15/2023,11,9733,1527,4383,172,284,31,16130
9/15/2023,12,9725,1696,4387,227,295,30,16360
9/15/2023,13,9713,1931,4172,283,283,31,16413
9/15/2023,14,9709,1809,4348,292,293,30,16481
9/15/2023,15,9746,2210,4409,281,255,30,16931
9/15/2023,16,9730,2492,4597,229,198,30,17276
9/15/2023,17,9752,3033,4519,201,127,31,17663
9/15/2023,18,9762,2734,4298,200,48,30,17072
9/15/2023,19,9661,2279,4149,230,1,30,16350
9/15/2023,20,9413,2151,4008,255,0,29,15856
9/15/2023,21,9168,2132,3970,234,0,29,15533
9/15/2023,22,8986,2021,4008,200,0,29,15244
9/15/2023,23,8981,1497,3914,195,0,29,14616
9/15/2023,24,8967,1105,3818,193,0,21,14104
9/16/2023,1,8958,320,3726,252,0,16,13272
9/16/2023,2,8957,206,3703,267,0,16,13149
9/16/2023,3,8953,210,3268,290,0,16,12737
9/16/2023,4,8958,326,3199,266,0,16,12765
9/16/2023,5,8947,500,3275,233,0,16,12971
9/16/2023,6,8946,772,3188,209,0,16,13131
9/16/2023,7,8948,828,3476,183,13,16,13464
9/16/2023,8,8960,753,3849,148,99,16,13825
9/16/2023,9,8966,773,4078,72,224,16,14129
9/16/2023,10,8967,924,4142,42,340,27,14442
9/16/2023,11,8952,1284,4172,104,362,29,14903
9/16/2023,12,8934,1204,4056,157,338,29,14718
9/16/2023,13,8929,1636,4245,180,348,30,15368
9/16/2023,14,8921,1935,4191,222,349,30,15648
9/16/2023,15,8924,2227,4219,255,310,29,15964
9/16/2023,16,8931,2684,4106,302,243,30,16296
9/16/2023,17,8930,2389,4221,328,141,30,16039
9/16/2023,18,8936,2240,4045,351,41,30,15643
9/16/2023,19,8947,2227,4153,350,0,29,15706
9/16/2023,20,8949,1798,4141,444,0,29,15361
9/16/2023,21,8951,1663,4127,459,0,29,15229
9/16/2023,22,8953,1523,3972,449,0,27,14924
9/16/2023,23,8955,1229,3611,457,0,28,14280
9/16/2023,24,8962,334,3365,499,0,21,13181
9/17/2023,1,8978,151,3092,389,0,17,12627
9/17/2023,2,8974,147,3091,357,0,17,12586
9/17/2023,3,8979,147,3408,257,0,17,12808
9/17/2023,4,8977,147,3352,174,0,17,12667
9/17/2023,5,8976,147,2914,218,0,17,12272
9/17/2023,6,8978,147,3161,130,0,17,12433
9/17/2023,7,8980,146,3344,82,11,17,12580
9/17/2023,8,8972,213,3694,64,70,17,13030
9/17/2023,9,8962,523,3788,58,148,17,13496
9/17/2023,10,8958,844,3801,73,218,0,13894
9/17/2023,11,8952,1208,4257,73,242,0,14732
9/17/2023,12,8933,1613,4709,105,263,0,15623
9/17/2023,13,8939,2099,4357,195,271,0,15861
9/17/2023,14,8933,1887,4408,322,277,0,15827
9/17/2023,15,8920,2131,4280,401,261,0,15993
9/17/2023,16,8922,2459,4567,496,174,0,16618
9/17/2023,17,8926,2800,4336,507,85,0,16654
9/17/2023,18,8939,2747,4382,593,22,0,16683
9/17/2023,19,8934,2805,4660,517,0,0,16916
9/17/2023,20,8936,2954,4332,343,0,0,16565
9/17/2023,21,8943,2979,4112,363,0,29,16426
9/17/2023,22,8955,2095,3933,431,0,29,15443
9/17/2023,23,8957,1117,3653,437,0,29,14193
9/17/2023,24,8953,819,3330,448,0,22,13572
9/18/2023,1,8946,778,3242,462,0,17,13445
9/18/2023,2,8942,776,2781,556,0,17,13072
9/18/2023,3,8929,778,2959,607,0,17,13290
9/18/2023,4,8936,973,2710,556,0,17,13192
9/18/2023,5,8939,1344,2893,177,0,17,13370
9/18/2023,6,8949,1790,3004,628,0,17,14388
9/18/2023,7,8939,1801,3507,915,9,17,15188
9/18/2023,8,8923,1952,4188,894,80,17,16054
9/18/2023,9,8918,2138,3941,925,180,17,16119
9/18/2023,10,8910,2332,4129,810,267,23,16471
9/18/2023,11,8911,2830,4087,1049,266,30,17173
9/18/2023,12,8910,2882,4077,1205,261,30,17365
9/18/2023,13,8927,3163,4121,1364,255,30,17860
9/18/2023,14,8942,3041,4052,1514,217,29,17795
9/18/2023,15,8941,3039,3685,1534,192,29,17420
9/18/2023,16,8941,2728,3817,1539,141,28,17194
9/18/2023,17,8942,2720,4101,1415,86,28,17292
9/18/2023,18,8951,2935,4152,1086,35,28,17187
9/18/2023,19,8962,3093,4124,822,2,28,17031
9/18/2023,20,8968,3118,3873,766,0,28,16753
9/18/2023,21,8974,2653,3883,749,0,28,16287
9/18/2023,22,8972,2401,3883,637,0,27,15920
9/18/2023,23,8978,2119,3655,541,0,27,15320
9/18/2023,24,8978,1644,3206,486,0,21,14335
9/19/2023,1,8980,1132,3005,458,0,15,13590
9/19/2023,2,8969,1008,3007,430,0,14,13428
9/19/2023,3,8978,1124,3125,429,0,15,13671
9/19/2023,4,8988,1256,3158,471,0,15,13888
9/19/2023,5,8979,1406,2970,293,0,15,13663
9/19/2023,6,8970,1518,3241,515,0,15,14259
9/19/2023,7,8957,1900,3842,590,12,16,15317
9/19/2023,8,8955,2073,3788,508,86,17,15427
9/19/2023,9,8973,2007,3682,345,201,17,15225
9/19/2023,10,8992,1906,3682,423,271,24,15298
9/19/2023,11,9004,2092,3858,560,338,29,15881
9/19/2023,12,9018,2261,3807,560,337,30,16013
9/19/2023,13,9018,2491,3781,526,317,30,16163
9/19/2023,14,9014,2782,3875,558,295,30,16554
9/19/2023,15,9019,2729,3890,514,296,30,16478
9/19/2023,16,9019,3062,4248,420,228,30,17007
9/19/2023,17,9020,3201,4253,365,140,30,17009
9/19/2023,18,9024,3052,4163,305,42,31,16617
9/19/2023,19,9025,3081,4242,305,0,31,16684
9/19/2023,20,9003,2836,4021,351,0,36,16247
9/19/2023,21,8997,2767,3734,393,0,63,15954
9/19/2023,22,8979,2567,3426,346,0,84,15402
9/19/2023,23,8975,2322,3366,273,0,83,15019
9/19/2023,24,8987,1616,2888,217,0,78,13786
9/20/2023,1,8997,926,3176,199,0,71,13369
9/20/2023,2,9011,823,3233,178,0,26,13271
9/20/2023,3,9025,1021,3107,146,0,18,13317
9/20/2023,4,9035,1259,3275,166,0,18,13753
9/20/2023,5,9037,1412,3221,213,0,18,13901
9/20/2023,6,9037,1600,3457,284,0,19,14397
9/20/2023,7,9028,2256,3670,331,22,21,15328
9/20/2023,8,9010,2190,3688,355,126,21,15390
9/20/2023,9,8998,2121,3811,284,246,21,15481
9/20/2023,10,8980,2129,3834,246,342,26,15557
9/20/2023,11,8967,2519,3946,301,377,31,16141
9/20/2023,12,8957,2444,4107,341,398,41,16288
9/20/2023,13,8939,2819,4047,295,392,73,16565
9/20/2023,14,8898,3205,3900,292,395,82,16772
9/20/2023,15,8875,2993,4003,319,352,82,16624
9/20/2023,16,8924,3025,4220,288,280,82,16819
9/20/2023,17,8949,3138,4323,295,157,82,16944
9/20/2023,18,8958,3237,4168,323,41,82,16809
9/20/2023,19,8970,3131,4140,416,0,82,16739
9/20/2023,20,8979,3227,3987,528,0,82,16803
9/20/2023,21,8984,3038,3768,636,0,82,16508
9/20/2023,22,8985,2665,3499,725,0,38,15912
9/20/2023,23,8968,2181,3208,726,0,31,15114
9/20/2023,24,8942,1863,2950,652,0,24,14431
9/21/2023,1,8940,1090,3019,643,0,19,13711
9/21/2023,2,8939,830,3290,740,0,19,13818
9/21/2023,3,8937,968,3194,739,0,19,13857
9/21/2023,4,8930,1085,3207,700,0,19,13941
9/21/2023,5,8917,1508,3289,680,0,19,14413
9/21/2023,6,8915,1951,3505,703,0,40,15114
9/21/2023,7,8919,2364,3771,694,17,72,15837
9/21/2023,8,8917,2451,3865,672,95,71,16071
9/21/2023,9,8915,2463,3863,411,195,72,15919
9/21/2023,10,8920,2751,3906,233,296,82,16188
9/21/2023,11,8934,2865,3827,183,372,83,16264
9/21/2023,12,8932,3059,3859,117,388,83,16438
9/21/2023,13,8906,3520,4285,94,392,84,17281
9/21/2023,14,8869,3936,4186,121,396,82,17590
9/21/2023,15,8866,3975,4143,103,347,88,17522
9/21/2023,16,8881,4167,4256,116,258,138,17816
9/21/2023,17,8886,4067,4410,116,133,127,17739
9/21/2023,18,8875,3951,4225,105,32,131,17319
9/21/2023,19,8874,4068,4140,220,0,179,17481
9/21/2023,20,8872,4118,3925,353,0,140,17408
9/21/2023,21,8870,3819,3852,490,0,105,17136
9/21/2023,22,8872,3224,3729,718,0,63,16606
9/21/2023,23,8880,2940,3449,923,0,31,16223
9/21/2023,24,8873,1771,3146,867,0,23,14680
9/22/2023,1,8867,998,2973,837,0,19,13694
9/22/2023,2,8873,830,3017,829,0,19,13568
9/22/2023,3,8867,1042,2711,893,0,19,13532
9/22/2023,4,8870,1396,2597,881,0,19,13763
9/22/2023,5,8861,1521,2673,784,0,19,13858
9/22/2023,6,8855,1851,3023,1027,0,18,14774
9/22/2023,7,8857,2236,3666,944,14,19,15736
9/22/2023,8,8854,2070,3762,881,95,19,15681
9/22/2023,9,8851,2515,3842,562,202,26,15998
9/22/2023,10,8853,2862,3924,355,287,69,16350
9/22/2023,11,8855,2831,4056,298,327,118,16485
9/22/2023,12,8853,2688,4148,299,350,106,16444
9/22/2023,13,8846,2950,4214,367,371,82,16830
9/22/2023,14,8844,3084,4215,346,356,81,16926
9/22/2023,15,8839,3451,4276,367,325,43,17301
9/22/2023,16,8830,3709,4371,418,240,29,17597
9/22/2023,17,8828,3864,4562,493,132,29,17908
9/22/2023,18,8826,3957,4215,548,39,29,17614
9/22/2023,19,8824,3853,4087,846,0,29,17639
9/22/2023,20,8829,3550,3849,1339,0,29,17596
9/22/2023,21,8825,2987,3345,1646,0,29,16832
9/22/2023,22,8823,2245,3131,1759,0,29,15987
9/22/2023,23,8824,1683,3011,1595,0,29,15142
9/22/2023,24,8828,727,2938,1544,0,21,14058
9/23/2023,1,8824,347,2864,1564,0,17,13616
9/23/2023,2,8827,184,3171,1260,0,17,13459
9/23/2023,3,8831,272,3340,885,0,17,13345
9/23/2023,4,8830,491,3216,628,0,17,13182
9/23/2023,5,8823,686,3155,574,0,17,13255
9/23/2023,6,8825,890,3339,482,0,17,13553
9/23/2023,7,8826,1453,3325,569,9,17,14199
9/23/2023,8,8825,1254,3332,762,64,17,14254
9/23/2023,9,8819,1420,3462,584,145,17,14447
9/23/2023,10,8819,1652,3576,556,252,24,14879
9/23/2023,11,8818,1656,3738,857,349,28,15446
9/23/2023,12,8810,1360,3142,1272,367,28,14979
9/23/2023,13,8807,1314,3108,1165,353,28,14775
9/23/2023,14,8804,1473,3205,1747,326,28,15583
9/23/2023,15,8802,1790,3178,1673,263,28,15734
9/23/2023,16,8800,1950,3447,1647,176,28,16048
9/23/2023,17,8801,1972,3772,1664,96,28,16333
9/23/2023,18,8801,1967,3856,1597,31,24,16276
9/23/2023,19,8801,2081,3832,1641,0,18,16373
9/23/2023,20,8794,2334,3899,1610,0,3,16640
9/23/2023,21,8795,2163,3535,1681,0,0,16174
9/23/2023,22,8803,1783,3457,1786,0,0,15829
9/23/2023,23,8806,1077,3180,2066,0,0,15129
9/23/2023,24,8804,329,2849,2262,0,0,14244
9/24/2023,1,8801,154,3076,1931,0,0,13962
9/24/2023,2,8800,155,3229,1777,0,0,13961
9/24/2023,3,8797,157,3450,1668,0,0,14072
9/24/2023,4,8800,148,3141,1777,0,0,13866
9/24/2023,5,8794,143,2907,1821,0,0,13665
9/24/2023,6,8806,244,2756,2036,0,0,13842
9/24/2023,7,8810,470,2935,2115,13,0,14343
9/24/2023,8,8805,777,3097,1912,94,0,14685
9/24/2023,9,8798,1170,3432,1702,216,0,15318
9/24/2023,10,8802,1359,3072,1558,315,0,15106
9/24/2023,11,8796,1719,3122,1309,387,0,15333
9/24/2023,12,8795,2290,3125,798,371,0,15379
9/24/2023,13,8788,2649,3259,552,305,0,15553
9/24/2023,14,8786,2281,3319,1108,276,0,15770
9/24/2023,15,8760,2310,3401,1423,226,0,16120
9/24/2023,16,8712,2767,3879,1398,185,0,16941
9/24/2023,17,8701,3558,3972,1198,100,0,17529
9/24/2023,18,8714,3525,4163,1034,22,0,17458
9/24/2023,19,8716,3489,4079,1123,0,0,17407
9/24/2023,20,8716,3192,3802,1166,0,0,16876
9/24/2023,21,8718,3180,3567,1140,0,0,16605
9/24/2023,22,8718,2610,3481,1219,0,0,16028
9/24/2023,23,8716,2085,3342,1285,0,0,15428
9/24/2023,24,8683,1838,2974,1217,0,0,14712
9/25/2023,1,8694,1298,3106,1087,0,0,14185
9/25/2023,2,8699,1067,3142,1007,0,0,13915
9/25/2023,3,8702,1059,2911,1026,0,0,13698
9/25/2023,4,8737,1601,2633,834,0,0,13805
9/25/2023,5,8761,2013,2661,807,0,0,14242
9/25/2023,6,8767,2570,2690,968,0,0,14995
9/25/2023,7,8767,2779,3215,1276,13,0,16050
9/25/2023,8,8766,2778,3276,1248,87,0,16155
9/25/2023,9,8763,2886,3474,1061,180,0,16364
9/25/2023,10,8764,3065,3567,1043,255,0,16694
9/25/2023,11,8764,3030,3563,1120,304,0,16781
9/25/2023,12,8791,3283,3560,1230,324,0,17188
9/25/2023,13,8826,3367,3727,1330,339,0,17589
9/25/2023,14,8817,3485,3856,1180,313,0,17651
9/25/2023,15,8810,3546,3840,1011,294,6,17507
9/25/2023,16,8802,3592,4041,965,178,10,17588
9/25/2023,17,8809,3758,4122,884,76,8,17657
9/25/2023,18,8809,3542,4092,977,14,16,17450
9/25/2023,19,8824,3287,4029,1209,0,22,17371
9/25/2023,20,8837,3219,3941,1399,0,20,17416
9/25/2023,21,8839,3369,3637,1531,0,9,17385
9/25/2023,22,8838,3197,3323,1554,0,12,16924
9/25/2023,23,8838,2438,3070,1650,0,4,16000
9/25/2023,24,8842,1862,2922,1689,0,0,15315
9/26/2023,1,8839,1359,2815,1739,0,0,14752
9/26/2023,2,8838,854,2958,1670,0,0,14320
9/26/2023,3,8841,883,3032,1632,0,0,14388
9/26/2023,4,8843,1134,2739,1652,0,0,14368
9/26/2023,5,8846,1619,2729,1712,0,0,14906
9/26/2023,6,8852,2036,3037,1922,0,0,15847
9/26/2023,7,8844,2331,3617,1903,5,0,16700
9/26/2023,8,8810,2681,3780,1474,76,0,16821
9/26/2023,9,8767,2971,3675,1232,176,0,16821
9/26/2023,10,8700,2973,3531,1336,234,0,16774
9/26/2023,11,8662,2574,3451,1574,246,0,16507
9/26/2023,12,8528,2388,3472,1848,288,0,16524
9/26/2023,13,8581,2465,3665,2026,280,0,17017
9/26/2023,14,8605,2529,3650,2120,263,0,17167
9/26/2023,15,8609,2690,3611,2215,230,0,17355
9/26/2023,16,8621,2831,3748,2223,171,0,17594
9/26/2023,17,8607,2912,3785,2207,91,0,17602
9/26/2023,18,8602,2866,3852,2044,19,0,17383
9/26/2023,19,8603,2931,3966,2032,0,0,17532
9/26/2023,20,8589,2822,3453,2163,0,0,17027
9/26/2023,21,8581,2756,3451,2231,0,0,17019
9/26/2023,22,8587,2833,3181,2204,0,0,16805
9/26/2023,23,8634,2343,3080,1980,0,0,16037
9/26/2023,24,8623,1773,3012,1789,0,0,15197
9/27/2023,1,8605,1716,3050,1648,0,0,15019
9/27/2023,2,8616,1098,3084,1521,0,0,14319
9/27/2023,3,8611,1248,3232,1156,0,0,14247
9/27/2023,4,8632,1648,3036,1025,0,0,14341
9/27/2023,5,8639,1838,2723,824,0,0,14024
9/27/2023,6,8667,2256,2696,897,0,0,14516
9/27/2023,7,8672,2448,3239,1508,7,0,15874
9/27/2023,8,8669,2482,3414,1532,68,0,16165
9/27/2023,9,8669,2454,3575,1590,190,0,16478
9/27/2023,10,8673,2460,3290,1725,280,0,16428
9/27/2023,11,8663,2529,3261,1891,320,0,16664
9/27/2023,12,8684,2501,3251,1878,346,0,16660
9/27/2023,13,8691,2411,3739,1743,316,0,16900
9/27/2023,14,8646,2367,3733,1813,319,0,16878
9/27/2023,15,8700,2597,3597,1904,280,0,17078
9/27/2023,16,8689,2840,3716,1828,228,0,17301
9/27/2023,17,8673,2862,3693,1610,108,0,16946
9/27/2023,18,8679,2856,3594,1611,17,0,16757
9/27/2023,19,8685,2793,3837,1714,0,0,17029
9/27/2023,20,8681,2672,3558,2010,0,0,16921
9/27/2023,21,8679,2606,3309,2205,0,0,16799
9/27/2023,22,8686,2358,2920,2358,0,0,16322
9/27/2023,23,8685,2196,2824,1593,0,0,15298
9/27/2023,24,8688,1793,2713,1596,0,0,14790
9/28/2023,1,8695,1230,2747,1655,0,0,14327
9/28/2023,2,8702,1352,3050,1495,0,0,14599
9/28/2023,3,8719,1400,2601,1174,0,0,13894
9/28/2023,4,8730,1693,2661,1242,0,0,14326
9/28/2023,5,8734,1960,2763,1309,0,0,14766
9/28/2023,6,8734,2396,2982,1252,0,0,15364
9/28/2023,7,8737,2938,3378,1272,9,0,16334
9/28/2023,8,8743,2977,3454,1138,60,0,16372
9/28/2023,9,8743,2847,3759,888,124,0,16361
9/28/2023,10,8735,3156,3655,735,204,0,16485
9/28/2023,11,8754,3055,3627,674,249,0,16359
9/28/2023,12,8785,2932,3660,718,303,0,16398
9/28/2023,13,8790,2706,3859,702,292,0,16349
9/28/2023,14,8781,2713,4006,761,287,0,16548
9/28/2023,15,8775,2876,4051,716,281,1,16700
9/28/2023,16,8766,3149,4274,652,158,1,17000
9/28/2023,17,8762,3081,4072,618,64,0,16597
9/28/2023,18,8747,3251,4133,554,9,0,16694
9/28/2023,19,8739,3457,3901,622,0,0,16719
9/28/2023,20,8733,3477,3738,682,0,0,16630
9/28/2023,21,8733,3316,3636,629,0,0,16314
9/28/2023,22,8750,2999,3480,572,0,0,15801
9/28/2023,23,8750,2713,3142,462,0,0,15067
9/28/2023,24,8746,2450,2787,403,0,0,14386
9/29/2023,1,8745,1606,3265,529,0,0,14145
9/29/2023,2,8755,1695,3111,425,0,0,13986
9/29/2023,3,8779,2109,2853,316,0,0,14057
9/29/2023,4,8774,2668,2949,277,0,0,14668
9/29/2023,5,8778,3111,3529,256,0,0,15674
9/29/2023,6,8774,3435,3711,264,16,0,16200
9/29/2023,7,8777,3630,3813,225,33,0,16478
9/29/2023,8,8799,3772,3714,187,63,0,16535
9/29/2023,9,8833,3626,3764,128,152,0,16503
9/29/2023,10,8841,3922,3737,100,209,2,16811
9/29/2023,11,8849,3904,3736,114,260,0,16863
9/29/2023,12,8850,3808,3873,129,284,0,16944
9/29/2023,13,8867,3632,3894,156,327,0,16876
9/29/2023,14,8858,3370,3956,157,300,0,16641
9/29/2023,15,8865,3232,4096,159,286,0,16638
9/29/2023,16,8863,3259,4075,116,218,0,16531
9/29/2023,17,8880,3443,4226,149,98,0,16796
9/29/2023,18,8880,3393,4236,184,19,0,16712
9/29/2023,19,8880,3497,4376,233,0,0,16986
9/29/2023,20,8880,3284,4219,309,0,0,16692
9/29/2023,21,8876,3116,4004,428,0,0,16424
9/29/2023,22,8865,2804,3487,319,0,0,15475
9/29/2023,23,8869,2523,3429,213,0,10,15044
9/29/2023,24,8877,1929,3243,210,0,38,14297
9/30/2023,1,8879,1661,2789,209,0,51,13589
9/30/2023,2,8895,1160,2856,128,0,51,13090
9/30/2023,3,8891,986,2961,115,0,51,13004
9/30/2023,4,8901,1116,2818,121,0,51,13007
9/30/2023,5,8899,1508,2852,96,0,50,13405
9/30/2023,6,8903,1838,2974,118,0,49,13882
9/30/2023,7,8899,1965,3175,161,8,50,14258
9/30/2023,8,8895,1936,3454,150,80,50,14565
9/30/2023,9,8890,2193,3616,109,125,51,14984
9/30/2023,10,8884,2449,3763,74,200,94,15464
9/30/2023,11,8893,2697,3767,57,257,55,15726
9/30/2023,12,8891,3076,3660,42,281,53,16003
9/30/2023,13,8887,3350,3677,61,306,53,16334
9/30/2023,14,8873,3415,3787,101,345,53,16574
9/30/2023,15,8865,3565,3877,166,310,53,16836
9/30/2023,16,8865,3902,4009,178,223,53,17230
9/30/2023,17,8884,3987,4054,120,116,53,17214
9/30/2023,18,8896,3677,4271,108,23,53,17028
9/30/2023,19,8899,3572,4249,115,0,53,16888
9/30/2023,20,8903,3228,4108,119,0,50,16408
9/30/2023,21,8909,3457,3817,118,0,48,16349
9/30/2023,22,8921,2997,3405,88,0,49,15460
9/30/2023,23,8922,2508,3082,108,0,49,14669
9/30/2023,24,8933,2078,2715,118,0,52,13896
10/1/2023,1,8951,1412,2684,107,0,50,13204
10/1/2023,2,8943,932,2926,118,0,49,12968
10/1/2023,3,8940,818,2790,93,0,48,12689
10/1/2023,4,8940,1115,2579,101,0,48,12783
10/1/2023,5,8935,1234,2504,127,0,49,12849
10/1/2023,6,8935,1252,2594,177,0,51,13009
10/1/2023,7,8932,1576,2963,104,11,52,13638
10/1/2023,8,8933,1787,3164,79,93,52,14108
10/1/2023,9,8930,1973,3346,80,198,52,14579
10/1/2023,10,8927,2129,3138,73,279,52,14598
10/1/2023,11,8903,2512,3210,79,322,52,15078
10/1/2023,12,8903,3204,3485,92,324,52,16060
10/1/2023,13,8898,3804,3586,122,334,52,16796
10/1/2023,14,8890,4040,3684,92,345,61,17112
10/1/2023,15,8880,4300,3888,125,313,61,17567
10/1/2023,16,8891,4286,4038,181,210,54,17660
10/1/2023,17,8893,4389,4082,186,109,54,17713
10/1/2023,18,8895,4424,4150,221,20,54,17764
10/1/2023,19,8906,4298,4379,183,0,54,17820
10/1/2023,20,8904,4136,4129,203,0,52,17424
10/1/2023,21,8904,3972,3878,248,0,50,17052
10/1/2023,22,8912,3695,3520,228,0,54,16409
10/1/2023,23,8926,2879,3138,210,0,51,15204
10/1/2023,24,8927,2460,2770,202,0,79,14438
10/2/2023,1,8921,1667,2858,170,0,60,13676
10/2/2023,2,8913,1464,2868,182,0,59,13486
10/2/2023,3,8907,1703,2795,193,0,52,13650
10/2/2023,4,8902,2062,2553,223,0,50,13790
10/2/2023,5,8908,2631,2751,245,0,50,14585
10/2/2023,6,8913,3028,3174,305,0,51,15471
10/2/2023,7,8909,3870,3400,459,8,50,16696
10/2/2023,8,8912,3414,3527,543,82,52,16530
10/2/2023,9,8915,3666,3499,381,202,67,16730
10/2/2023,10,8916,4080,3444,233,323,72,17068
10/2/2023,11,8926,4259,3511,200,385,78,17359
10/2/2023,12,8916,4309,3458,221,404,74,17382
10/2/2023,13,8917,4388,3578,213,408,52,17556
10/2/2023,14,8887,4791,3551,327,384,61,18001
10/2/2023,15,8932,4620,3784,327,320,70,18053
10/2/2023,16,8910,4879,3894,324,236,69,18312
10/2/2023,17,8902,5085,4051,307,115,68,18528
10/2/2023,18,8908,5303,3855,374,18,60,18518
10/2/2023,19,8907,4713,3992,566,0,56,18234
10/2/2023,20,8904,4764,3848,728,0,63,18307
10/2/2023,21,8904,4573,3746,852,0,61,18136
10/2/2023,22,8895,3875,3729,884,0,67,17450
10/2/2023,23,8900,2973,3441,908,0,104,16326
10/2/2023,24,8901,2648,2815,875,0,89,15328
10/3/2023,1,8907,2217,2578,604,0,76,14382
10/3/2023,2,8901,1990,2568,643,0,73,14175
10/3/2023,3,8908,2030,2599,531,0,71,14139
10/3/2023,4,8909,2233,2518,409,0,71,14140
10/3/2023,5,8907,2781,2456,304,0,73,14521
10/3/2023,6,8911,3426,2948,366,0,76,15727
10/3/2023,7,8913,4208,3250,319,5,79,16774
10/3/2023,8,8910,4147,3550,281,92,85,17065
10/3/2023,9,8902,4226,3557,207,223,116,17231
10/3/2023,10,8902,4439,3484,101,324,137,17387
10/3/2023,11,8907,4880,3504,92,381,136,17900
10/3/2023,12,8904,5015,3866,155,407,133,18480
10/3/2023,13,8899,5050,3957,253,408,128,18695
10/3/2023,14,8890,4856,4347,303,390,118,18904
10/3/2023,15,8883,5250,4300,333,328,111,19205
10/3/2023,16,8885,5250,4352,402,230,105,19224
10/3/2023,17,8895,5499,4513,389,121,106,19523
10/3/2023,18,8899,5803,4235,353,20,100,19410
10/3/2023,19,8900,5325,4100,488,0,53,18866
10/3/2023,20,8896,4777,3932,640,0,53,18298
10/3/2023,21,8888,4535,3702,837,0,54,18016
10/3/2023,22,8888,3625,3541,1132,0,54,17240
10/3/2023,23,8890,3262,2828,1327,0,54,16361
10/3/2023,24,8897,2830,2596,1471,0,67,15861
10/4/2023,1,8894,1902,2635,1336,0,56,14823
10/4/2023,2,8895,1610,2661,1506,0,53,14725
10/4/2023,3,8897,1799,2560,1554,0,54,14864
10/4/2023,4,8897,2096,2529,1211,0,53,14786
10/4/2023,5,8895,2551,2507,972,0,53,14978
10/4/2023,6,8896,2798,2623,1415,0,54,15786
10/4/2023,7,8899,3279,3121,1559,4,54,16916
10/4/2023,8,8900,3467,3420,1312,83,54,17236
10/4/2023,9,8887,4277,3725,831,223,96,18039
10/4/2023,10,8888,4574,3691,687,325,105,18270
10/4/2023,11,8885,4092,3693,1127,386,106,18289
10/4/2023,12,8879,3867,3907,1261,392,104,18410
10/4/2023,13,8874,4210,4076,1232,383,106,18881
10/4/2023,14,8727,4656,4020,1106,372,104,18985
10/4/2023,15,8676,4396,4496,1011,302,103,18984
10/4/2023,16,8730,4245,4593,1104,204,104,18980
10/4/2023,17,8855,4751,4364,1041,88,100,19199
10/4/2023,18,8868,4306,4120,1143,12,104,18553
10/4/2023,19,8868,4155,4122,1580,0,154,18879
10/4/2023,20,8863,3734,4065,1994,0,182,18838
10/4/2023,21,8867,3171,3753,2647,0,181,18619
10/4/2023,22,8865,2467,3173,2946,0,154,17605
10/4/2023,23,8856,2152,2654,2819,0,65,16546
10/4/2023,24,8864,1249,2543,2965,0,54,15675
10/5/2023,1,8866,650,2776,3170,0,54,15516
10/5/2023,2,8866,662,2888,2895,0,54,15365
10/5/2023,3,8871,822,2864,2555,0,54,15166
10/5/2023,4,8872,1074,2674,2395,0,54,15069
10/5/2023,5,8873,1514,2494,2065,0,54,15000
10/5/2023,6,8866,2110,2816,1993,0,54,15839
10/5/2023,7,8865,2775,3220,2187,1,54,17102
10/5/2023,8,8857,2913,3404,2053,37,57,17321
10/5/2023,9,8856,3249,3434,1600,114,101,17354
10/5/2023,10,8853,3744,3564,1310,185,104,17760
10/5/2023,11,8853,3749,3662,1265,235,104,17868
10/5/2023,12,8860,4002,3869,1191,227,103,18252
10/5/2023,13,8864,3724,3825,1179,232,103,17927
10/5/2023,14,8859,3839,4075,906,226,103,18008
10/5/2023,15,8860,3918,4013,900,173,95,17959
10/5/2023,16,8873,3827,4072,1000,102,51,17925
10/5/2023,17,8874,3454,4010,1301,32,50,17721
10/5/2023,18,8876,3146,3903,1858,3,50,17836
10/5/2023,19,8871,3060,3959,2250,0,50,18190
10/5/2023,20,8863,2757,4048,2527,0,51,18246
10/5/2023,21,8843,2745,3472,2941,0,51,18052
10/5/2023,22,8819,2174,3151,2721,0,51,16916
10/5/2023,23,8821,1604,3143,2403,0,51,16022
10/5/2023,24,8842,1052,3167,1979,0,51,15091
10/6/2023,1,8859,1006,3019,1934,0,51,14869
10/6/2023,2,8864,632,2952,2085,0,51,14584
10/6/2023,3,8865,562,2896,1833,0,51,14207
10/6/2023,4,8876,746,2604,1969,0,51,14246
10/6/2023,5,8882,1214,2459,1562,0,51,14168
10/6/2023,6,8878,1781,3027,1445,0,51,15182
10/6/2023,7,8875,2775,3424,1519,0,51,16644
10/6/2023,8,8868,2582,3440,1582,30,50,16552
10/6/2023,9,8880,2952,3291,1798,124,51,17096
10/6/2023,10,8882,3346,3443,1618,210,50,17549
10/6/2023,11,8896,3100,3126,1892,269,51,17334
10/6/2023,12,8892,2363,3033,2212,286,51,16837
10/6/2023,13,8888,2257,3185,2125,292,51,16798
10/6/2023,14,8884,2311,3167,2446,264,50,17122
10/6/2023,15,8893,2410,3437,2556,241,51,17588
10/6/2023,16,8904,2424,3567,1982,224,51,17152
10/6/2023,17,8900,3139,3932,1598,91,54,17714
10/6/2023,18,8908,3575,3933,1211,14,95,17736
10/6/2023,19,8904,3113,3965,1172,0,80,17234
10/6/2023,20,8899,2763,3955,1321,0,54,16992
10/6/2023,21,8901,2254,3364,1712,0,54,16285
10/6/2023,22,8906,1909,3010,1552,0,54,15431
10/6/2023,23,8912,1665,3220,1172,0,54,15023
10/6/2023,24,8912,1327,3219,1017,0,37,14512
10/7/2023,1,8911,721,3007,1324,0,0,13963
10/7/2023,2,8923,662,2632,1596,0,0,13813
10/7/2023,3,8914,662,2600,1612,0,0,13788
10/7/2023,4,8926,782,2726,1708,0,0,14142
10/7/2023,5,8917,1038,2745,1776,0,0,14476
10/7/2023,6,8925,990,2957,1806,0,0,14678
10/7/2023,7,8930,923,3445,1645,2,0,14945
10/7/2023,8,8923,929,3586,1494,30,0,14962
10/7/2023,9,8911,974,3820,1740,84,0,15529
10/7/2023,10,8916,910,3377,2181,151,0,15535
10/7/2023,11,8915,906,3500,2488,128,0,15937
10/7/2023,12,8917,901,3564,2661,131,0,16174
10/7/2023,13,8914,890,3681,2661,133,16,16295
10/7/2023,14,8901,593,3101,2833,168,43,15639
10/7/2023,15,8913,589,3330,2807,158,52,15849
10/7/2023,16,8918,850,3403,2831,129,51,16182
10/7/2023,17,8920,1151,3577,2885,75,51,16659
10/7/2023,18,8925,1168,3807,2791,12,52,16755
10/7/2023,19,8933,1167,4115,2707,0,51,16973
10/7/2023,20,8954,1075,3912,2840,0,52,16833
10/7/2023,21,8959,821,3501,2927,0,52,16260
10/7/2023,22,8972,785,3084,3004,0,53,15898
10/7/2023,23,8984,374,2878,2810,0,52,15098
10/7/2023,24,8964,149,2699,2789,0,11,14612
10/8/2023,1,8984,149,2627,2620,0,0,14380
10/8/2023,2,9004,149,2512,2681,0,0,14346
10/8/2023,3,9013,149,2426,2470,0,0,14058
10/8/2023,4,9028,149,2501,2576,0,0,14254
10/8/2023,5,9034,149,2479,2765,0,0,14427
10/8/2023,6,9033,141,2609,2728,0,0,14511
10/8/2023,7,9045,141,2983,2733,2,0,14904
10/8/2023,8,9043,144,3093,3350,43,0,15673
10/8/2023,9,9046,144,3428,3668,119,12,16417
10/8/2023,10,9048,145,3092,3761,172,42,16260
10/8/2023,11,9053,145,3028,3759,215,52,16252
10/8/2023,12,9057,144,3263,3792,203,50,16509
10/8/2023,13,9056,140,3358,3645,175,51,16425
10/8/2023,14,9064,138,3500,4179,130,51,17062
10/8/2023,15,9070,138,3364,4061,111,15,16759
10/8/2023,16,9074,139,3418,3919,71,1,16622
10/8/2023,17,9074,139,3383,3845,27,1,16469
10/8/2023,18,9081,138,3548,3557,3,1,16328
10/8/2023,19,9085,136,3657,3596,0,0,16474
10/8/2023,20,9088,136,3607,3665,0,0,16496
10/8/2023,21,9084,136,3430,3723,0,0,16373
10/8/2023,22,9082,139,3144,3667,0,0,16032
10/8/2023,23,9086,156,3022,3559,0,1,15824
10/8/2023,24,9081,201,3064,3123,0,1,15470
10/9/2023,1,9079,236,2720,3061,0,1,15097
10/9/2023,2,9079,271,2564,2968,0,3,14885
10/9/2023,3,9087,287,2480,2939,0,2,14795
10/9/2023,4,9082,288,2462,2924,0,2,14758
10/9/2023,5,9085,285,2606,2921,0,3,14900
10/9/2023,6,9087,281,2865,3279,0,26,15538
10/9/2023,7,9090,269,3012,3661,0,31,16063
10/9/2023,8,9086,233,3299,3738,36,30,16422
10/9/2023,9,9087,235,3765,3546,90,16,16739
10/9/2023,10,9087,215,3376,3778,175,12,16643
10/9/2023,11,9083,214,3113,3761,221,19,16411
10/9/2023,12,9083,206,3406,3731,200,16,16642
10/9/2023,13,9078,262,3433,3948,217,2,16940
10/9/2023,14,9087,310,3498,3815,213,0,16923
10/9/2023,15,9083,515,3646,3594,177,0,17015
10/9/2023,16,9081,764,3787,3433,134,17,17216
10/9/2023,17,9080,765,4054,3264,76,49,17288
10/9/2023,18,9080,776,4171,2855,10,53,16945
10/9/2023,19,9087,986,4410,2705,0,51,17239
10/9/2023,20,9092,899,4087,2941,0,51,17070
10/9/2023,21,9079,773,3979,3027,0,51,16909
10/9/2023,22,9075,759,3851,2831,0,14,16530
10/9/2023,23,9073,339,3831,2555,0,0,15798
10/9/2023,24,9086,168,3686,2415,0,0,15355
10/10/2023,1,9087,157,3403,2407,0,0,15054
10/10/2023,2,9089,157,3125,2434,0,0,14805
10/10/2023,3,9090,289,3043,2244,0,0,14666
10/10/2023,4,9096,497,3246,2179,0,0,15018
10/10/2023,5,9093,774,3247,2054,0,0,15168
10/10/2023,6,9103,952,3972,1731,0,0,15758
10/10/2023,7,9102,1486,4670,1483,0,0,16741
10/10/2023,8,9098,1730,4187,1442,11,0,16468
10/10/2023,9,9094,1562,3997,1315,48,0,16016
10/10/2023,10,9095,1751,3806,1380,87,5,16124
10/10/2023,11,9099,1412,3574,1529,172,36,15822
10/10/2023,12,9097,1286,3312,1777,238,54,15764
10/10/2023,13,9112,1379,3353,1717,210,53,15824
10/10/2023,14,9107,1411,3629,1883,206,51,16287
10/10/2023,15,9104,1710,4046,1765,144,53,16822
10/10/2023,16,9100,1854,4128,1489,104,56,16731
10/10/2023,17,9108,2188,4145,1319,31,86,16877
10/10/2023,18,9112,2072,4288,1588,2,83,17145
10/10/2023,19,9115,1698,4276,1557,0,55,16701
10/10/2023,20,9119,1812,4174,1444,0,69,16618
10/10/2023,21,9113,1768,4137,1563,0,65,16646
10/10/2023,22,9123,1218,3835,1577,0,17,15770
10/10/2023,23,9127,1213,3419,1503,0,0,15262
10/10/2023,24,9132,727,3385,1345,0,0,14589
10/11/2023,1,9134,313,3564,1227,0,0,14238
10/11/2023,2,9134,539,3345,1103,0,0,14121
10/11/2023,3,9132,806,3069,1020,0,0,14027
10/11/2023,4,9132,859,3121,969,0,16,14097
10/11/2023,5,9133,923,3037,878,0,40,14011
10/11/2023,6,9136,1231,3652,811,0,68,14898
10/11/2023,7,9133,1965,4108,769,1,106,16082
10/11/2023,8,9134,2422,3978,608,26,97,16265
10/11/2023,9,9137,2561,4034,589,120,103,16544
10/11/2023,10,9133,2561,3721,618,169,96,16298
10/11/2023,11,9135,2497,3546,700,186,90,16154
10/11/2023,12,9135,2298,3515,812,232,77,16069
10/11/2023,13,9129,2228,3452,841,221,68,15939
10/11/2023,14,9129,2191,3378,905,138,80,15821
10/11/2023,15,9132,2159,3596,872,159,68,15986
10/11/2023,16,9137,2250,4196,675,112,53,16423
10/11/2023,17,9132,2314,4236,599,53,55,16389
10/11/2023,18,9132,2360,4294,501,6,56,16349
10/11/2023,19,9136,2397,4376,562,0,57,16528
10/11/2023,20,9133,2535,4217,502,0,78,16465
10/11/2023,21,9124,2254,4153,425,0,60,16016
10/11/2023,22,9128,2200,4062,346,0,72,15808
10/11/2023,23,9126,1475,3734,375,0,55,14765
10/11/2023,24,9127,850,3744,309,0,16,14046
10/12/2023,1,9132,485,3673,296,0,14,13600
10/12/2023,2,9136,670,3340,244,0,37,13427
10/12/2023,3,9142,981,3544,233,0,38,13938
10/12/2023,4,9136,1059,3416,281,0,38,13930
10/12/2023,5,9149,1470,3498,370,0,52,14539
10/12/2023,6,9149,2076,3705,414,0,79,15423
10/12/2023,7,9140,2415,3971,407,2,91,16026
10/12/2023,8,9140,2452,3966,279,55,88,15980
10/12/2023,9,9143,2258,3353,161,166,80,15161
10/12/2023,10,9141,2274,3500,130,249,85,15379
10/12/2023,11,9137,2364,3805,110,313,42,15771
10/12/2023,12,9137,2516,3673,131,352,33,15842
10/12/2023,13,9131,2385,3538,252,297,33,15636
10/12/2023,14,9130,2141,3570,361,288,33,15523
10/12/2023,15,9131,2150,3543,329,236,29,15418
10/12/2023,16,9128,2121,3914,259,84,41,15547
10/12/2023,17,9127,1908,3986,553,68,66,15708
10/12/2023,18,9134,1817,3950,902,8,71,15882
10/12/2023,19,9127,1816,3837,1273,0,68,16121
10/12/2023,20,9124,1812,3818,1518,0,59,16331
10/12/2023,21,9122,1696,3787,1542,0,55,16202
10/12/2023,22,9125,1266,3888,1267,0,25,15571
10/12/2023,23,9121,1033,3954,1055,0,10,15173
10/12/2023,24,9130,805,3910,888,0,12,14745
10/13/2023,1,9130,366,3708,894,0,6,14104
10/13/2023,2,9132,190,3478,750,0,0,13550
10/13/2023,3,9129,538,3786,647,0,0,14100
10/13/2023,4,9136,1001,3381,622,0,11,14151
10/13/2023,5,9131,1303,3164,545,0,42,14185
10/13/2023,6,9137,1690,3499,511,0,52,14889
10/13/2023,7,9139,1848,4045,725,5,59,15821
10/13/2023,8,9137,1747,4063,792,68,54,15861
10/13/2023,9,9135,1822,4065,436,204,54,15716
10/13/2023,10,9137,1846,3984,367,264,80,15678
10/13/2023,11,9133,1741,4191,340,271,87,15763
10/13/2023,12,9134,2092,4130,340,242,124,16062
10/13/2023,13,9132,1868,4187,402,184,106,15879
10/13/2023,14,9127,1414,4294,383,179,124,15521
10/13/2023,15,9126,1107,4031,583,131,116,15094
10/13/2023,16,9128,1187,4126,667,63,90,15261
10/13/2023,17,9136,1611,4121,709,23,93,15693
10/13/2023,18,9132,1591,4170,806,0,92,15791
10/13/2023,19,9127,1519,4212,1073,0,84,16015
10/13/2023,20,9127,1430,3777,1294,0,52,15680
10/13/2023,21,9125,1423,3439,1482,0,52,15521
10/13/2023,22,9127,1208,3341,1576,0,47,15299
10/13/2023,23,9127,771,3379,1761,0,44,15082
10/13/2023,24,9133,382,3754,1660,0,45,14974
10/14/2023,1,9139,333,3345,1908,0,8,14733
10/14/2023,2,9138,202,3081,2275,0,0,14696
10/14/2023,3,9140,137,3081,2463,0,0,14821
10/14/2023,4,9144,137,3248,2653,0,0,15182
10/14/2023,5,9141,253,3479,2665,0,0,15538
10/14/2023,6,9143,541,3605,2660,0,0,15949
10/14/2023,7,9151,604,3879,2698,1,0,16333
10/14/2023,8,9152,770,3749,2744,22,0,16437
10/14/2023,9,9149,949,4074,2610,58,0,16840
10/14/2023,10,9147,1026,4084,2655,141,0,17053
10/14/2023,11,9146,882,3893,2747,174,0,16842
10/14/2023,12,9138,880,3579,2936,146,0,16679
10/14/2023,13,9133,910,3771,2848,153,0,16815
10/14/2023,14,9132,1205,3880,2827,98,0,17142
10/14/2023,15,9120,1696,3863,2694,61,0,17434
10/14/2023,16,9100,1555,4001,2550,42,0,17248
10/14/2023,17,9096,1388,4051,2296,20,0,16851
10/14/2023,18,9088,1814,4264,1864,1,0,17031
10/14/2023,19,9083,1949,4076,1770,0,0,16878
10/14/2023,20,9075,1359,3883,2151,0,0,16468
10/14/2023,21,9079,1110,3584,2374,0,0,16147
10/14/2023,22,9083,874,3354,2455,0,0,15766
10/14/2023,23,9081,548,3518,2508,0,0,15655
10/14/2023,24,9089,381,3796,2142,0,0,15408
10/15/2023,1,9092,455,3830,2012,0,0,15389
10/15/2023,2,9086,178,3675,2001,0,0,14940
10/15/2023,3,9093,189,3778,1792,0,0,14852
10/15/2023,4,9100,218,3801,1570,0,0,14689
10/15/2023,5,9109,178,3475,1445,0,0,14207
10/15/2023,6,9108,159,3642,1604,0,0,14513
10/15/2023,7,9112,149,3696,1778,3,0,14738
10/15/2023,8,9104,146,3602,1621,48,0,14521
10/15/2023,9,9108,154,3976,2071,76,0,15385
10/15/2023,10,9103,262,3927,2339,125,0,15756
10/15/2023,11,9106,519,3944,2245,157,0,15971
10/15/2023,12,9109,521,3720,2570,178,0,16098
10/15/2023,13,9103,648,3725,2838,146,0,16460
10/15/2023,14,9104,800,3730,2869,152,2,16657
10/15/2023,15,9116,1062,3731,2744,123,0,16776
10/15/2023,16,9108,1114,3998,2598,68,0,16886
10/15/2023,17,9113,1826,4540,2446,25,0,17950
10/15/2023,18,9112,2010,4475,2348,1,0,17946
10/15/2023,19,9110,1998,4356,2125,0,0,17589
10/15/2023,20,9108,1974,4292,1942,0,0,17316
10/15/2023,21,9104,1034,4110,1906,0,0,16154
10/15/2023,22,9091,937,4129,1642,0,0,15799
10/15/2023,23,9072,679,3707,1516,0,0,14974
10/15/2023,24,9069,585,3549,1327,0,0,14530
10/16/2023,1,9074,327,3247,1298,0,0,13946
10/16/2023,2,9064,278,3130,1367,0,0,13839
10/16/2023,3,9059,309,3142,1447,0,0,13957
10/16/2023,4,9059,400,3270,1529,0,0,14258
10/16/2023,5,9049,692,3299,1561,0,0,14601
10/16/2023,6,9049,1098,3530,1451,0,0,15128
10/16/2023,7,9050,1474,4028,1547,0,0,16099
10/16/2023,8,9052,1519,3885,1519,19,0,15994
10/16/2023,9,9047,1904,3988,1441,48,0,16428
10/16/2023,10,9052,2112,4021,1470,118,0,16773
10/16/2023,11,9046,2325,4005,1449,146,0,16971
10/16/2023,12,9044,2363,4055,1453,145,0,17060
10/16/2023,13,9059,2344,3954,1539,111,0,17007
10/16/2023,14,9062,2001,3945,1658,96,0,16762
10/16/2023,15,9069,1951,3788,1828,90,0,16726
10/16/2023,16,9061,1991,4028,1924,80,0,17084
10/16/2023,17,9062,2090,4218,1860,32,0,17262
10/16/2023,18,9073,2256,4363,1672,0,0,17364
10/16/2023,19,9073,2733,4295,1548,0,0,17649
10/16/2023,20,9073,2544,4206,1527,0,0,17350
10/16/2023,21,9071,2294,4110,1318,0,0,16793
10/16/2023,22,9076,1643,3952,1032,0,0,15703
10/16/2023,23,9076,1370,3422,729,0,0,14597
10/16/2023,24,9075,1228,3631,486,0,0,14420
10/17/2023,1,9078,877,3861,367,0,0,14183
10/17/2023,2,9069,830,3827,317,0,0,14043
10/17/2023,3,9075,940,3747,284,0,0,14046
10/17/2023,4,9081,1083,3702,259,0,0,14125
10/17/2023,5,9082,1546,3569,256,0,0,14453
10/17/2023,6,9079,2173,4001,233,0,0,15486
10/17/2023,7,9075,2862,4271,230,0,0,16438
10/17/2023,8,9076,2900,4270,198,18,0,16462
10/17/2023,9,9072,2705,4315,129,77,0,16298
10/17/2023,10,9072,2615,4220,104,114,0,16125
10/17/2023,11,9062,2429,4134,147,135,0,15907
10/17/2023,12,9060,2259,4149,174,131,0,15773
10/17/2023,13,9058,2104,4193,331,116,0,15802
10/17/2023,14,9052,2407,4284,289,102,0,16134
10/17/2023,15,9050,2595,4341,201,70,0,16257
10/17/2023,16,9048,2536,4351,210,47,0,16192
10/17/2023,17,9032,2626,4357,203,22,0,16240
10/17/2023,18,9034,2716,4294,195,0,0,16239
10/17/2023,19,9032,2808,4533,177,0,0,16550
10/17/2023,20,9032,2791,4367,228,0,0,16418
10/17/2023,21,9025,2657,4284,269,0,0,16235
10/17/2023,22,9031,2372,3989,246,0,0,15638
10/17/2023,23,9034,1875,3690,233,0,0,14832
10/17/2023,24,9031,1284,3780,285,0,0,14380
10/18/2023,1,9031,870,3550,310,0,0,13761
10/18/2023,2,9029,916,3642,319,0,0,13906
10/18/2023,3,9031,1012,3570,298,0,0,13911
10/18/2023,4,9032,1203,3553,383,0,0,14171
10/18/2023,5,9029,1758,3123,476,0,0,14386
10/18/2023,6,9026,2338,3544,578,0,0,15486
10/18/2023,7,9026,2400,4110,895,0,0,16431
10/18/2023,8,9022,2363,3964,1027,12,0,16388
10/18/2023,9,9022,2374,4400,1042,52,1,16891
10/18/2023,10,9014,2114,4230,1106,97,10,16571
10/18/2023,11,9011,1682,3985,1432,107,11,16228
10/18/2023,12,9014,1425,3858,1550,140,1,15988
10/18/2023,13,9016,1471,3859,1919,107,0,16372
10/18/2023,14,9011,1764,3854,2098,126,0,16853
10/18/2023,15,9009,1921,4033,2037,130,0,17130
10/18/2023,16,9007,2758,4511,1633,93,0,18002
10/18/2023,17,8992,3005,4629,1320,30,0,17976
10/18/2023,18,8995,2868,4436,1280,1,0,17580
10/18/2023,19,8995,2689,4429,1585,0,0,17698
10/18/2023,20,8994,2496,4453,1644,0,0,17587
10/18/2023,21,8992,2375,3895,1927,0,0,17189
10/18/2023,22,8991,1457,3244,2048,0,0,15740
10/18/2023,23,8996,845,3148,2402,0,0,15391
10/18/2023,24,8993,264,3175,2554,0,0,14986
10/19/2023,1,8988,146,3143,2432,0,0,14709
10/19/2023,2,8990,145,3238,2251,0,0,14624
10/19/2023,3,8988,145,3134,2276,0,0,14543
10/19/2023,4,8991,259,3015,2378,0,0,14643
10/19/2023,5,8989,418,2990,2478,0,0,14875
10/19/2023,6,8989,630,3417,2616,0,0,15652
10/19/2023,7,8990,982,3993,2813,3,0,16781
10/19/2023,8,8991,956,3815,2700,46,0,16508
10/19/2023,9,8989,1097,3963,2295,119,0,16463
10/19/2023,10,8981,1344,3938,2231,193,0,16687
10/19/2023,11,8981,893,3493,2080,222,0,15669
10/19/2023,12,8982,994,3443,2134,182,0,15735
10/19/2023,13,8982,1115,3639,2408,144,0,16288
10/19/2023,14,8989,1384,3881,2364,113,0,16731
10/19/2023,15,8984,1854,4052,2281,81,0,17252
10/19/2023,16,8984,2077,4157,2242,49,0,17509
10/19/2023,17,8982,1915,4105,2238,13,0,17253
10/19/2023,18,8974,1844,4387,2637,0,0,17842
10/19/2023,19,8978,1772,3819,3247,0,0,17816
10/19/2023,20,8977,1772,3686,3348,0,0,17783
10/19/2023,21,8970,1042,3749,3236,0,0,16997
10/19/2023,22,8971,315,3649,3360,0,0,16295
10/19/2023,23,8970,140,3198,3078,0,0,15386
10/19/2023,24,8968,140,2957,2683,0,0,14748
10/20/2023,1,8967,141,3059,2608,0,0,14775
10/20/2023,2,8974,140,3004,2145,0,0,14263
10/20/2023,3,9002,142,2991,1959,0,0,14094
10/20/2023,4,9002,254,3107,1882,0,0,14245
10/20/2023,5,9001,639,3362,1643,0,0,14645
10/20/2023,6,9000,1237,3584,1527,0,0,15348
10/20/2023,7,8996,1902,4043,1483,0,0,16424
10/20/2023,8,8995,2322,4189,1347,4,0,16857
10/20/2023,9,8997,2739,4323,1128,30,0,17217
10/20/2023,10,8983,3074,4305,963,63,0,17388
10/20/2023,11,8989,3172,4196,908,71,0,17336
10/20/2023,12,8980,2884,3962,851,98,0,16775
10/20/2023,13,8978,2933,3963,813,57,0,16744
10/20/2023,14,8981,2950,4044,772,55,0,16802
10/20/2023,15,8980,2940,4157,611,62,0,16750
10/20/2023,16,8964,3071,4327,616,43,0,17021
10/20/2023,17,8960,2355,4521,678,32,0,16546
10/20/2023,18,8965,2226,4747,787,0,0,16725
10/20/2023,19,8970,2171,4693,1003,0,0,16837
10/20/2023,20,8972,2139,4473,1351,0,0,16935
10/20/2023,21,8976,1888,4334,1511,0,0,16709
10/20/2023,22,8977,1248,3635,1986,0,0,15846
10/20/2023,23,8978,303,3228,2260,0,0,14769
10/20/2023,24,8981,133,3205,2229,0,0,14548
10/21/2023,1,8983,134,2998,2140,0,0,14255
10/21/2023,2,8989,133,2996,1955,0,0,14073
10/21/2023,3,8987,133,2971,2002,0,0,14093
10/21/2023,4,8985,133,3058,1896,0,0,14072
10/21/2023,5,8975,234,2989,2170,0,0,14368
10/21/2023,6,8985,407,3285,2085,0,0,14762
10/21/2023,7,8982,547,3529,1964,0,0,15022
10/21/2023,8,8979,546,4052,1913,7,0,15497
10/21/2023,9,8956,675,4400,1731,36,0,15798
10/21/2023,10,8954,777,4368,1736,80,0,15915
10/21/2023,11,8954,569,4260,1736,110,0,15629
10/21/2023,12,8956,548,4068,1822,99,0,15493
10/21/2023,13,8952,548,3873,1793,177,0,15343
10/21/2023,14,8947,657,3954,1776,155,0,15489
10/21/2023,15,8953,824,4168,1784,107,0,15836
10/21/2023,16,8953,1348,4492,1592,61,0,16446
10/21/2023,17,8949,1653,4555,1629,20,0,16806
10/21/2023,18,8951,1483,4769,1648,0,0,16851
10/21/2023,19,8948,1393,4887,1650,0,0,16878
10/21/2023,20,8940,1015,4580,1756,0,0,16291
10/21/2023,21,8944,909,3556,1720,0,0,15129
10/21/2023,22,8950,577,3751,1835,0,0,15113
10/21/2023,23,8952,514,3351,1761,0,0,14578
10/21/2023,24,8953,400,3403,1766,0,0,14522
10/22/2023,1,8949,318,3175,1999,0,30,14471
10/22/2023,2,8952,319,2817,1680,0,30,13798
10/22/2023,3,8958,320,2792,1370,0,37,13477
10/22/2023,4,8952,319,2877,1575,0,38,13761
10/22/2023,5,8952,320,2857,1957,0,38,14124
10/22/2023,6,8956,319,2919,2175,0,38,14407
10/22/2023,7,8952,319,2959,2509,0,37,14776
10/22/2023,8,8958,319,3295,2491,44,30,15137
10/22/2023,9,8960,164,3549,2822,118,22,15635
10/22/2023,10,8957,133,3259,2947,146,34,15476
10/22/2023,11,8956,132,3299,2705,200,38,15330
10/22/2023,12,8950,132,3309,2773,237,39,15440
10/22/2023,13,8949,208,3627,2593,252,38,15667
10/22/2023,14,8955,513,3775,2396,268,38,15945
10/22/2023,15,8952,981,3726,2226,229,36,16150
10/22/2023,16,8943,1675,3790,1822,163,37,16430
10/22/2023,17,8940,1809,4241,2112,72,34,17208
10/22/2023,18,8939,2131,5097,1706,2,27,17902
10/22/2023,19,8942,2719,5015,1530,0,26,18232
10/22/2023,20,8945,2756,4916,1318,0,25,17960
10/22/2023,21,8945,2275,5029,1128,0,12,17389
10/22/2023,22,8952,1994,4789,839,0,20,16594
10/22/2023,23,9007,1599,4366,677,0,9,15658
10/22/2023,24,8242,1872,4217,483,0,1,14815
10/23/2023,1,8155,1933,4251,310,0,0,14649
10/23/2023,2,8157,1797,4196,246,0,0,14396
10/23/2023,3,8163,1798,4154,302,0,0,14417
10/23/2023,4,8163,2017,4213,293,0,0,14686
10/23/2023,5,8163,2200,4143,281,0,0,14787
10/23/2023,6,8153,2599,4432,237,0,0,15421
10/23/2023,7,8150,3531,4547,243,2,0,16473
10/23/2023,8,8148,3659,4424,246,83,0,16560
10/23/2023,9,8148,3152,4540,238,227,0,16305
10/23/2023,10,8150,3148,4414,198,336,14,16260
10/23/2023,11,8154,3058,4051,357,401,18,16039
10/23/2023,12,8147,2734,4108,459,368,15,15831
10/23/2023,13,8135,2745,4014,510,369,0,15773
10/23/2023,14,8133,2798,4000,472,354,0,15757
10/23/2023,15,8120,2886,4136,421,275,0,15838
10/23/2023,16,8124,3274,4190,378,168,0,16134
10/23/2023,17,8121,3237,4750,429,44,0,16581
10/23/2023,18,8129,3187,4996,557,1,0,16870
10/23/2023,19,8136,3394,4958,732,0,0,17220
10/23/2023,20,8139,3204,4916,1292,0,0,17551
10/23/2023,21,8145,2378,4826,1875,0,0,17224
10/23/2023,22,8148,1933,4745,1665,0,0,16491
10/23/2023,23,8159,1509,4393,1807,0,0,15868
10/23/2023,24,8166,1003,3982,1856,0,0,15007
10/24/2023,1,8171,804,3785,2131,0,0,14891
10/24/2023,2,8179,422,3654,2149,0,0,14404
10/24/2023,3,8184,392,3801,1957,0,0,14334
10/24/2023,4,8188,772,4004,1849,0,0,14813
10/24/2023,5,8189,908,3693,1781,0,6,14577
10/24/2023,6,8187,1290,4135,1878,0,4,15494
10/24/2023,7,8184,1744,4611,1978,0,0,16517
10/24/2023,8,8186,1499,4441,2149,17,0,16292
10/24/2023,9,8185,1462,4356,2183,117,0,16303
10/24/2023,10,8200,1621,4265,1992,200,0,16278
10/24/2023,11,8210,1604,4151,2059,163,0,16187
10/24/2023,12,8212,1775,4584,1789,175,0,16535
10/24/2023,13,8213,2068,4507,1499,234,0,16521
10/24/2023,14,8212,1941,4280,1636,233,0,16302
10/24/2023,15,8200,1482,3781,1794,222,0,15479
10/24/2023,16,8202,1420,3936,1861,144,0,15563
10/24/2023,17,8207,1411,4080,2690,56,0,16444
10/24/2023,18,8204,1409,4186,3165,2,0,16966
10/24/2023,19,8199,1347,3999,3329,0,0,16874
10/24/2023,20,8199,1166,4014,3549,0,0,16928
10/24/2023,21,8196,959,3994,3732,0,0,16881
10/24/2023,22,8198,269,4209,3698,0,0,16374
10/24/2023,23,8197,130,3899,3763,0,0,15989
10/24/2023,24,8197,130,3295,3503,0,0,15125
10/25/2023,1,8198,131,3094,3468,0,0,14891
10/25/2023,2,8197,130,3015,3329,0,2,14673
10/25/2023,3,8211,132,3062,3124,0,0,14529
10/25/2023,4,8208,247,3054,3026,0,0,14535
10/25/2023,5,8208,705,3240,2661,0,0,14814
10/25/2023,6,8208,1376,3520,2714,0,0,15818
10/25/2023,7,8202,1765,4582,2572,0,0,17121
10/25/2023,8,8204,2149,4632,2298,3,0,17286
10/25/2023,9,8199,2008,4278,2405,30,0,16920
10/25/2023,10,8189,2159,4294,2294,74,0,17010
10/25/2023,11,8184,1957,4156,2610,157,0,17064
10/25/2023,12,8190,1900,4463,2649,105,0,17307
10/25/2023,13,8194,2275,4563,2278,89,0,17399
10/25/2023,14,8194,2836,4393,2112,118,0,17653
10/25/2023,15,8205,2675,4296,2042,64,0,17282
10/25/2023,16,8219,2850,4590,1777,38,0,17474
10/25/2023,17,8222,3305,4839,1638,8,0,18012
10/25/2023,18,8227,3103,4853,1629,0,0,17812
10/25/2023,19,8235,3100,4842,1576,0,7,17760
10/25/2023,20,8232,3164,4775,1370,0,13,17554
10/25/2023,21,8241,2833,4750,1170,0,5,16999
10/25/2023,22,8255,2423,4624,1121,0,0,16423
10/25/2023,23,8258,1515,4403,1250,0,0,15426
10/25/2023,24,8255,994,3986,1244,0,0,14479
10/26/2023,1,8256,626,3866,1187,0,0,13935
10/26/2023,2,8250,518,4126,1050,0,2,13946
10/26/2023,3,8256,637,4141,896,0,0,13930
10/26/2023,4,8250,1003,3786,1135,0,0,14174
10/26/2023,5,8252,1487,3481,1054,0,0,14274
10/26/2023,6,8259,1945,4385,1042,0,0,15631
10/26/2023,7,8262,2409,4799,1137,0,0,16607
10/26/2023,8,8255,2641,4402,1252,0,0,16550
10/26/2023,9,8258,2447,4116,1482,16,0,16319
10/26/2023,10,8253,2455,4028,1666,55,0,16457
10/26/2023,11,8248,2219,3870,2040,90,0,16467
10/26/2023,12,8240,2061,3952,2206,99,0,16558
10/26/2023,13,8241,2181,4129,2397,119,0,17067
10/26/2023,14,8237,2225,4254,2626,92,0,17434
10/26/2023,15,8244,2447,4476,2617,70,0,17854
10/26/2023,16,8247,2776,4694,2919,38,0,18674
10/26/2023,17,8247,2665,4895,3210,10,0,19027
10/26/2023,18,8260,2317,4965,3449,0,0,18991
10/26/2023,19,8264,2309,4770,3614,0,0,18957
10/26/2023,20,8261,2317,4320,3736,0,0,18634
10/26/2023,21,8259,1718,3821,3746,0,0,17544
10/26/2023,22,8262,1219,3510,3799,0,0,16790
10/26/2023,23,8253,321,3272,3836,0,0,15682
10/26/2023,24,8247,136,3215,3363,0,0,14961
10/27/2023,1,8253,137,3139,3352,0,0,14881
10/27/2023,2,8251,136,3128,3045,0,0,14560
10/27/2023,3,8256,139,3172,2989,0,0,14556
10/27/2023,4,8262,288,3114,3014,0,0,14678
10/27/2023,5,8262,579,3056,3107,0,0,15004
10/27/2023,6,8256,1027,3587,2970,0,0,15840
10/27/2023,7,8255,1099,4016,3174,0,0,16544
10/27/2023,8,8252,1230,4231,3098,7,0,16818
10/27/2023,9,8253,1222,4415,3227,52,0,17169
10/27/2023,10,8254,1287,4134,3290,104,0,17069
10/27/2023,11,8250,1325,4123,3262,134,0,17094
10/27/2023,12,8247,1423,4270,3233,222,0,17395
10/27/2023,13,8249,1657,4030,3288,244,0,17468
10/27/2023,14,8248,1812,4099,3184,193,0,17536
10/27/2023,15,8250,1780,4364,3127,155,0,17676
10/27/2023,16,8253,1878,4533,3095,98,0,17857
10/27/2023,17,8253,1846,4872,2893,30,0,17894
10/27/2023,18,8253,1882,4901,2852,0,0,17888
10/27/2023,19,8251,1769,4692,3175,0,0,17887
10/27/2023,20,8250,1761,4170,3644,0,0,17825
10/27/2023,21,8249,1606,3568,3714,0,0,17137
10/27/2023,22,8254,731,3536,3851,0,0,16372
10/27/2023,23,8246,220,3288,3845,0,0,15599
10/27/2023,24,8242,138,3166,3456,0,0,15002
10/28/2023,1,8243,138,3229,2824,0,0,14434
10/28/2023,2,8249,138,3140,2577,0,0,14104
10/28/2023,3,8243,151,3082,2528,0,0,14004
10/28/2023,4,8244,157,3121,2738,0,0,14260
10/28/2023,5,8241,182,3219,2660,0,0,14302
10/28/2023,6,8239,272,3183,2532,0,0,14226
10/28/2023,7,8242,542,3347,2341,0,0,14472
10/28/2023,8,8250,548,3535,2373,6,0,14712
10/28/2023,9,8250,665,3388,2287,114,0,14704
10/28/2023,10,8258,800,3427,2200,264,0,14949
10/28/2023,11,8258,960,3735,2358,253,0,15564
10/28/2023,12,8266,963,3799,2433,250,0,15711
10/28/2023,13,8270,904,3823,2278,256,0,15531
10/28/2023,14,8274,1051,3851,1966,265,0,15407
10/28/2023,15,8280,1209,4035,1583,231,0,15338
10/28/2023,16,8288,1452,4437,1335,143,0,15655
10/28/2023,17,8290,1872,4799,1084,33,0,16078
10/28/2023,18,8298,1894,5001,914,0,0,16107
10/28/2023,19,8302,1810,4873,800,0,0,15785
10/28/2023,20,8300,1432,4817,789,0,0,15338
10/28/2023,21,8297,1365,4731,765,0,0,15158
10/28/2023,22,8303,1304,4394,909,0,0,14910
10/28/2023,23,8301,1166,3914,993,0,0,14374
10/28/2023,24,8303,1162,3660,1061,0,0,14186
10/29/2023,1,8297,326,4015,874,0,0,13512
10/29/2023,2,8290,168,3908,1077,0,0,13443
10/29/2023,3,8290,169,3702,1040,0,0,13201
10/29/2023,4,8285,176,3759,973,0,0,13193
10/29/2023,5,8287,265,3673,992,0,0,13217
10/29/2023,6,8292,731,3811,934,0,0,13768
10/29/2023,7,8292,1487,3598,893,0,0,14270
10/29/2023,8,8283,1863,3711,901,5,0,14763
10/29/2023,9,8282,2378,4016,778,20,0,15474
10/29/2023,10,8285,2451,3846,664,45,0,15291
10/29/2023,11,8279,2920,3910,538,74,0,15721
10/29/2023,12,8278,3044,4078,498,88,0,15986
10/29/2023,13,8279,2766,4148,386,99,0,15678
10/29/2023,14,8276,2699,4110,405,98,0,15588
10/29/2023,15,8280,2870,4193,445,69,0,15857
10/29/2023,16,8280,3030,4607,419,36,0,16372
10/29/2023,17,8277,3143,4934,483,8,0,16845
10/29/2023,18,8280,3217,4938,461,0,0,16896
10/29/2023,19,8276,3119,4865,527,0,0,16787
10/29/2023,20,8275,2644,4889,477,0,0,16285
10/29/2023,21,8269,2209,4558,591,0,0,15627
10/29/2023,22,8273,1708,3990,689,0,0,14660
10/29/2023,23,8273,1256,3669,819,0,0,14017
10/29/2023,24,8279,1155,3509,840,0,0,13783
10/30/2023,1,8279,1305,3667,708,0,0,13959
10/30/2023,2,8282,1350,3711,816,0,0,14159
10/30/2023,3,8283,1485,3565,903,0,0,14236
10/30/2023,4,8279,1818,3336,949,0,0,14382
10/30/2023,5,8282,2355,3025,787,0,0,14449
10/30/2023,6,8281,2718,3540,931,0,0,15470
10/30/2023,7,8285,3612,4242,808,0,0,16947
10/30/2023,8,8285,4519,4391,756,3,0,17954
10/30/2023,9,8281,4376,4322,852,25,0,17856
10/30/2023,10,8277,4638,4314,915,53,0,18197
10/30/2023,11,8274,4464,4213,1173,88,0,18212
10/30/2023,12,8270,3815,4231,1293,120,0,17729
10/30/2023,13,8272,3498,4315,1464,106,0,17655
10/30/2023,14,8271,2799,4183,1995,73,0,17321
10/30/2023,15,8269,2803,3932,2420,57,0,17481
10/30/2023,16,8271,3067,4271,2160,44,0,17813
10/30/2023,17,8269,3600,4876,2010,14,0,18769
10/30/2023,18,8269,3827,4976,1801,0,0,18873
10/30/2023,19,8271,3917,4965,1607,0,0,18760
10/30/2023,20,8277,3881,4835,1432,0,0,18425
10/30/2023,21,8275,3769,4735,1387,0,0,18166
10/30/2023,22,8276,2839,4323,1423,0,0,16861
10/30/2023,23,8281,2355,3948,1425,0,0,16009
10/30/2023,24,8275,1820,4158,1219,0,0,15472
10/31/2023,1,8277,1668,3874,1058,0,0,14877
10/31/2023,2,8283,1463,4311,839,0,0,14896
10/31/2023,3,8285,1609,4319,707,0,0,14920
10/31/2023,4,8287,1885,4241,682,0,0,15095
10/31/2023,5,8288,2473,3582,764,0,0,15107
10/31/2023,6,8285,3020,4301,749,0,0,16355
10/31/2023,7,8286,4137,4157,729,0,0,17309
10/31/2023,8,8284,3723,4296,772,27,0,17102
10/31/2023,9,8275,3895,4387,675,81,0,17313
10/31/2023,10,8277,3818,4241,733,153,0,17222
10/31/2023,11,8279,3213,4458,817,155,0,16922
10/31/2023,12,8279,2880,4135,1090,135,0,16519
10/31/2023,13,8279,2997,3934,1207,166,0,16583
10/31/2023,14,8279,3067,4076,1124,163,0,16709
10/31/2023,15,8280,3294,4440,981,83,0,17078
10/31/2023,16,8284,4019,4736,867,44,0,17950
10/31/2023,17,8287,3585,4946,872,6,0,17696
10/31/2023,18,8278,3521,4973,1055,0,0,17827
10/31/2023,19,8279,3707,5102,984,0,0,18072
10/31/2023,20,8278,3835,4863,978,0,0,17954
10/31/2023,21,8276,3175,4804,1215,0,0,17470
10/31/2023,22,8280,2939,3704,1616,0,0,16539
10/31/2023,23,8282,2034,3543,1499,0,0,15358
10/31/2023,24,8277,1485,3802,1490,0,0,15054
11/1/2023,1,8288,1248,4393,1491,0,0,15420
11/1/2023,2,8287,1127,3846,1667,0,0,14927
11/1/2023,3,8284,1226,3715,1721,0,0,14946
11/1/2023,4,8286,1681,3610,1713,0,0,15290
11/1/2023,5,8281,2402,3681,1621,0,0,15985
11/1/2023,6,8277,3015,4047,1701,0,0,17040
11/1/2023,7,8273,3916,4671,1849,0,0,18709
11/1/2023,8,8268,4008,4823,1720,9,0,18828
11/1/2023,9,8263,3876,4645,1422,62,1,18269
11/1/2023,10,8265,3459,4470,1267,146,2,17609
11/1/2023,11,8263,3204,3844,1278,226,3,16818
11/1/2023,12,8264,2791,4046,1298,246,1,16646
11/1/2023,13,8270,2647,4326,1250,237,3,16733
11/1/2023,14,8286,2778,4612,1174,201,1,17052
11/1/2023,15,8289,3077,4677,1091,140,0,17274
11/1/2023,16,8291,3466,4767,1002,65,0,17591
11/1/2023,17,8332,4323,5025,769,13,0,18462
11/1/2023,18,8489,4549,4822,638,0,1,18499
11/1/2023,19,8485,4601,4956,725,0,13,18780
11/1/2023,20,8481,3941,4860,956,0,19,18257
11/1/2023,21,8484,3592,4687,1231,0,17,18011
11/1/2023,22,8468,2888,3972,1549,0,10,16887
11/1/2023,23,8538,2345,3498,1642,0,9,16032
11/1/2023,24,8665,1316,3407,1979,0,9,15376
11/2/2023,1,8772,650,3686,2275,0,9,15392
11/2/2023,2,8940,583,3867,2396,0,9,15795
11/2/2023,3,8940,596,3993,2302,0,9,15840
11/2/2023,4,8943,881,4163,2258,0,14,16259
11/2/2023,5,8952,1352,3704,2391,0,17,16416
11/2/2023,6,8950,1759,3843,2410,0,20,16982
11/2/2023,7,8951,2161,4545,2269,0,24,17950
11/2/2023,8,8952,2258,4463,2126,12,24,17835
11/2/2023,9,8951,2115,4536,2143,68,24,17837
11/2/2023,10,8958,2251,4227,2478,136,24,18074
11/2/2023,11,8962,2224,4137,2956,173,24,18476
11/2/2023,12,8958,1310,3973,3127,174,24,17566
11/2/2023,13,8964,1013,3660,3291,220,24,17172
11/2/2023,14,9063,1283,3620,3230,161,24,17381
11/2/2023,15,8988,1562,3692,2959,133,24,17358
11/2/2023,16,9064,1623,3954,3506,57,24,18228
11/2/2023,17,9063,1758,4324,3226,13,24,18408
11/2/2023,18,9063,1764,4710,2984,0,24,18545
11/2/2023,19,9057,1806,4755,3141,0,24,18783
11/2/2023,20,9054,1755,4466,3394,0,24,18693
11/2/2023,21,9074,1571,4151,3652,0,22,18470
11/2/2023,22,9080,895,3507,3757,0,19,17258
11/2/2023,23,9086,354,3346,3614,0,17,16417
11/2/2023,24,9091,144,3102,3843,0,16,16196
11/3/2023,1,9088,144,3072,3676,0,16,15996
11/3/2023,2,9095,144,3003,3493,0,16,15751
11/3/2023,3,9107,145,3051,3333,0,16,15652
11/3/2023,4,9089,217,3074,3332,0,16,15728
11/3/2023,5,9083,501,2987,3643,0,16,16230
11/3/2023,6,9029,1076,3499,3881,0,16,17501
11/3/2023,7,9015,1242,4156,3906,0,20,18339
11/3/2023,8,9004,1235,4410,3877,27,24,18577
11/3/2023,9,9007,1232,4046,3893,147,24,18349
11/3/2023,10,9009,1232,3714,3652,239,24,17870
11/3/2023,11,9016,1079,3492,3297,301,24,17209
11/3/2023,12,9016,570,3302,3624,336,24,16872
11/3/2023,13,9010,161,3551,4126,290,24,17162
11/3/2023,14,9019,137,4263,4179,191,24,17813
11/3/2023,15,9034,180,4455,4188,102,24,17983
11/3/2023,16,9106,182,3858,4223,33,24,17426
11/3/2023,17,9102,180,3840,4225,7,24,17378
11/3/2023,18,9097,202,3996,4137,0,24,17456
11/3/2023,19,9098,181,3982,4237,0,24,17522
11/3/2023,20,9098,166,4015,4057,0,18,17354
11/3/2023,21,9098,163,4366,3704,0,17,17348
11/3/2023,22,9095,175,4477,3234,0,16,16997
11/3/2023,23,9087,176,4107,3054,0,1,16425
11/3/2023,24,9098,168,4307,2625,0,0,16198
11/4/2023,1,9102,148,4022,2116,0,0,15388
11/4/2023,2,9103,149,4359,1521,0,0,15132
11/4/2023,3,9103,311,4429,872,0,0,14715
11/4/2023,4,9106,610,4216,596,0,0,14528
11/4/2023,5,9105,942,4082,393,0,0,14522
11/4/2023,6,9104,1162,4302,268,0,0,14836
11/4/2023,7,9110,1701,4157,185,0,0,15153
11/4/2023,8,9112,2291,4131,150,0,0,15684
11/4/2023,9,9107,2899,4195,141,18,0,16360
11/4/2023,10,9099,2608,3910,119,45,0,15781
11/4/2023,11,9114,2763,3827,70,87,0,15861
11/4/2023,12,9108,2867,3801,69,113,0,15958
11/4/2023,13,9110,2674,3997,92,216,0,16089
11/4/2023,14,9104,3164,3918,100,181,0,16467
11/4/2023,15,9105,3462,3727,98,112,4,16508
11/4/2023,16,9095,3926,3953,104,57,0,17135
11/4/2023,17,9090,3754,3993,154,15,0,17006
11/4/2023,18,9095,3803,4107,147,0,0,17152
11/4/2023,19,9115,3561,4338,214,0,0,17228
11/4/2023,20,9123,3403,4537,204,0,0,17267
11/4/2023,21,9125,2860,4610,209,0,0,16804
11/4/2023,22,9125,2511,4565,199,0,0,16400
11/4/2023,23,9132,1939,4469,221,0,0,15761
11/4/2023,24,9133,1129,4479,200,0,0,14941
11/5/2023,1,9135,617,4371,146,0,0,14269
11/5/2023,2,9139,508,4391,193,0,0,14231
11/5/2023,3,9139,521,4352,271,0,0,14283
11/5/2023,4,9138,401,4240,420,0,0,14199
11/5/2023,5,9138,343,4229,493,0,0,14203
11/5/2023,6,9144,463,4395,406,0,0,14408
11/5/2023,7,9145,926,4630,349,0,0,15050
11/5/2023,8,9143,1272,4518,304,26,0,15263
11/5/2023,9,9134,1270,4173,206,150,0,14933
11/5/2023,10,9138,1338,4585,110,261,0,15432
11/5/2023,11,9134,1724,4496,61,293,0,15708
11/5/2023,12,9132,2025,4342,55,355,0,15909
11/5/2023,13,9131,2019,4390,47,335,0,15922
11/5/2023,14,9133,2146,4082,75,308,0,15744
11/5/2023,15,9135,2209,4042,105,208,0,15699
11/5/2023,16,9132,2486,4466,128,101,0,16313
11/5/2023,17,9131,3470,4472,154,18,0,17245
11/5/2023,18,9127,3838,4510,208,0,0,17683
11/5/2023,19,9133,3428,4579,341,0,0,17481
11/5/2023,20,9138,3729,4395,271,0,0,17533
11/5/2023,21,9139,3305,4338,307,0,0,17089
11/5/2023,22,9138,2729,4329,401,0,0,16597
11/5/2023,23,9137,1985,4077,611,0,0,15810
11/5/2023,24,9143,1584,3771,816,0,0,15314
11/6/2023,1,9141,896,3900,993,0,0,14930
11/6/2023,2,9143,706,3901,1181,0,0,14931
11/6/2023,3,9151,706,3694,1349,0,0,14900
11/6/2023,4,9149,440,3738,1539,0,0,14866
11/6/2023,5,9148,673,3363,1606,0,0,14790
11/6/2023,6,9150,905,3629,2153,0,0,15837
11/6/2023,7,9147,1017,3810,2656,0,0,16630
11/6/2023,8,9150,1009,4075,3225,4,0,17463
11/6/2023,9,9147,1010,4218,3410,41,0,17826
11/6/2023,10,9146,1013,4342,3703,66,0,18270
11/6/2023,11,9149,1015,4026,3942,86,0,18218
11/6/2023,12,9140,1022,4071,4098,82,0,18413
11/6/2023,13,9139,1217,3857,3934,176,0,18323
11/6/2023,14,9134,1504,3959,3722,84,0,18403
11/6/2023,15,9136,1423,3658,3859,55,0,18131
11/6/2023,16,9136,1354,3992,4142,21,0,18645
11/6/2023,17,9129,1209,4173,3857,2,0,18370
11/6/2023,18,9132,1180,4317,3992,0,0,18621
11/6/2023,19,9133,1165,4335,4187,0,0,18820
11/6/2023,20,9134,1149,4448,4115,0,0,18846
11/6/2023,21,9134,1430,4378,4059,0,0,19001
11/6/2023,22,9124,1211,3932,4007,0,0,18274
11/6/2023,23,9113,733,3657,4087,0,0,17590
11/6/2023,24,9114,212,3330,4133,0,0,16789
11/7/2023,1,9112,155,3186,4012,0,0,16465
11/7/2023,2,9109,165,3067,3794,0,0,16135
11/7/2023,3,9106,204,3072,3612,0,0,15994
11/7/2023,4,9107,247,3142,3483,0,0,15979
11/7/2023,5,9107,462,3145,3432,0,0,16146
11/7/2023,6,9107,1009,3406,3146,0,0,16668
11/7/2023,7,9121,1599,3726,3070,0,1,17517
11/7/2023,8,9126,1662,4412,3074,3,5,18282
11/7/2023,9,9126,1708,4357,2939,34,17,18181
11/7/2023,10,9133,1820,4231,3058,61,12,18315
11/7/2023,11,9132,1929,4261,2891,87,1,18301
11/7/2023,12,9127,2141,4305,2668,81,0,18322
11/7/2023,13,9127,2716,4393,2380,74,0,18690
11/7/2023,14,9130,3154,4414,2170,56,0,18924
11/7/2023,15,9129,3166,4544,2078,59,0,18976
11/7/2023,16,9127,3568,4423,1932,29,0,19079
11/7/2023,17,9127,3493,4455,1796,7,0,18878
11/7/2023,18,9122,3716,4224,1687,0,0,18749
11/7/2023,19,9126,3874,4235,1589,0,0,18824
11/7/2023,20,9129,3825,4250,1515,0,0,18719
11/7/2023,21,9124,4164,4186,1570,0,0,19044
11/7/2023,22,9122,3850,4129,1433,0,0,18534
11/7/2023,23,9129,3230,3943,1193,0,0,17495
11/7/2023,24,9133,2634,3996,1076,0,0,16839
11/8/2023,1,9136,1770,3928,1130,0,0,15964
11/8/2023,2,9142,1603,3887,1127,0,0,15759
11/8/2023,3,9141,1748,3689,1028,0,0,15606
11/8/2023,4,9148,1866,3686,1054,0,0,15754
11/8/2023,5,9150,2071,3801,1040,0,0,16062
11/8/2023,6,9151,2520,3821,1032,0,0,16524
11/8/2023,7,9156,3584,4018,1030,0,0,17788
11/8/2023,8,9154,4066,3955,1241,22,0,18438
11/8/2023,9,9151,3323,3896,1968,93,0,18431
11/8/2023,10,9150,2677,4011,2290,154,0,18282
11/8/2023,11,9146,3286,4101,2191,159,0,18883
11/8/2023,12,9143,3919,3849,1997,87,0,18995
11/8/2023,13,9147,4091,3703,1853,70,0,18864
11/8/2023,14,9146,3420,3838,2235,50,0,18689
11/8/2023,15,9143,3271,3832,2454,29,0,18729
11/8/2023,16,9148,3317,3853,2729,11,0,19058
11/8/2023,17,9147,3779,4078,2531,0,0,19535
11/8/2023,18,9150,4276,4150,2513,0,0,20089
11/8/2023,19,9151,3803,4187,2543,0,6,19690
11/8/2023,20,9151,3309,4092,2896,0,9,19457
11/8/2023,21,9153,3278,4010,2969,0,9,19419
11/8/2023,22,9144,2839,3803,3036,0,1,18823
11/8/2023,23,9146,2159,3601,2673,0,5,17584
11/8/2023,24,9138,1449,4307,1966,0,7,16867
11/9/2023,1,9133,1393,3919,1464,0,2,15911
11/9/2023,2,9131,1229,3960,1009,0,0,15329
11/9/2023,3,9133,1261,4127,777,0,0,15298
11/9/2023,4,9133,980,3408,1110,0,0,14631
11/9/2023,5,9134,1292,3271,1094,0,0,14791
11/9/2023,6,9133,1929,3299,1623,0,0,15984
11/9/2023,7,9128,2337,3564,1445,0,0,16474
11/9/2023,8,9143,2422,3793,2211,0,4,17573
11/9/2023,9,9147,2369,3759,2261,7,7,17550
11/9/2023,10,9146,2966,3990,1950,22,0,18074
11/9/2023,11,9148,3366,3785,1979,58,0,18336
11/9/2023,12,9147,2649,3625,2599,83,1,18104
11/9/2023,13,9146,2408,3436,3092,109,0,18191
11/9/2023,14,9146,2406,3439,3004,111,0,18106
11/9/2023,15,9149,2452,3434,3025,152,0,18212
11/9/2023,16,9141,2567,3552,3281,94,0,18635
11/9/2023,17,9143,2982,3861,3555,26,0,19567
11/9/2023,18,9139,3183,4181,3885,0,0,20388
11/9/2023,19,9137,3078,4031,4194,0,0,20440
11/9/2023,20,9135,2940,4009,4305,0,0,20389
11/9/2023,21,9135,2581,3788,4215,0,0,19719
11/9/2023,22,9131,2057,4000,3958,0,0,19146
11/9/2023,23,9132,1431,3866,3633,0,0,18062
11/9/2023,24,9136,970,3800,3355,0,0,17261
11/10/2023,1,9135,861,3975,3079,0,0,17050
11/10/2023,2,9130,848,3482,2914,0,0,16374
11/10/2023,3,9134,860,3522,2557,0,0,16073
11/10/2023,4,9140,1051,3715,2216,0,0,16122
11/10/2023,5,9141,1604,3815,2124,0,0,16684
11/10/2023,6,9145,1986,3873,2051,0,0,17055
11/10/2023,7,9148,2568,3972,1985,0,0,17673
11/10/2023,8,9151,3114,4313,1781,8,1,18368
11/10/2023,9,9152,3659,4169,1636,66,0,18682
11/10/2023,10,9148,3800,4057,1400,141,0,18546
11/10/2023,11,9148,3819,4147,1276,230,0,18620
11/10/2023,12,9151,3303,4193,1277,179,0,18103
11/10/2023,13,9146,3524,4222,1301,139,0,18332
11/10/2023,14,9149,3657,4193,1524,141,0,18664
11/10/2023,15,9156,4220,4146,1572,67,0,19161
11/10/2023,16,9152,4777,4277,1321,39,0,19566
11/10/2023,17,9148,5284,4456,1158,6,0,20052
11/10/2023,18,9141,5445,4519,1057,0,0,20162
11/10/2023,19,9144,5142,4324,1066,0,0,19676
11/10/2023,20,9148,4578,4246,1266,0,0,19238
11/10/2023,21,9151,4641,4241,1274,0,0,19307
11/10/2023,22,9148,4292,4210,1185,0,0,18835
11/10/2023,23,9152,4199,4022,861,0,0,18234
11/10/2023,24,9150,3629,3933,759,0,0,17471
11/11/2023,1,9148,3225,3987,743,0,0,17103
11/11/2023,2,9150,2680,3984,649,0,0,16463
11/11/2023,3,9151,2651,4023,652,0,0,16477
11/11/2023,4,9149,1981,4048,698,0,0,15876
11/11/2023,5,9151,2267,4098,651,0,0,16167
11/11/2023,6,9152,2815,4117,698,0,0,16782
11/11/2023,7,9155,3344,4117,523,0,0,17139
11/11/2023,8,9157,4234,4183,387,16,0,17977
11/11/2023,9,9158,4144,4311,259,87,0,17959
11/11/2023,10,9159,4357,4339,198,137,0,18190
11/11/2023,11,9155,4356,4224,140,176,0,18051
11/11/2023,12,9146,4325,4147,129,158,0,17905
11/11/2023,13,9149,4697,4036,226,140,0,18248
11/11/2023,14,9152,4514,4097,211,107,0,18081
11/11/2023,15,9151,4455,4161,189,65,0,18021
11/11/2023,16,9152,4399,4254,179,30,0,18014
11/11/2023,17,9156,4673,4217,164,6,0,18216
11/11/2023,18,9145,4888,4301,149,0,0,18483
11/11/2023,19,9143,4645,4421,220,0,0,18429
11/11/2023,20,9143,4904,4370,253,0,0,18670
11/11/2023,21,9145,4671,4342,249,0,0,18407
11/11/2023,22,9142,4838,4211,247,0,0,18438
11/11/2023,23,9138,4067,4180,263,0,0,17648
11/11/2023,24,9140,3487,4154,289,0,0,17070
11/12/2023,1,9136,2781,4235,348,0,0,16500
11/12/2023,2,9135,2586,4168,383,0,0,16272
11/12/2023,3,9138,2348,4190,375,0,0,16051
11/12/2023,4,9136,2341,4118,387,0,0,15982
11/12/2023,5,9165,2553,4146,410,0,0,16274
11/12/2023,6,9167,2809,4156,492,0,0,16624
11/12/2023,7,9171,2943,4168,595,0,0,16877
11/12/2023,8,9171,3347,4292,607,14,0,17431
11/12/2023,9,9174,3381,4269,708,112,0,17644
11/12/2023,10,9172,3205,4278,651,191,0,17497
11/12/2023,11,9167,3021,4219,437,294,0,17138
11/12/2023,12,9166,2744,4125,408,360,0,16803
11/12/2023,13,9167,2921,4048,446,303,0,16885
11/12/2023,14,9166,3019,4140,479,307,0,17111
11/12/2023,15,9166,3112,4110,462,253,0,17103
11/12/2023,16,9164,3866,4284,521,132,0,17967
11/12/2023,17,9152,4538,4376,729,24,0,18819
11/12/2023,18,9149,4667,4458,885,0,0,19159
11/12/2023,19,9144,4735,4221,1209,0,0,19309
11/12/2023,20,9138,4355,4204,1542,0,0,19239
11/12/2023,21,9134,4247,4092,1828,0,0,19301
11/12/2023,22,9126,4037,4078,2059,0,0,19300
11/12/2023,23,9133,3135,4027,2007,0,0,18302
11/12/2023,24,9133,2071,4013,2169,0,0,17386
11/13/2023,1,9129,1520,3840,2039,0,0,16528
11/13/2023,2,9139,1162,3855,2212,0,0,16368
11/13/2023,3,9135,769,3889,2451,0,0,16244
11/13/2023,4,9131,834,3897,2693,0,0,16555
11/13/2023,5,9129,1410,3486,2916,0,0,16941
11/13/2023,6,9129,2097,3404,2825,0,0,17455
11/13/2023,7,9133,2847,3504,3123,0,0,18607
11/13/2023,8,9132,3391,4056,3191,8,0,19778
11/13/2023,9,9132,4187,4087,2749,73,0,20228
11/13/2023,10,9129,4357,3938,2522,156,0,20102
11/13/2023,11,9126,3572,3998,2506,267,0,19469
11/13/2023,12,9127,3068,4028,2307,290,0,18820
11/13/2023,13,9125,3132,3847,2572,265,0,18941
11/13/2023,14,9120,2848,3757,3029,222,0,18976
11/13/2023,15,9122,2776,3485,3285,169,0,18837
11/13/2023,16,9115,2752,3669,3436,96,0,19068
11/13/2023,17,9105,3123,4205,3263,18,0,19714
11/13/2023,18,9093,3881,4491,3092,0,0,20557
11/13/2023,19,9097,4606,4496,2905,0,0,21104
11/13/2023,20,9105,4474,4187,3263,0,0,21029
11/13/2023,21,9099,3378,4182,3113,0,0,19772
11/13/2023,22,9092,3358,4246,2724,0,0,19420
11/13/2023,23,9096,2395,3992,2695,0,0,18178
11/13/2023,24,9094,1825,4112,2480,0,0,17511
11/14/2023,1,9099,1137,3953,2420,0,0,16609
11/14/2023,2,9094,1185,4039,2105,0,0,16423
11/14/2023,3,9102,1337,3875,2022,0,0,16336
11/14/2023,4,9107,1564,3794,1854,0,0,16319
11/14/2023,5,9105,1837,3905,1585,0,0,16432
11/14/2023,6,9101,2518,4094,1349,0,1,17063
11/14/2023,7,9102,3642,4254,1005,0,11,18014
11/14/2023,8,9103,5127,4428,688,3,17,19366
11/14/2023,9,9101,5482,4010,497,39,27,19156
11/14/2023,10,9094,5360,4013,253,93,15,18828
11/14/2023,11,9096,5024,3948,157,137,22,18384
11/14/2023,12,9100,4493,3806,193,147,27,17766
11/14/2023,13,9097,4242,3775,253,223,25,17615
11/14/2023,14,9101,4058,3892,357,219,23,17650
11/14/2023,15,9097,4193,3808,476,183,23,17780
11/14/2023,16,9098,3932,3909,526,111,24,17600
11/14/2023,17,9092,4117,4031,643,21,24,17928
11/14/2023,18,9093,5080,4300,828,0,16,19317
11/14/2023,19,9090,4747,4181,1149,0,4,19171
11/14/2023,20,9092,4557,4247,1533,0,0,19429
11/14/2023,21,9085,4656,4047,1850,0,0,19638
11/14/2023,22,9083,4218,3878,2071,0,0,19250
11/14/2023,23,9080,2665,3780,2227,0,0,17752
11/14/2023,24,9085,2008,3769,2355,0,0,17217
11/15/2023,1,9085,1351,3791,2557,0,0,16784
11/15/2023,2,9088,933,3338,2817,0,0,16176
11/15/2023,3,9090,766,3277,2913,0,0,16046
11/15/2023,4,9088,894,3412,2753,0,0,16147
11/15/2023,5,9091,1190,3405,2810,0,0,16496
11/15/2023,6,9094,1611,3362,2941,0,0,17008
11/15/2023,7,9091,2126,3680,3047,0,0,17944
11/15/2023,8,9093,2444,3913,3246,5,0,18701
11/15/2023,9,9086,2176,3833,3423,66,2,18586
11/15/2023,10,9081,2070,3583,3318,133,0,18185
11/15/2023,11,9080,2019,3219,2832,293,14,17457
11/15/2023,12,9083,2191,3358,2576,361,8,17577
11/15/2023,13,9081,1809,3475,2414,337,0,17116
11/15/2023,14,9082,1751,3881,2314,288,0,17316
11/15/2023,15,9080,2334,3546,1994,246,0,17200
11/15/2023,16,9079,2895,3592,2072,134,0,17772
11/15/2023,17,9079,3378,3848,2609,21,0,18935
11/15/2023,18,9078,3313,4111,2999,0,0,19501
11/15/2023,19,9082,3286,4061,3079,0,0,19508
11/15/2023,20,9077,3462,4409,2812,0,0,19760
11/15/2023,21,9076,3461,4230,2547,0,0,19314
11/15/2023,22,9075,2874,3777,2490,0,0,18216
11/15/2023,23,9088,2046,3776,2176,0,0,17086
11/15/2023,24,9080,1372,3785,1752,0,0,15989
11/16/2023,1,9077,1493,3857,1296,0,0,15723
11/16/2023,2,9079,1870,3895,933,0,0,15777
11/16/2023,3,9081,2089,3661,639,0,0,15470
11/16/2023,4,9080,2255,3630,527,0,0,15492
11/16/2023,5,9083,2340,3725,516,0,0,15664
11/16/2023,6,9087,3318,3850,426,0,0,16681
11/16/2023,7,9084,3836,4114,443,0,0,17477
11/16/2023,8,9081,4289,4029,591,19,0,18009
11/16/2023,9,9078,3815,3935,828,124,0,17780
11/16/2023,10,9074,3291,3792,962,242,0,17361
11/16/2023,11,9071,3000,3766,1015,283,1,17136
11/16/2023,12,9068,2549,3887,1203,283,2,16992
11/16/2023,13,9064,2293,3616,1379,280,33,16665
11/16/2023,14,9062,2115,3961,1620,268,40,17066
11/16/2023,15,9077,2459,3779,1816,214,35,17380
11/16/2023,16,9078,2968,3958,1935,99,27,18065
11/16/2023,17,9057,3300,3938,2493,9,26,18823
11/16/2023,18,9055,3478,4020,3023,0,26,19602
11/16/2023,19,9054,3322,3896,3517,0,22,19811
11/16/2023,20,9057,2965,3742,3965,0,10,19739
11/16/2023,21,9055,2722,3513,4040,0,10,19340
11/16/2023,22,9053,1760,3456,4061,0,15,18345
11/16/2023,23,9050,613,3356,4276,0,3,17298
11/16/2023,24,9052,411,3238,3890,0,0,16591
11/17/2023,1,9052,411,3339,3565,0,0,16367
11/17/2023,2,9057,411,3367,2802,0,0,15637
11/17/2023,3,9054,411,3358,2606,0,0,15429
11/17/2023,4,9053,493,3350,2351,0,0,15247
11/17/2023,5,9053,844,3200,1902,0,0,14999
11/17/2023,6,9055,1420,3097,1823,0,0,15395
11/17/2023,7,9062,1860,3170,2864,0,0,16956
11/17/2023,8,9050,1857,3263,3742,0,0,17912
11/17/2023,9,9051,1864,3383,3790,7,0,18095
11/17/2023,10,9047,1899,3658,3993,14,0,18611
11/17/2023,11,9037,2179,3861,3619,21,0,18717
11/17/2023,12,9032,2448,3930,3454,28,5,18897
11/17/2023,13,9044,2492,3546,3659,29,14,18784
11/17/2023,14,9047,1971,3565,3440,25,17,18065
11/17/2023,15,9050,2138,3549,3301,16,16,18070
11/17/2023,16,9046,2047,3955,3269,12,18,18347
11/17/2023,17,9051,2760,4260,2722,1,19,18813
11/17/2023,18,9060,4136,4327,2268,0,19,19810
11/17/2023,19,9065,4179,4356,1638,0,18,19256
11/17/2023,20,9060,4255,4195,1502,0,1,19013
11/17/2023,21,9061,3985,3971,1253,0,0,18270
11/17/2023,22,9060,4196,3898,1087,0,0,18241
11/17/2023,23,9061,3573,3825,1212,0,0,17671
11/17/2023,24,9055,2736,3664,1271,0,0,16726
11/18/2023,1,9054,2098,3790,1031,0,0,15973
11/18/2023,2,9054,1799,3742,914,0,0,15509
11/18/2023,3,9055,1838,3818,866,0,0,15577
11/18/2023,4,9050,2036,3771,822,0,0,15679
11/18/2023,5,9055,2202,3761,694,0,0,15712
11/18/2023,6,9053,2564,4045,488,0,0,16150
11/18/2023,7,9062,2738,3902,406,0,0,16108
11/18/2023,8,9061,2814,4160,395,18,0,16448
11/18/2023,9,9059,2594,4229,570,133,0,16585
11/18/2023,10,9059,2278,4140,706,261,0,16444
11/18/2023,11,9063,1767,3854,1159,324,0,16167
11/18/2023,12,9062,1643,3633,1886,358,0,16582
11/18/2023,13,9059,1276,3442,2054,328,0,16159
11/18/2023,14,9059,1155,3418,2283,312,0,16227
11/18/2023,15,9045,1506,3398,2274,228,0,16451
11/18/2023,16,9051,2212,3564,2282,104,0,17213
11/18/2023,17,9050,2804,3891,2596,15,0,18356
11/18/2023,18,9078,2797,4126,2911,0,0,18912
11/18/2023,19,9109,2819,4243,3153,0,0,19324
11/18/2023,20,9111,2820,4281,3154,0,0,19366
11/18/2023,21,9099,2553,3933,3299,0,0,18884
11/18/2023,22,8738,2437,3631,3610,0,0,18416
11/18/2023,23,8260,2001,3705,3461,0,0,17427
11/18/2023,24,8273,1508,3740,3168,0,0,16689
11/19/2023,1,8271,1071,3679,2729,0,0,15750
11/19/2023,2,8275,929,3853,2323,0,0,15380
11/19/2023,3,8275,939,3800,2069,0,0,15083
11/19/2023,4,8276,691,3617,1958,0,0,14542
11/19/2023,5,8277,800,3815,1860,0,0,14752
11/19/2023,6,8281,1339,4158,1653,0,0,15431
11/19/2023,7,8281,1986,3746,1863,0,0,15876
11/19/2023,8,8278,1566,3827,2383,11,4,16069
11/19/2023,9,8291,1606,3605,2415,112,1,16030
11/19/2023,10,8291,1867,3996,1998,157,1,16310
11/19/2023,11,8292,2061,3949,1903,180,3,16388
11/19/2023,12,8293,1810,3925,1987,185,0,16200
11/19/2023,13,8291,1668,3973,1837,264,1,16034
11/19/2023,14,8296,1824,4030,1648,253,0,16051
11/19/2023,15,8294,2323,4068,1388,163,0,16236
11/19/2023,16,8319,3098,4287,1135,128,0,16967
11/19/2023,17,8327,4043,4546,1017,17,0,17950
11/19/2023,18,8345,4633,4590,988,0,0,18556
11/19/2023,19,8347,4857,4447,1007,0,0,18658
11/19/2023,20,8347,4716,4404,1154,0,0,18621
11/19/2023,21,8342,4492,4402,1033,0,0,18269
11/19/2023,22,8342,4492,4101,995,0,0,17930
11/19/2023,23,8344,4047,3806,895,0,0,17092
11/19/2023,24,8341,3699,3630,871,0,0,16541
11/20/2023,1,8326,2579,3636,1111,0,0,15652
11/20/2023,2,8328,2226,3581,1174,0,0,15309
11/20/2023,3,8345,2438,3566,994,0,0,15343
11/20/2023,4,8356,2809,3555,1013,0,0,15733
11/20/2023,5,8356,2872,3534,1211,0,0,15973
11/20/2023,6,8354,3452,3885,1238,0,0,16929
11/20/2023,7,8346,4117,4132,1370,0,0,17965
11/20/2023,8,8348,4559,4098,1552,10,0,18567
11/20/2023,9,8352,4197,4085,1477,83,0,18194
11/20/2023,10,8349,4287,3945,1196,173,0,17950
11/20/2023,11,8356,4530,3973,1200,221,0,18280
11/20/2023,12,8352,4397,3912,1220,232,0,18113
11/20/2023,13,8349,4460,3848,1337,230,0,18224
11/20/2023,14,8338,4336,3935,1465,188,0,18262
11/20/2023,15,8341,4108,3963,1666,133,0,18211
11/20/2023,16,8344,3769,4188,1908,53,0,18262
11/20/2023,17,8338,3843,4482,1932,7,0,18602
11/20/2023,18,8343,4714,4491,1880,0,0,19428
11/20/2023,19,8344,4504,4392,2178,0,0,19418
11/20/2023,20,8345,4549,4358,2525,0,0,19777
11/20/2023,21,8344,4081,4424,2783,0,0,19632
11/20/2023,22,8352,3944,4145,2965,0,0,19406
11/20/2023,23,8355,3001,3901,3119,0,0,18376
11/20/2023,24,8342,2143,3829,3258,0,0,17572
11/21/2023,1,8322,1606,3548,3480,0,0,16956
11/21/2023,2,8316,1242,3441,3540,0,0,16539
11/21/2023,3,8316,1269,3311,3323,0,0,16219
11/21/2023,4,8312,1510,3275,3143,0,0,16240
11/21/2023,5,8315,1876,3382,2831,0,0,16404
11/21/2023,6,8307,2501,3578,3278,0,0,17664
11/21/2023,7,8309,3344,4168,3141,0,0,18962
11/21/2023,8,8313,3477,3942,3225,1,0,18958
11/21/2023,9,8314,3866,3911,3467,8,3,19569
11/21/2023,10,8304,3423,3854,3485,17,7,19090
11/21/2023,11,8305,3968,4052,3263,26,11,19625
11/21/2023,12,8306,3956,3849,3171,25,6,19313
11/21/2023,13,8307,4659,3996,2997,20,3,19982
11/21/2023,14,8314,5069,4022,2889,16,2,20312
11/21/2023,15,8310,4401,3888,2879,11,3,19492
11/21/2023,16,8311,4470,4093,2857,4,9,19744
11/21/2023,17,8298,4545,4259,2900,0,8,20010
11/21/2023,18,8296,4717,4509,2741,0,9,20272
11/21/2023,19,8296,4633,4317,2584,0,3,19833
11/21/2023,20,8302,4944,4259,2350,0,0,19855
11/21/2023,21,8307,4755,4231,2048,0,0,19341
11/21/2023,22,8306,4711,4053,1612,0,0,18682
11/21/2023,23,8314,4304,3865,1499,0,0,17982
11/21/2023,24,8309,3286,3807,1221,0,0,16623
11/22/2023,1,8313,2831,3683,1185,0,0,16012
11/22/2023,2,8315,2201,3723,1267,0,0,15506
11/22/2023,3,8314,2122,3569,1411,0,0,15416
11/22/2023,4,8314,1863,3426,1766,0,0,15369
11/22/2023,5,8318,2537,3258,1268,0,0,15381
11/22/2023,6,8315,2838,3367,1761,0,0,16281
11/22/2023,7,8316,3204,3893,2319,0,0,17732
11/22/2023,8,8312,4088,4144,2200,0,0,18744
11/22/2023,9,8314,4902,3945,1952,1,0,19114
11/22/2023,10,8341,5010,3931,1771,18,0,19071
11/22/2023,11,8367,4818,4122,1809,27,0,19143
11/22/2023,12,8372,5071,3887,1876,41,0,19247
11/22/2023,13,8380,4864,3822,1923,42,0,19031
11/22/2023,14,8347,4887,3770,1802,39,0,18845
11/22/2023,15,8325,5129,3797,1636,33,0,18920
11/22/2023,16,8317,5164,4023,1395,16,0,18915
11/22/2023,17,8319,5396,4393,1001,1,2,19112
11/22/2023,18,8321,5660,4319,772,0,14,19086
11/22/2023,19,8327,5692,4288,550,0,18,18875
11/22/2023,20,8332,5579,4219,489,0,9,18628
11/22/2023,21,8331,4865,4146,652,0,0,17994
11/22/2023,22,8330,4558,3968,835,0,0,17691
11/22/2023,23,8327,4373,3814,950,0,1,17465
11/22/2023,24,8326,3137,3800,1050,0,0,16313
11/23/2023,1,8323,2502,3666,1385,0,0,15876
11/23/2023,2,8327,1609,3403,1627,0,0,14966
11/23/2023,3,8321,1838,3432,1674,0,0,15265
11/23/2023,4,8324,1845,3407,1918,0,0,15494
11/23/2023,5,8325,2067,3410,1940,0,0,15742
11/23/2023,6,8318,2512,3409,1774,0,0,16013
11/23/2023,7,8305,2961,3505,2298,0,0,17069
11/23/2023,8,8301,2957,3794,3039,0,0,18091
11/23/2023,9,8300,3070,4106,3230,17,0,18723
11/23/2023,10,8309,2955,3733,3215,72,0,18284
11/23/2023,11,8301,2974,3961,3037,111,0,18384
11/23/2023,12,8307,3652,4025,2640,93,16,18733
11/23/2023,13,8305,3585,3886,2399,90,48,18313
11/23/2023,14,8310,3346,3939,2318,85,51,18049
11/23/2023,15,8311,3815,3981,2379,64,50,18600
11/23/2023,16,8313,4207,4173,2249,19,51,19012
11/23/2023,17,8310,4156,4181,2276,1,28,18952
11/23/2023,18,8312,3860,4345,2231,0,0,18748
11/23/2023,19,8313,3727,4283,2246,0,8,18577
11/23/2023,20,8311,3298,4180,2511,0,10,18310
11/23/2023,21,8309,3244,4109,2812,0,11,18485
11/23/2023,22,8303,3177,3975,2748,0,16,18219
11/23/2023,23,8305,2736,3834,2694,0,14,17583
11/23/2023,24,8304,2319,3727,2531,0,10,16891
11/24/2023,1,8305,1982,3479,2465,0,10,16241
11/24/2023,2,8328,1491,3444,2261,0,10,15534
11/24/2023,3,8340,1763,3368,2127,0,10,15608
11/24/2023,4,8439,1919,3525,1964,0,10,15857
11/24/2023,5,8553,2227,3447,1768,0,10,16005
11/24/2023,6,8547,2661,3596,1915,0,10,16729
11/24/2023,7,8625,2972,4047,1948,0,10,17602
11/24/2023,8,8737,3915,4201,1906,6,10,18775
11/24/2023,9,8741,4111,4181,1976,52,6,19067
11/24/2023,10,8836,3854,4059,2211,101,10,19071
11/24/2023,11,8906,3364,3921,2422,160,10,18783
11/24/2023,12,8912,3067,3844,2541,146,10,18520
11/24/2023,13,8917,2988,3972,2348,170,10,18405
11/24/2023,14,8913,3093,3754,2449,148,20,18377
11/24/2023,15,8906,3037,3620,2584,129,60,18336
11/24/2023,16,8906,3271,3783,2374,58,80,18472
11/24/2023,17,8911,3786,4217,2041,10,78,19043
11/24/2023,18,8918,4935,4505,1851,0,120,20329
11/24/2023,19,8920,5154,4370,1741,0,134,20319
11/24/2023,20,9009,4953,4249,1739,0,82,20032
11/24/2023,21,9020,4673,4059,1667,0,67,19486
11/24/2023,22,9005,4539,4057,1510,0,67,19178
11/24/2023,23,9009,3903,3900,1367,0,68,18247
11/24/2023,24,9016,3601,3836,1189,0,72,17714
11/25/2023,1,9007,3438,3764,1085,0,69,17363
11/25/2023,2,9007,2749,3613,1070,0,71,16510
11/25/2023,3,9011,2402,3657,1031,0,73,16174
11/25/2023,4,9009,2554,3646,1024,0,104,16337
11/25/2023,5,9015,2624,3668,1023,0,111,16441
11/25/2023,6,9042,2875,3832,1080,0,113,16942
11/25/2023,7,9102,2803,4203,1094,0,110,17312
11/25/2023,8,9101,3340,4179,1066,4,112,17802
11/25/2023,9,9102,3689,4232,1011,38,102,18174
11/25/2023,10,9098,3914,4149,911,113,105,18290
11/25/2023,11,9098,4234,4131,942,137,155,18697
11/25/2023,12,9094,3945,3927,1068,210,108,18352
11/25/2023,13,9102,3400,3898,1070,197,72,17739
11/25/2023,14,9120,2937,4026,1047,175,72,17377
11/25/2023,15,9124,3104,4014,1106,112,70,17530
11/25/2023,16,9123,4124,4085,1012,65,87,18496
11/25/2023,17,9121,4212,4186,924,6,83,18532
11/25/2023,18,9123,5126,4266,920,0,109,19544
11/25/2023,19,9126,4536,4257,945,0,100,18964
11/25/2023,20,9128,4783,4258,922,0,98,19189
11/25/2023,21,9130,4832,4093,912,0,100,19067
11/25/2023,22,9134,4355,3810,843,0,100,18242
11/25/2023,23,9130,3853,3641,777,0,87,17488
11/25/2023,24,9130,3578,3617,742,0,80,17147
11/26/2023,1,9131,2598,3913,598,0,89,16329
11/26/2023,2,9133,2515,3777,453,0,126,16004
11/26/2023,3,9136,2472,3576,403,0,91,15678
11/26/2023,4,9134,2520,3588,400,0,69,15711
11/26/2023,5,9141,2723,3565,379,0,70,15878
11/26/2023,6,9145,3007,3556,414,0,68,16190
11/26/2023,7,9145,2945,3818,564,0,67,16539
11/26/2023,8,9141,2988,4017,814,4,67,17031
11/26/2023,9,9141,2799,4073,1019,48,67,17147
11/26/2023,10,9138,2669,3980,945,127,67,16926
11/26/2023,11,9137,2780,4036,861,164,70,17048
11/26/2023,12,9136,2863,4016,991,160,68,17234
11/26/2023,13,9136,2995,4011,1239,117,71,17569
11/26/2023,14,9136,3462,3907,1483,42,70,18100
11/26/2023,15,9141,3824,3880,1609,21,70,18545
11/26/2023,16,9139,3997,4008,1635,7,70,18856
11/26/2023,17,9138,3956,4153,1730,0,70,19047
11/26/2023,18,9144,4199,4278,1979,0,80,19680
11/26/2023,19,9137,3646,4303,2295,0,70,19451
11/26/2023,20,9131,3603,4186,2494,0,69,19483
11/26/2023,21,9130,3264,4050,2677,0,68,19189
11/26/2023,22,9132,2335,3688,2896,0,68,18119
11/26/2023,23,9132,1281,3455,3005,0,68,16941
11/26/2023,24,9138,626,3281,3186,0,66,16297
11/27/2023,1,9142,231,3436,2884,0,28,15721
11/27/2023,2,9129,132,3375,3277,0,15,15928
11/27/2023,3,9129,131,3315,3552,0,15,16142
11/27/2023,4,9133,263,3375,3422,0,15,16208
11/27/2023,5,9138,705,3376,3133,0,15,16367
11/27/2023,6,9138,1434,3451,3304,0,15,17342
11/27/2023,7,9134,1627,3617,3530,0,15,17923
11/27/2023,8,9129,2162,3870,4067,0,19,19247
11/27/2023,9,9131,2363,3899,4061,9,27,19490
11/27/2023,10,9134,2580,3800,4104,53,26,19697
11/27/2023,11,9129,2185,3633,4183,80,42,19252
11/27/2023,12,9126,2189,3367,4218,54,42,18996
11/27/2023,13,9126,2387,3437,4128,69,62,19209
11/27/2023,14,9132,2504,3546,4120,49,93,19444
11/27/2023,15,9133,2472,3651,4149,64,88,19557
11/27/2023,16,9135,2666,3825,4239,38,73,19976
11/27/2023,17,9136,3381,4088,4124,1,69,20799
11/27/2023,18,9129,3641,4239,4137,0,70,21216
11/27/2023,19,9134,3654,4211,4101,0,69,21169
11/27/2023,20,9137,3459,4091,4080,0,69,20836
11/27/2023,21,9144,3507,4114,3880,0,69,20714
11/27/2023,22,9141,3297,3852,3731,0,76,20097
11/27/2023,23,9138,2529,3817,3421,0,96,19001
11/27/2023,24,9142,1861,3746,3203,0,70,18022
11/28/2023,1,9142,1648,3686,3128,0,27,17631
11/28/2023,2,9142,1425,3610,3030,0,15,17222
11/28/2023,3,9145,1539,3359,3087,0,15,17145
11/28/2023,4,9147,1481,3372,3192,0,17,17209
11/28/2023,5,9148,1748,3424,2966,0,19,17305
11/28/2023,6,9149,2172,3463,3120,0,25,17929
11/28/2023,7,9149,2666,3696,3491,0,43,19045
11/28/2023,8,9144,3685,3942,3570,1,79,20421
11/28/2023,9,9148,3865,3918,3556,32,83,20602
11/28/2023,10,9144,3496,3941,3469,84,75,20209
11/28/2023,11,9141,3392,3894,3296,126,72,19921
11/28/2023,12,9151,3346,3676,3281,146,80,19680
11/28/2023,13,9144,2697,3809,3359,242,84,19335
11/28/2023,14,9146,2531,3838,3619,249,82,19465
11/28/2023,15,9144,2653,3810,3661,164,83,19515
11/28/2023,16,9139,3326,3959,3502,72,87,20085
11/28/2023,17,9136,4537,4191,2934,6,101,20905
11/28/2023,18,9139,5301,4610,2522,0,189,21761
11/28/2023,19,9145,5251,4403,2564,0,191,21554
11/28/2023,20,9144,4983,4224,2711,0,121,21183
11/28/2023,21,9144,4481,4280,2940,0,83,20928
11/28/2023,22,9151,4432,4131,2913,0,73,20700
11/28/2023,23,9153,4363,3910,2797,0,25,20248
11/28/2023,24,9155,3654,3671,2870,0,16,19366
11/29/2023,1,9152,2431,3480,3014,0,16,18093
11/29/2023,2,9144,2008,3595,3001,0,16,17764
11/29/2023,3,9144,2261,3525,2992,0,16,17938
11/29/2023,4,9140,2464,3433,2927,0,20,17984
11/29/2023,5,9136,2735,3420,2976,0,27,18294
11/29/2023,6,9139,2812,3805,3043,0,30,18829
11/29/2023,7,9133,3828,4040,2989,0,38,20028
11/29/2023,8,9137,4221,4014,3259,3,70,20704
11/29/2023,9,9137,4252,4016,3519,25,74,21023
11/29/2023,10,9143,4322,3871,3584,81,70,21071
11/29/2023,11,9142,3978,3884,3773,120,67,20964
11/29/2023,12,9143,3722,3804,3972,101,69,20811
11/29/2023,13,9138,3290,3878,3883,82,68,20339
11/29/2023,14,9135,3819,3939,3707,70,69,20739
11/29/2023,15,9134,4293,3832,3522,45,69,20895
11/29/2023,16,9133,4524,3948,3261,23,70,20959
11/29/2023,17,9132,4976,4107,3078,4,70,21367
11/29/2023,18,9147,5540,4212,3074,0,70,22043
11/29/2023,19,9150,5464,4077,3305,0,70,22066
11/29/2023,20,9148,4666,4105,3464,0,70,21453
11/29/2023,21,9148,4718,3995,3324,0,71,21256
11/29/2023,22,9146,4097,3816,3036,0,71,20166
11/29/2023,23,9145,3395,3615,3054,0,73,19282
11/29/2023,24,9143,2848,3211,2957,0,28,18187
11/30/2023,1,9147,2376,3210,2705,0,17,17455
11/30/2023,2,9143,1675,3252,3119,0,17,17206
11/30/2023,3,9143,1685,3316,2977,0,16,17137
11/30/2023,4,9137,2039,3453,2694,0,16,17339
11/30/2023,5,9138,2298,3298,2977,0,16,17727
11/30/2023,6,9138,2497,3335,2944,0,27,17941
11/30/2023,7,9145,3034,4011,3220,0,44,19454
11/30/2023,8,9147,3570,4217,3392,0,81,20407
11/30/2023,9,9148,3737,3983,3595,35,91,20589
11/30/2023,10,9143,3329,3944,3636,119,91,20262
11/30/2023,11,9146,3098,3735,3636,157,89,19861
11/30/2023,12,9142,2779,3632,3686,179,85,19503
11/30/2023,13,9144,2549,3250,3432,220,90,18685
11/30/2023,14,9144,2115,3318,3479,228,74,18358
11/30/2023,15,9148,2134,3482,3767,202,81,18814
11/30/2023,16,9149,2462,3397,4071,82,85,19246
11/30/2023,17,9152,3013,3769,4292,9,61,20296
11/30/2023,18,9150,3070,4689,4167,0,69,21145
11/30/2023,19,9149,3090,4565,4238,0,69,21111
11/30/2023,20,9147,2700,4583,4204,0,69,20703
11/30/2023,21,9138,2500,4393,4176,0,69,20276
11/30/2023,22,9136,1928,4088,4036,0,67,19255
11/30/2023,23,9143,1382,3795,3559,0,27,17906
11/30/2023,24,9145,1022,3971,3057,0,16,17211
12/1/2023,1,9145,1108,3836,2618,0,15,16722
12/1/2023,2,9147,1337,3858,2287,0,15,16644
12/1/2023,3,9149,1495,3834,1745,0,15,16238
12/1/2023,4,9151,1815,3983,1365,0,15,16329
12/1/2023,5,9150,2256,3527,896,0,21,15850
12/1/2023,6,9153,2674,3704,750,0,51,16332
12/1/2023,7,9158,3453,4497,596,0,68,17772
12/1/2023,8,9153,4882,4640,590,0,68,19333
12/1/2023,9,9149,5309,4475,561,4,68,19566
12/1/2023,10,9151,5104,4436,596,17,68,19372
12/1/2023,11,9154,4740,4293,703,39,68,18997
12/1/2023,12,9156,5028,4294,787,50,74,19389
12/1/2023,13,9156,5200,4334,661,51,84,19486
12/1/2023,14,9158,5324,4566,721,53,125,19947
12/1/2023,15,9160,5414,4529,452,40,111,19706
12/1/2023,16,9160,5133,4648,473,12,91,19517
12/1/2023,17,9159,4812,4724,492,0,91,19278
12/1/2023,18,9158,4630,4791,626,0,90,19295
12/1/2023,19,9163,4178,4750,710,0,73,18874
12/1/2023,20,9160,4297,4812,749,0,69,19087
12/1/2023,21,9160,4604,4541,768,0,69,19142
12/1/2023,22,9157,4616,4505,661,0,70,19009
12/1/2023,23,9164,4367,4144,560,0,28,18263
12/1/2023,24,9160,3344,4006,532,0,18,17060
12/2/2023,1,9157,2700,4011,456,0,18,16342
12/2/2023,2,9157,2563,3865,372,0,17,15974
12/2/2023,3,9161,2489,3816,335,0,16,15817
12/2/2023,4,9158,2323,3792,295,0,16,15584
12/2/2023,5,9185,2040,3965,436,0,16,15642
12/2/2023,6,9198,2183,4054,441,0,16,15892
12/2/2023,7,9196,2514,4251,494,0,16,16471
12/2/2023,8,9195,2901,4454,602,0,32,17184
12/2/2023,9,9192,3063,4597,653,3,63,17571
12/2/2023,10,9194,3509,4667,665,24,69,18128
12/2/2023,11,9195,3942,4607,608,47,69,18468
12/2/2023,12,9189,4652,4501,544,81,69,19036
12/2/2023,13,9190,4849,4517,415,74,69,19114
12/2/2023,14,9183,4799,4478,400,75,69,19004
12/2/2023,15,9189,4630,4499,382,51,69,18820
12/2/2023,16,9187,4251,4596,434,15,69,18552
12/2/2023,17,9192,4134,4613,543,0,69,18551
12/2/2023,18,9193,4130,4789,655,0,68,18835
12/2/2023,19,9193,4016,4874,728,0,69,18880
12/2/2023,20,9194,3878,4741,838,0,69,18720
12/2/2023,21,9194,3735,4678,901,0,69,18577
12/2/2023,22,9192,3264,4438,903,0,27,17824
12/2/2023,23,9192,2772,4312,945,0,22,17243
12/2/2023,24,9193,2179,4171,998,0,20,16561
12/3/2023,1,9197,1723,4218,1111,0,16,16265
12/3/2023,2,9198,1450,3719,1309,0,16,15692
12/3/2023,3,9202,1641,3245,1464,0,16,15568
12/3/2023,4,9191,1466,3180,1455,0,16,15308
12/3/2023,5,9194,1400,3509,1554,0,16,15673
12/3/2023,6,9195,1752,3975,1206,0,16,16144
12/3/2023,7,9193,2009,4273,1138,0,16,16629
12/3/2023,8,9192,2136,4407,1184,0,16,16935
12/3/2023,9,9188,2812,4476,1146,4,27,17653
12/3/2023,10,9189,3184,4586,1088,30,57,18134
12/3/2023,11,9188,3905,4638,962,52,68,18813
12/3/2023,12,9183,4368,4588,812,55,70,19076
12/3/2023,13,9186,4688,4866,634,55,98,19527
12/3/2023,14,9193,4859,4661,501,54,87,19355
12/3/2023,15,9192,4324,4478,723,43,71,18831
12/3/2023,16,9190,3964,4576,1174,18,68,18990
12/3/2023,17,9193,3705,4729,1238,6,69,18940
12/3/2023,18,9190,4543,4702,1132,5,70,19642
12/3/2023,19,9191,4846,4601,1262,5,70,19975
12/3/2023,20,9194,4181,4451,1572,5,70,19473
12/3/2023,21,9187,3813,4270,1877,5,70,19222
12/3/2023,22,9190,3273,4208,2059,5,71,18806
12/3/2023,23,9185,2830,3901,1920,5,72,17913
12/3/2023,24,9190,2174,3711,1853,5,71,17004
12/4/2023,1,9186,1799,4062,1770,1,70,16888
12/4/2023,2,9180,1335,4033,1816,0,70,16434
12/4/2023,3,9177,1087,4077,1801,0,70,16212
12/4/2023,4,9180,1324,4004,1676,0,70,16254
12/4/2023,5,9182,1711,4067,1505,0,70,16535
12/4/2023,6,9187,2776,3946,1102,0,71,17082
12/4/2023,7,9188,4149,3973,873,0,90,18273
12/4/2023,8,9189,5141,4157,700,1,106,19294
12/4/2023,9,9189,5437,3965,523,15,81,19210
12/4/2023,10,9188,5665,3921,412,46,95,19327
12/4/2023,11,9190,5715,3806,441,127,68,19347
12/4/2023,12,9187,5624,3706,439,116,68,19140
12/4/2023,13,9192,5550,3707,487,111,67,19114
12/4/2023,14,9193,5244,3729,623,87,66,18942
12/4/2023,15,9193,5532,3775,785,38,66,19389
12/4/2023,16,9199,5323,4030,728,14,67,19361
12/4/2023,17,9201,5276,4226,765,3,70,19541
12/4/2023,18,9204,5310,4271,741,0,72,19598
12/4/2023,19,9200,5094,4395,699,0,72,19460
12/4/2023,20,9196,5208,4257,558,0,73,19292
12/4/2023,21,9192,5555,4013,528,0,73,19361
12/4/2023,22,9189,5246,3773,540,0,68,18816
12/4/2023,23,9187,4905,3611,550,0,70,18323
12/4/2023,24,9180,4227,3550,513,0,66,17536
12/5/2023,1,9182,3536,3699,406,0,66,16889
12/5/2023,2,9184,3453,3599,335,0,68,16639
12/5/2023,3,9202,3272,3554,196,0,67,16291
12/5/2023,4,9184,3162,3554,122,0,67,16089
12/5/2023,5,9190,3274,3436,82,0,67,16049
12/5/2023,6,9190,4064,3769,86,0,68,17177
12/5/2023,7,9194,4693,3982,100,0,71,18040
12/5/2023,8,9192,5339,4083,61,0,69,18744
12/5/2023,9,9199,5812,4075,57,5,69,19217
12/5/2023,10,9193,6074,3995,64,21,69,19416
12/5/2023,11,9194,6114,4020,24,29,91,19472
12/5/2023,12,9195,6228,3918,4,50,85,19480
12/5/2023,13,9195,5652,3992,6,55,69,18969
12/5/2023,14,9189,5521,3956,22,47,68,18803
12/5/2023,15,9181,5495,3999,35,36,67,18813
12/5/2023,16,9181,5444,4165,46,18,68,18922
12/5/2023,17,9192,5795,4490,47,3,73,19600
12/5/2023,18,9189,5860,4605,86,0,69,19809
12/5/2023,19,9192,5707,4701,100,0,71,19771
12/5/2023,20,9190,5766,4666,156,0,71,19849
12/5/2023,21,9192,5889,4431,278,0,69,19859
12/5/2023,22,9192,5266,4149,518,0,89,19214
12/5/2023,23,9190,4332,4060,587,0,70,18239
12/5/2023,24,9187,3589,3914,579,0,29,17298
12/6/2023,1,9187,2938,3899,599,0,16,16639
12/6/2023,2,9189,2499,3747,593,0,16,16044
12/6/2023,3,9186,2459,3435,617,0,16,15713
12/6/2023,4,9186,2517,3349,564,0,16,15632
12/6/2023,5,9188,2662,3525,746,0,16,16137
12/6/2023,6,9196,2942,3832,707,0,16,16693
12/6/2023,7,9192,3900,4378,629,0,22,18121
12/6/2023,8,9188,4839,4514,610,0,54,19205
12/6/2023,9,9181,5397,4412,572,24,70,19656
12/6/2023,10,9178,5346,4238,440,112,73,19387
12/6/2023,11,9181,5036,4211,379,174,73,19054
12/6/2023,12,9183,4909,4208,384,146,69,18899
12/6/2023,13,9190,4811,4394,342,192,69,18998
12/6/2023,14,9185,3894,4506,320,211,70,18186
12/6/2023,15,9188,3923,4628,338,152,70,18299
12/6/2023,16,9190,4775,4894,310,60,71,19300
12/6/2023,17,9183,5326,5128,253,4,71,19965
12/6/2023,18,9184,5942,5150,329,0,71,20676
12/6/2023,19,9188,5498,4945,502,0,71,20204
12/6/2023,20,9189,5225,4870,757,0,68,20109
12/6/2023,21,9185,5116,4529,1043,0,69,19942
12/6/2023,22,9184,4659,4363,1167,0,70,19443
12/6/2023,23,9186,3817,4262,1525,0,31,18821
12/6/2023,24,9187,3075,4159,1731,0,16,18168
12/7/2023,1,9187,2475,4086,1932,0,13,17693
12/7/2023,2,9181,2032,4107,2030,0,11,17361
12/7/2023,3,9191,2114,4048,2062,0,11,17426
12/7/2023,4,9189,2201,3572,2642,0,11,17615
12/7/2023,5,9192,2405,3246,2936,0,4,17783
12/7/2023,6,9192,2653,3376,3052,0,4,18277
12/7/2023,7,9188,3121,4426,2983,0,4,19722
12/7/2023,8,9184,4347,4753,2599,0,14,20897
12/7/2023,9,9191,4705,4769,2181,4,14,20864
12/7/2023,10,9191,4945,4740,1790,21,18,20705
12/7/2023,11,9191,4919,4628,1589,41,38,20406
12/7/2023,12,9193,5104,4441,1236,52,65,20091
12/7/2023,13,9196,5115,4474,936,66,71,19858
12/7/2023,14,9202,5435,4503,590,61,73,19864
12/7/2023,15,9198,5630,4503,409,33,71,19844
12/7/2023,16,9198,5732,4740,266,8,71,20015
12/7/2023,17,9197,6216,4803,185,1,95,20497
12/7/2023,18,9199,6252,4973,148,0,103,20675
12/7/2023,19,9202,5824,4975,207,0,70,20278
12/7/2023,20,9203,5777,4897,240,0,71,20188
12/7/2023,21,9200,5854,4589,308,0,70,20021
12/7/2023,22,9191,5495,4302,414,0,70,19472
12/7/2023,23,9197,4618,4210,592,0,29,18646
12/7/2023,24,9200,3829,4196,826,0,17,18068
12/8/2023,1,9198,2957,4120,994,0,17,17286
12/8/2023,2,9196,2540,3616,1272,0,17,16641
12/8/2023,3,9199,2034,3428,1652,0,17,16330
12/8/2023,4,9200,1806,3472,1986,0,17,16481
12/8/2023,5,9201,1981,3328,2244,0,17,16771
12/8/2023,6,9196,2367,3247,2556,0,17,17383
12/8/2023,7,9198,2660,3786,2912,0,18,18574
12/8/2023,8,9213,3024,4675,3133,0,18,20063
12/8/2023,9,9215,3310,4826,3254,11,18,20634
12/8/2023,10,9215,3485,4757,3197,80,18,20752
12/8/2023,11,9212,3487,4519,3076,153,18,20465
12/8/2023,12,9209,3560,4471,3033,131,18,20422
12/8/2023,13,9210,3349,4455,2857,123,18,20012
12/8/2023,14,9209,3572,4281,2909,89,18,20078
12/8/2023,15,9204,3367,4351,2840,41,35,19838
12/8/2023,16,9200,3774,4430,2779,12,67,20262
12/8/2023,17,9199,3515,4694,2956,1,73,20438
12/8/2023,18,9204,3753,4900,3016,0,72,20945
12/8/2023,19,9181,3902,4722,3102,0,72,20979
12/8/2023,20,9176,3346,4352,3266,0,71,20211
12/8/2023,21,9175,2899,4256,3382,0,71,19783
12/8/2023,22,9175,2361,4209,3430,0,71,19246
12/8/2023,23,9173,1595,4129,3315,0,31,18243
12/8/2023,24,9173,828,3891,3430,0,19,17341
12/9/2023,1,9178,257,3905,3412,0,18,16770
12/9/2023,2,9172,141,3695,3384,0,18,16410
12/9/2023,3,9170,140,3916,3209,0,18,16453
12/9/2023,4,9175,140,3899,3088,0,18,16320
12/9/2023,5,9180,252,4004,2872,0,18,16326
12/9/2023,6,9172,414,3847,2965,0,18,16416
12/9/2023,7,9176,703,3415,3234,0,18,16546
12/9/2023,8,9178,951,3687,3537,0,18,17371
12/9/2023,9,9176,951,3917,3807,9,18,17878
12/9/2023,10,9170,1003,4005,4098,28,18,18322
12/9/2023,11,9171,1030,4097,4201,30,18,18547
12/9/2023,12,9170,1192,4239,4188,31,18,18838
12/9/2023,13,9167,990,4111,4221,55,18,18562
12/9/2023,14,9167,1074,3811,4313,80,18,18463
12/9/2023,15,9163,1447,3496,4283,41,17,18447
12/9/2023,16,9166,1626,3669,4335,21,41,18858
12/9/2023,17,9167,2140,3537,4327,1,65,19237
12/9/2023,18,9162,2391,4255,3872,0,70,19750
12/9/2023,19,9162,2387,4683,3103,0,70,19405
12/9/2023,20,9168,2418,4826,2389,0,68,18869
12/9/2023,21,9162,2471,4654,2019,0,67,18373
12/9/2023,22,9158,2282,4445,1761,0,69,17715
12/9/2023,23,9157,1626,4106,1937,0,28,16854
12/9/2023,24,9164,1158,3935,2129,0,16,16402
12/10/2023,1,9162,331,3821,2509,0,16,15839
12/10/2023,2,9158,145,4032,2327,0,16,15678
12/10/2023,3,9159,146,4022,2258,0,16,15601
12/10/2023,4,9175,146,3633,2362,0,16,15332
12/10/2023,5,9169,155,3962,2337,0,16,15639
12/10/2023,6,9173,259,3358,2616,0,17,15423
12/10/2023,7,9172,563,3379,2665,0,17,15796
12/10/2023,8,9175,1010,3589,2738,0,17,16529
12/10/2023,9,9173,1339,4044,2642,6,17,17221
12/10/2023,10,9170,1685,4664,2587,20,17,18143
12/10/2023,11,9170,2183,4706,2448,45,17,18569
12/10/2023,12,9172,2974,4649,2311,49,17,19172
12/10/2023,13,9164,3427,4790,1925,58,17,19381
12/10/2023,14,9163,3933,5003,1552,43,17,19711
12/10/2023,15,9170,4667,4838,1302,22,22,20021
12/10/2023,16,9174,4236,4731,1259,6,50,19456
12/10/2023,17,9173,4003,4983,1166,0,65,19390
12/10/2023,18,9176,4505,5017,1355,0,65,20118
12/10/2023,19,9171,4712,4985,1285,0,71,20224
12/10/2023,20,9172,4717,4890,1309,0,71,20159
12/10/2023,21,9167,4523,4755,1417,0,70,19932
12/10/2023,22,9170,4093,4599,1370,0,70,19302
12/10/2023,23,9179,3161,4311,1606,0,30,18287
12/10/2023,24,9187,2382,4372,1854,0,17,17812
12/11/2023,1,9181,1786,4082,2087,0,17,17153
12/11/2023,2,9187,1696,4088,2070,0,17,17058
12/11/2023,3,9197,1561,3946,2141,0,17,16862
12/11/2023,4,9192,1903,3451,2440,0,17,17003
12/11/2023,5,9199,2410,3307,2281,0,17,17214
12/11/2023,6,9206,2772,3469,2153,0,17,17617
12/11/2023,7,9202,3051,4183,2560,0,17,19013
12/11/2023,8,9203,4012,4948,2390,0,35,20588
12/11/2023,9,9198,4651,4797,2308,16,65,21035
12/11/2023,10,9198,4706,4730,2242,41,71,20988
12/11/2023,11,9196,4571,4655,2262,80,73,20837
12/11/2023,12,9190,4124,4615,2365,90,75,20459
12/11/2023,13,9187,4188,4542,2389,100,82,20488
12/11/2023,14,9191,4234,4591,2488,74,79,20657
12/11/2023,15,9187,4426,4737,2486,41,75,20952
12/11/2023,16,9185,4396,4933,2344,21,75,20954
12/11/2023,17,9180,4886,5090,2034,0,76,21266
12/11/2023,18,9186,5583,5037,1794,0,101,21701
12/11/2023,19,9194,5653,4948,1672,0,104,21571
12/11/2023,20,9193,5447,4914,1725,0,72,21351
12/11/2023,21,9194,5191,4650,2084,0,69,21188
12/11/2023,22,9182,4430,4450,2356,0,27,20445
12/11/2023,23,9180,3775,4149,2582,0,19,19705
12/11/2023,24,9182,2665,3870,2808,0,18,18543
12/12/2023,1,9177,2131,4124,2910,0,17,18359
12/12/2023,2,9175,1781,3825,3196,0,17,17994
12/12/2023,3,9177,1250,3685,3586,0,18,17716
12/12/2023,4,9178,1050,3511,3907,0,18,17664
12/12/2023,5,9185,1310,3285,3982,0,17,17779
12/12/2023,6,9186,1827,3965,3474,0,16,18468
12/12/2023,7,9186,2077,4278,4114,0,17,19672
12/12/2023,8,9189,2594,4709,4521,0,17,21030
12/12/2023,9,9193,2696,4570,4406,31,16,20912
12/12/2023,10,9188,2490,4409,4430,91,16,20624
12/12/2023,11,9190,2354,4268,4328,111,16,20267
12/12/2023,12,9195,2106,4117,4265,124,16,19823
12/12/2023,13,9190,2508,4015,3862,111,16,19702
12/12/2023,14,9182,2385,4004,3887,72,16,19546
12/12/2023,15,9181,2039,4033,4257,113,29,19652
12/12/2023,16,9175,2355,4469,4186,43,57,20285
12/12/2023,17,9170,3750,4674,3889,7,69,21559
12/12/2023,18,9166,4665,5069,3652,0,93,22645
12/12/2023,19,9183,4600,4891,3669,0,72,22415
12/12/2023,20,9180,4140,4960,3555,0,72,21907
12/12/2023,21,9175,3919,4817,3549,0,68,21528
12/12/2023,22,9169,3403,4535,3297,0,68,20472
12/12/2023,23,9172,3147,4362,3172,0,28,19881
12/12/2023,24,9178,2242,4280,3272,0,18,18990
12/13/2023,1,9182,1684,4397,3286,0,17,18566
12/13/2023,2,9179,1316,4268,3153,0,24,17940
12/13/2023,3,9182,1042,4372,2848,0,23,17467
12/13/2023,4,9171,1187,4361,2730,0,26,17475
12/13/2023,5,9165,2013,4125,2827,0,35,18165
12/13/2023,6,9170,2468,3994,3004,0,42,18678
12/13/2023,7,9176,3065,4619,2971,0,59,19890
12/13/2023,8,9170,4435,4912,2733,0,99,21349
12/13/2023,9,9171,4725,4647,2657,51,99,21350
12/13/2023,10,9171,4229,4655,2522,155,87,20819
12/13/2023,11,9166,3378,4725,2446,230,97,20042
12/13/2023,12,9164,3795,4641,2281,231,113,20225
12/13/2023,13,9145,3128,4277,2129,243,100,19022
12/13/2023,14,9153,3189,4266,2054,256,103,19021
12/13/2023,15,9150,3195,4422,1817,149,101,18834
12/13/2023,16,9147,4165,4896,1474,79,100,19861
12/13/2023,17,9148,4920,5140,1157,11,112,20488
12/13/2023,18,9150,5514,5185,1137,0,153,21139
12/13/2023,19,9153,4682,5146,1173,0,105,20259
12/13/2023,20,9152,4812,5232,1078,0,104,20378
12/13/2023,21,9154,5158,5208,935,0,125,20580
12/13/2023,22,9153,5200,4907,880,0,90,20230
12/13/2023,23,9150,4886,4284,813,0,46,19179
12/13/2023,24,9154,4039,4219,898,0,29,18339
12/14/2023,1,9153,3159,4218,974,0,17,17521
12/14/2023,2,9152,2535,4170,1056,0,17,16930
12/14/2023,3,9153,2339,4107,1028,0,25,16652
12/14/2023,4,9152,2476,4042,1230,0,45,16945
12/14/2023,5,9151,2646,3746,1466,0,40,17049
12/14/2023,6,9150,2997,4248,1611,0,36,18042
12/14/2023,7,9154,3796,4560,1945,0,67,19522
12/14/2023,8,9155,4435,4861,2137,0,88,20676
12/14/2023,9,9159,4525,4731,2233,30,92,20770
12/14/2023,10,9161,4286,4482,2268,134,86,20417
12/14/2023,11,9165,3989,4447,2301,191,84,20177
12/14/2023,12,9169,3907,4173,2532,200,86,20067
12/14/2023,13,9168,3609,4154,2761,160,90,19942
12/14/2023,14,9164,3276,4091,3093,137,94,19855
12/14/2023,15,9161,2921,3752,3637,119,91,19681
12/14/2023,16,9164,2849,4083,3795,61,88,20040
12/14/2023,17,9163,3051,4814,3993,8,84,21113
12/14/2023,18,9165,3207,4775,4207,0,83,21437
12/14/2023,19,9168,3164,4702,4448,0,78,21560
12/14/2023,20,9168,3051,4697,4477,0,81,21474
12/14/2023,21,9167,3277,4364,4500,0,43,21351
12/14/2023,22,9164,2635,4267,4472,0,21,20559
12/14/2023,23,9154,1665,4342,4478,0,17,19656
12/14/2023,24,9155,990,4159,4461,0,17,18782
12/15/2023,1,9160,769,3833,4370,0,17,18149
12/15/2023,2,9162,306,3898,4210,0,17,17593
12/15/2023,3,9163,208,3987,4008,0,17,17383
12/15/2023,4,9159,317,3914,4013,0,17,17420
12/15/2023,5,9156,1014,3617,3958,0,17,17762
12/15/2023,6,9153,1956,3266,3968,0,17,18360
12/15/2023,7,9165,2380,4003,3798,0,17,19363
12/15/2023,8,9161,2508,4851,3584,0,17,20121
12/15/2023,9,9161,3059,4751,3352,56,17,20396
12/15/2023,10,9162,2619,4686,2885,179,17,19548
12/15/2023,11,9158,2427,4268,2323,303,26,18505
12/15/2023,12,9156,2441,4097,2037,345,27,18103
12/15/2023,13,9158,2579,3562,1906,347,30,17582
12/15/2023,14,9153,2604,3569,2035,305,33,17699
12/15/2023,15,9157,2758,3607,1845,206,52,17625
12/15/2023,16,9152,2863,4522,1818,91,80,18526
12/15/2023,17,9168,3329,5059,1994,8,81,19639
12/15/2023,18,9176,3311,5133,2324,0,84,20028
12/15/2023,19,9177,3137,5183,2329,0,83,19909
12/15/2023,20,9177,3284,5114,2095,0,83,19753
12/15/2023,21,9174,3526,5032,1849,0,71,19652
12/15/2023,22,9169,3847,4725,1564,0,70,19375
12/15/2023,23,9168,3335,4551,1188,0,29,18271
12/15/2023,24,9167,3133,4336,781,0,17,17434
12/16/2023,1,9168,2648,4384,503,0,17,16720
12/16/2023,2,9178,2236,4226,456,0,16,16112
12/16/2023,3,9184,1705,4188,397,0,16,15490
12/16/2023,4,9187,1137,4059,394,0,16,14793
12/16/2023,5,9180,1204,4299,435,0,16,15134
12/16/2023,6,9177,1626,4332,490,0,16,15641
12/16/2023,7,9178,2008,4479,650,0,16,16331
12/16/2023,8,9177,2295,4790,1096,2,16,17376
12/16/2023,9,9185,2340,4419,1580,34,16,17574
12/16/2023,10,9187,2335,3859,2012,93,16,17502
12/16/2023,11,9190,2336,4190,1757,186,16,17675
12/16/2023,12,9183,2334,4258,1559,211,17,17562
12/16/2023,13,9184,2385,4522,1627,209,17,17944
12/16/2023,14,9187,2321,4335,1791,195,17,17846
12/16/2023,15,9194,2579,4609,1679,102,38,18201
12/16/2023,16,9196,2618,4562,2065,53,65,18559
12/16/2023,17,9189,2635,4855,2465,3,69,19216
12/16/2023,18,9189,2695,4785,2960,0,69,19698
12/16/2023,19,9182,2457,4942,3106,0,68,19755
12/16/2023,20,9185,2264,4803,3019,0,68,19339
12/16/2023,21,9176,1845,4291,3213,0,71,18596
12/16/2023,22,9174,1492,3896,3547,0,27,18136
12/16/2023,23,9173,799,3902,3636,0,17,17527
12/16/2023,24,9176,442,3626,3849,0,17,17110
12/17/2023,1,9180,184,3833,3919,0,17,17133
12/17/2023,2,9185,143,3469,4051,0,17,16865
12/17/2023,3,9184,143,3158,4001,0,17,16503
12/17/2023,4,9182,144,3200,3977,0,16,16519
12/17/2023,5,9184,145,3282,3957,0,16,16584
12/17/2023,6,9188,144,3459,3887,0,17,16695
12/17/2023,7,9185,144,3356,3898,0,17,16600
12/17/2023,8,9182,137,3825,3725,0,17,16886
12/17/2023,9,9182,238,4146,3659,2,17,17244
12/17/2023,10,9182,409,4291,3762,9,17,17670
12/17/2023,11,9182,547,4565,3845,16,20,18175
12/17/2023,12,9181,700,4690,3711,21,27,18330
12/17/2023,13,9177,1089,4772,3499,16,28,18581
12/17/2023,14,9177,1513,4789,3539,12,24,19054
12/17/2023,15,9174,1879,4420,3721,7,37,19238
12/17/2023,16,9180,2264,4055,3538,2,65,19104
12/17/2023,17,9175,2719,4816,3133,0,68,19911
12/17/2023,18,9182,3248,5245,2770,0,68,20513
12/17/2023,19,9187,3476,5122,2373,0,67,20225
12/17/2023,20,9187,3241,4980,2193,0,66,19667
12/17/2023,21,9219,2966,4775,1995,0,68,19023
12/17/2023,22,9387,2690,4145,1862,0,68,18152
12/17/2023,23,9368,2041,4141,1782,0,29,17361
12/17/2023,24,9362,1096,4284,1606,0,17,16365
12/18/2023,1,9363,997,4130,1469,0,17,15976
12/18/2023,2,9361,635,3951,1304,0,17,15268
12/18/2023,3,9370,569,4015,1012,0,17,14983
12/18/2023,4,9427,569,3848,1157,0,17,15018
12/18/2023,5,9481,779,3251,1321,0,17,14849
12/18/2023,6,9614,1466,3239,952,0,17,15288
12/18/2023,7,9624,2253,3428,1625,0,17,16947
12/18/2023,8,9612,2662,3977,1814,0,30,18095
12/18/2023,9,9641,3166,4121,1898,2,63,18891
12/18/2023,10,9704,3027,4093,2089,12,83,19008
12/18/2023,11,9692,3452,3897,2376,23,88,19528
12/18/2023,12,9688,3567,3633,2941,32,94,19955
12/18/2023,13,9688,3014,3659,3330,34,92,19817
12/18/2023,14,9683,2760,3724,3576,40,92,19875
12/18/2023,15,9678,2906,3654,3701,31,91,20061
12/18/2023,16,9681,2518,3916,3868,11,98,20092
12/18/2023,17,9683,2761,4429,3994,1,106,20974
12/18/2023,18,9688,3139,4453,4225,0,109,21614
12/18/2023,19,9708,2835,4480,4288,0,99,21410
12/18/2023,20,9722,2678,4191,4243,0,99,20933
12/18/2023,21,9719,2470,3967,4310,0,102,20568
12/18/2023,22,9717,2458,3749,4206,0,59,20189
12/18/2023,23,9709,1528,3590,4148,0,48,19023
12/18/2023,24,9707,820,3406,4010,0,41,17984
12/19/2023,1,9694,311,3823,4063,0,35,17926
12/19/2023,2,9703,296,3927,4011,0,31,17968
12/19/2023,3,9708,417,3821,3948,0,29,17923
12/19/2023,4,9710,749,3681,3826,0,33,17999
12/19/2023,5,9740,1379,3351,3540,0,32,18042
12/19/2023,6,9762,2171,3272,3459,0,33,18697
12/19/2023,7,9756,2580,4065,3223,0,58,19682
12/19/2023,8,9761,3758,4472,2958,0,71,21020
12/19/2023,9,9761,3576,4619,2571,2,80,20609
12/19/2023,10,9821,4198,4544,2070,22,81,20736
12/19/2023,11,9817,4693,4504,1666,52,88,20820
12/19/2023,12,9822,4483,4183,1640,132,71,20331
12/19/2023,13,9842,3577,4335,1769,213,72,19808
12/19/2023,14,9843,3421,4360,1583,226,71,19504
12/19/2023,15,9844,3439,4691,1360,116,71,19521
12/19/2023,16,9851,3690,5116,1335,44,71,20107
12/19/2023,17,9846,4706,5310,1363,8,70,21303
12/19/2023,18,9844,5126,5291,1673,0,72,22006
12/19/2023,19,9857,4529,5236,2107,0,71,21800
12/19/2023,20,9856,4453,5174,2361,0,72,21916
12/19/2023,21,9853,3990,4928,2749,0,70,21590
12/19/2023,22,9867,3527,4549,3112,0,31,21086
12/19/2023,23,9907,2665,4124,3204,0,17,19917
12/19/2023,24,9892,1710,4150,3217,0,17,18986
12/20/2023,1,9897,1304,4090,3145,0,17,18453
12/20/2023,2,9890,1279,3874,3011,0,17,18071
12/20/2023,3,9886,1442,3906,2844,0,17,18095
12/20/2023,4,9895,1767,3582,2566,0,17,17827
12/20/2023,5,9894,2212,3783,2435,0,16,18340
12/20/2023,6,9896,2772,3851,2295,0,16,18830
12/20/2023,7,9895,3257,4384,2147,0,38,19721
12/20/2023,8,9895,4200,4671,2022,0,66,20854
12/20/2023,9,9889,4528,4902,1779,16,70,21184
12/20/2023,10,9885,4382,4952,1219,88,70,20596
12/20/2023,11,9893,4571,4829,928,104,70,20395
12/20/2023,12,9900,4649,4529,622,152,70,19922
12/20/2023,13,9900,4361,4682,413,173,70,19599
12/20/2023,14,9895,4446,4766,254,135,70,19566
12/20/2023,15,9899,4392,4834,201,68,70,19464
12/20/2023,16,9898,4729,5099,218,28,70,20042
12/20/2023,17,9922,4695,5227,240,3,70,20157
12/20/2023,18,9910,4828,5279,295,0,70,20382
12/20/2023,19,9914,5063,5263,308,0,73,20621
12/20/2023,20,9918,4992,5305,349,0,72,20636
12/20/2023,21,9918,5128,5107,495,0,70,20718
12/20/2023,22,9916,4989,4626,604,0,70,20205
12/20/2023,23,9912,4382,4334,636,0,30,19294
12/20/2023,24,9917,3307,4303,756,0,17,18300
12/21/2023,1,9919,2852,4175,870,0,17,17833
12/21/2023,2,9920,2269,3837,968,0,17,17011
12/21/2023,3,9918,2230,3836,1185,0,17,17186
12/21/2023,4,9918,2443,3563,1309,0,17,17250
12/21/2023,5,9927,2709,3822,1436,0,17,17911
12/21/2023,6,9923,3011,3877,1542,0,17,18370
12/21/2023,7,9921,3542,4539,1684,0,17,19703
12/21/2023,8,9921,4024,4944,1882,0,17,20788
12/21/2023,9,9917,4216,4929,2022,32,17,21133
12/21/2023,10,9913,3812,4826,2137,103,17,20808
12/21/2023,11,9908,3291,4708,2108,183,14,20212
12/21/2023,12,9891,3133,4387,2041,233,10,19695
12/21/2023,13,9886,3131,4300,2002,282,10,19611
12/21/2023,14,9793,3243,4612,1885,267,9,19809
12/21/2023,15,9638,3338,4628,1766,168,0,19538
12/21/2023,16,9569,3783,5244,1696,74,22,20388
12/21/2023,17,9537,4214,5662,1754,4,58,21229
12/21/2023,18,9534,4445,5627,1723,0,78,21407
12/21/2023,19,9542,4670,5614,1650,0,76,21552
12/21/2023,20,9550,5092,5299,1656,0,56,21653
12/21/2023,21,9536,5494,5050,1675,0,51,21806
12/21/2023,22,9540,5187,4560,1647,0,52,20986
12/21/2023,23,9533,4486,4229,1629,0,52,19929
12/21/2023,24,9567,3728,4187,1544,0,14,19040
12/22/2023,1,9565,3383,4094,1323,0,0,18365
12/22/2023,2,9575,3313,3926,1263,0,0,18077
12/22/2023,3,9580,3151,3868,1283,0,0,17882
12/22/2023,4,9588,2986,3892,1234,0,0,17700
12/22/2023,5,9599,3087,3920,1072,0,0,17678
12/22/2023,6,9601,3721,4034,978,0,9,18343
12/22/2023,7,9606,4011,4539,943,0,40,19139
12/22/2023,8,9605,4610,5106,983,0,56,20360
12/22/2023,9,9600,4885,5223,926,28,74,20736
12/22/2023,10,9607,5370,5111,827,103,71,21089
12/22/2023,11,9605,5392,5046,819,175,76,21113
12/22/2023,12,9597,5372,5149,736,204,57,21115
12/22/2023,13,9600,5251,5136,605,194,54,20840
12/22/2023,14,9602,5415,4969,612,154,54,20806
12/22/2023,15,9605,5274,5035,716,75,54,20759
12/22/2023,16,9686,4964,5275,683,31,60,20699
12/22/2023,17,9700,5165,5420,843,1,74,21203
12/22/2023,18,9701,5097,5381,956,0,75,21210
12/22/2023,19,9704,5251,5256,1048,0,74,21333
12/22/2023,20,9702,5194,5223,1166,0,65,21350
12/22/2023,21,9704,5134,5286,1203,0,54,21381
12/22/2023,22,9703,4712,4611,1120,0,53,20199
12/22/2023,23,9714,4184,4412,1066,0,8,19384
12/22/2023,24,9716,3198,4387,957,0,0,18258
12/23/2023,1,9712,2485,4380,818,0,0,17395
12/23/2023,2,9718,2288,4188,736,0,1,16931
12/23/2023,3,9716,1720,4030,761,0,17,16244
12/23/2023,4,9717,1567,4033,788,0,21,16126
12/23/2023,5,9705,1731,4037,935,0,20,16428
12/23/2023,6,9706,1874,3725,1236,0,17,16558
12/23/2023,7,9715,2239,3547,1361,0,17,16879
12/23/2023,8,9708,2252,4207,1381,0,17,17565
12/23/2023,9,9711,2719,4643,1306,3,17,18399
12/23/2023,10,9711,3688,4627,1181,11,17,19235
12/23/2023,11,9709,4252,4500,1041,29,17,19548
12/23/2023,12,9708,4351,4635,976,32,17,19719
12/23/2023,13,9704,4319,4789,762,26,17,19617
12/23/2023,14,9706,4175,4697,540,19,17,19154
12/23/2023,15,9703,4116,4925,374,11,27,19156
12/23/2023,16,9708,4140,5165,263,5,59,19340
12/23/2023,17,9710,4101,5351,201,1,68,19432
12/23/2023,18,9713,4142,5291,185,0,76,19407
12/23/2023,19,9706,3999,5280,190,0,81,19256
12/23/2023,20,9705,3875,5111,243,0,89,19023
12/23/2023,21,9707,3746,5060,270,0,46,18829
12/23/2023,22,9703,4013,4531,256,0,24,18527
12/23/2023,23,9710,3283,4348,203,0,28,17572
12/23/2023,24,9712,2566,4068,189,0,32,16567
12/24/2023,1,9706,2117,4042,197,0,31,16093
12/24/2023,2,9712,1592,4098,167,0,19,15588
12/24/2023,3,9706,1633,3974,170,0,17,15500
12/24/2023,4,9707,1099,3953,167,0,17,14943
12/24/2023,5,9707,1033,3885,181,0,17,14823
12/24/2023,6,9701,1235,4025,187,0,17,15165
12/24/2023,7,9704,1592,4200,205,0,17,15718
12/24/2023,8,9704,1840,4623,292,0,17,16476
12/24/2023,9,9701,1796,4810,351,1,17,16676
12/24/2023,10,9699,2357,4752,448,15,17,17288
12/24/2023,11,9702,2787,4752,490,28,18,17777
12/24/2023,12,9707,3167,4966,424,38,17,18319
12/24/2023,13,9710,3308,5003,449,39,17,18526
12/24/2023,14,9707,3274,4668,446,40,17,18152
12/24/2023,15,9700,3122,4762,417,26,29,18056
12/24/2023,16,9703,3039,4739,465,9,63,18018
12/24/2023,17,9704,2828,4921,557,0,69,18079
12/24/2023,18,9702,2447,5173,691,0,69,18082
12/24/2023,19,9705,2370,5200,846,0,68,18189
12/24/2023,20,9702,2370,5162,1015,0,69,18318
12/24/2023,21,9696,2325,4883,1101,0,28,18033
12/24/2023,22,9700,1804,4588,1235,0,17,17344
12/24/2023,23,9701,1603,4298,1266,0,17,16885
12/24/2023,24,9701,1095,4148,1256,0,17,16217
12/25/2023,1,9701,976,3578,1253,0,17,15525
12/25/2023,2,9702,819,3552,1097,0,17,15187
12/25/2023,3,9698,397,3665,1163,0,17,14940
12/25/2023,4,9700,174,3596,1117,0,17,14604
12/25/2023,5,9703,341,3121,1270,0,17,14452
12/25/2023,6,9702,535,3068,1399,0,17,14721
12/25/2023,7,9702,586,3271,1553,0,17,15129
12/25/2023,8,9704,551,3409,1757,0,17,15438
12/25/2023,9,9703,551,3995,1822,11,17,16099
12/25/2023,10,9700,666,4255,1770,36,17,16444
12/25/2023,11,9696,933,4592,1572,60,17,16870
12/25/2023,12,9703,1263,4547,1429,99,17,17058
12/25/2023,13,9707,1235,4510,1253,108,17,16830
12/25/2023,14,9680,1204,4486,1145,130,17,16662
12/25/2023,15,9697,1477,4518,1212,107,17,17028
12/25/2023,16,9705,1469,4624,1459,40,17,17314
12/25/2023,17,9708,1266,5117,1803,3,17,17914
12/25/2023,18,9701,1175,5068,2120,0,17,18081
12/25/2023,19,9706,1178,4217,2383,0,17,17501
12/25/2023,20,9703,1177,3829,2553,0,17,17279
12/25/2023,21,9703,786,3800,2603,0,16,16908
12/25/2023,22,9701,556,4075,2558,0,16,16906
12/25/2023,23,9705,557,3836,2567,0,16,16681
12/25/2023,24,9707,556,3515,2364,0,16,16158
12/26/2023,1,9710,237,3768,2165,0,16,15896
12/26/2023,2,9705,139,3444,2154,0,16,15458
12/26/2023,3,9703,252,3122,2259,0,16,15352
12/26/2023,4,9694,452,2737,2376,0,16,15275
12/26/2023,5,9698,772,2798,2370,0,16,15654
12/26/2023,6,9705,1178,2968,2214,0,16,16081
12/26/2023,7,9710,1533,3208,2000,0,16,16467
12/26/2023,8,9700,1606,3921,1821,0,16,17064
12/26/2023,9,9705,1613,4273,1663,9,16,17279
12/26/2023,10,9696,1625,4137,1509,29,17,17013
12/26/2023,11,9696,1665,4592,1260,51,17,17281
12/26/2023,12,9699,1972,4661,1025,71,17,17445
12/26/2023,13,9697,2452,4629,834,102,16,17730
12/26/2023,14,9737,2619,4570,642,79,16,17663
12/26/2023,15,9798,2612,4670,574,51,16,17721
12/26/2023,16,9796,2879,5103,487,22,16,18303
12/26/2023,17,9794,3355,5291,566,1,16,19023
12/26/2023,18,9796,3422,5482,630,0,16,19346
12/26/2023,19,9792,3378,5311,565,0,16,19062
12/26/2023,20,9796,3109,5101,545,0,16,18567
12/26/2023,21,9799,3043,4713,634,0,16,18205
12/26/2023,22,9791,3008,4430,643,0,16,17888
12/26/2023,23,9760,2455,4195,617,0,16,17043
12/26/2023,24,9762,2094,3780,570,0,16,16222
12/27/2023,1,9767,1521,3802,513,0,16,15619
12/27/2023,2,9809,1226,3603,403,0,16,15057
12/27/2023,3,9813,1175,3258,372,0,16,14634
12/27/2023,4,9824,869,3419,428,0,16,14556
12/27/2023,5,9839,810,3471,320,0,16,14456
12/27/2023,6,9831,1236,3933,278,0,16,15294
12/27/2023,7,9824,1754,4375,399,0,16,16368
12/27/2023,8,9829,2248,4731,509,0,17,17334
12/27/2023,9,9826,2371,5121,565,0,16,17899
12/27/2023,10,9824,2396,5130,662,7,16,18035
12/27/2023,11,9832,2751,5008,669,16,16,18292
12/27/2023,12,9836,3455,4796,574,18,16,18695
12/27/2023,13,9834,3984,4774,544,23,16,19175
12/27/2023,14,9834,3425,4597,751,18,16,18641
12/27/2023,15,9833,3208,4582,902,16,16,18557
12/27/2023,16,9821,3240,5038,627,8,16,18750
12/27/2023,17,9809,3987,5435,573,1,16,19821
12/27/2023,18,9803,4402,5575,555,0,17,20352
12/27/2023,19,9808,4164,5423,517,0,16,19928
12/27/2023,20,9811,3621,5322,653,0,17,19424
12/27/2023,21,9809,3062,5004,705,0,16,18596
12/27/2023,22,9802,2751,4686,724,0,16,17979
12/27/2023,23,9792,1987,4391,689,0,18,16877
12/27/2023,24,9810,1553,4115,653,0,18,16149
12/28/2023,1,9811,1081,4134,609,0,16,15651
12/28/2023,2,9804,909,4071,683,0,16,15483
12/28/2023,3,9808,537,4155,624,0,16,15140
12/28/2023,4,9816,722,4154,528,0,16,15236
12/28/2023,5,9814,1094,3992,431,0,16,15347
12/28/2023,6,9808,1586,3793,403,0,16,15606
12/28/2023,7,9816,2139,3868,422,0,17,16262
12/28/2023,8,9819,2570,4349,407,0,39,17184
12/28/2023,9,9814,2871,4701,368,2,41,17797
12/28/2023,10,9807,2933,4863,384,16,30,18033
12/28/2023,11,9919,3077,5057,403,31,29,18516
12/28/2023,12,9952,3434,4884,374,39,35,18718
12/28/2023,13,9944,3726,4934,304,37,34,18979
12/28/2023,14,9940,3832,4776,271,31,36,18886
12/28/2023,15,9943,3862,4789,264,23,37,18918
12/28/2023,16,9949,3785,4907,407,11,36,19095
12/28/2023,17,9947,3675,5485,500,0,36,19643
12/28/2023,18,9942,4216,5528,574,0,37,20297
12/28/2023,19,9947,3914,5369,597,0,31,19858
12/28/2023,20,9953,3402,5198,652,0,18,19223
12/28/2023,21,9949,3467,4930,774,0,16,19136
12/28/2023,22,9517,2662,4939,833,0,16,17967
12/28/2023,23,9428,2300,4138,998,0,18,16882
12/28/2023,24,9429,1643,3699,1044,0,17,15832
12/29/2023,1,9429,1292,3766,1024,0,16,15527
12/29/2023,2,9423,1155,3697,818,0,16,15109
12/29/2023,3,9426,1129,3485,699,0,16,14755
12/29/2023,4,9425,1133,3418,682,0,16,14674
12/29/2023,5,9405,1235,3367,640,0,16,14663
12/29/2023,6,9406,1579,3482,636,0,16,15119
12/29/2023,7,9401,2026,4097,753,0,20,16297
12/29/2023,8,9400,2327,4620,793,0,28,17168
12/29/2023,9,9401,2784,4929,732,20,31,17897
12/29/2023,10,9397,2742,4888,712,67,28,17834
12/29/2023,11,9404,3015,4854,677,116,36,18102
12/29/2023,12,9392,3233,4675,702,143,37,18182
12/29/2023,13,9392,3289,4794,725,126,38,18364
12/29/2023,14,9395,3331,4747,795,104,40,18412
12/29/2023,15,9450,3177,4707,921,86,39,18380
12/29/2023,16,9458,3109,4924,941,24,48,18504
12/29/2023,17,9461,3572,5122,892,4,72,19123
12/29/2023,18,9455,4159,5284,916,0,89,19903
12/29/2023,19,9464,3807,5182,1153,0,89,19695
12/29/2023,20,9460,3158,4977,1303,0,75,18973
12/29/2023,21,9466,3038,4638,1249,0,68,18459
12/29/2023,22,9459,2455,4701,1076,0,67,17758
12/29/2023,23,9467,2200,4273,1119,0,68,17127
12/29/2023,24,9469,2462,3939,875,0,28,16773
12/30/2023,1,9471,2033,3896,824,0,16,16240
12/30/2023,2,9466,1233,3993,847,0,16,15555
12/30/2023,3,9465,799,3681,858,0,16,14819
12/30/2023,4,9470,743,3705,800,0,16,14734
12/30/2023,5,9471,986,3876,706,0,16,15055
12/30/2023,6,9466,1208,3966,674,0,16,15330
12/30/2023,7,9471,1547,4048,543,0,16,15625
12/30/2023,8,9476,1712,4566,476,0,16,16246
12/30/2023,9,9475,1761,5104,418,4,16,16778
12/30/2023,10,9463,2250,5135,410,16,16,17290
12/30/2023,11,9465,2723,5164,482,25,17,17876
12/30/2023,12,9468,2837,5171,479,37,32,18024
12/30/2023,13,9475,2980,5328,458,36,34,18311
12/30/2023,14,9472,3067,5024,418,39,34,18054
12/30/2023,15,9471,3001,5095,398,29,34,18028
12/30/2023,16,9482,3159,5110,328,12,44,18135
12/30/2023,17,9472,3797,5502,257,2,72,19102
12/30/2023,18,9475,4004,5723,212,0,69,19483
12/30/2023,19,9479,4015,5521,187,0,70,19272
12/30/2023,20,9479,4040,5386,191,0,71,19167
12/30/2023,21,9478,3706,5303,268,0,70,18825
12/30/2023,22,9483,3517,4709,343,0,70,18122
12/30/2023,23,9474,3070,4577,395,0,70,17586
12/30/2023,24,9478,2939,4184,411,0,69,17081
12/31/2023,1,9476,2834,3886,453,0,27,16676
12/31/2023,2,9473,2653,3755,385,0,16,16282
12/31/2023,3,9477,2180,3715,375,0,16,15763
12/31/2023,4,9475,1854,3659,247,0,16,15251
12/31/2023,5,9474,1852,3716,215,0,16,15273
12/31/2023,6,9472,1930,3798,235,0,16,15451
12/31/2023,7,9477,1683,4168,329,0,17,15674
12/31/2023,8,9476,1723,4666,381,0,29,16275
12/31/2023,9,9475,2126,4856,390,3,32,16882
12/31/2023,10,9476,2444,5013,450,15,20,17418
12/31/2023,11,9472,2794,5149,517,36,23,17991
12/31/2023,12,9476,3296,5050,440,86,33,18381
12/31/2023,13,9478,3988,4832,364,69,21,18752
12/31/2023,14,9477,4459,4638,336,84,41,19035
12/31/2023,15,9476,4528,4699,345,47,68,19163
12/31/2023,16,9477,4417,4777,304,13,69,19057
12/31/2023,17,9478,4264,5327,329,0,69,19467
12/31/2023,18,9479,4459,5381,344,0,69,19732
12/31/2023,19,9479,4601,5421,376,0,69,19946
12/31/2023,20,9480,4421,5364,429,0,69,19763
12/31/2023,21,9472,4123,4918,512,0,69,19094
12/31/2023,22,9473,3690,4478,515,0,27,18183
12/31/2023,23,9473,3304,4417,528,0,16,17738
12/31/2023,24,9469,3080,4168,557,0,16,17290
