Date,Hour,NUCLEAR,GAS,HYDRO,WIND,SOLAR,BIOFUEL,Total Output
1/1/2020,1,11633,232,2948,1717,0,17,16547
1/1/2020,2,11637,231,2909,1382,0,14,16173
1/1/2020,3,11638,233,2880,1263,0,13,16027
1/1/2020,4,11632,233,2850,1184,0,13,15912
1/1/2020,5,11627,231,2950,1202,0,13,16023
1/1/2020,6,11636,233,2960,1248,0,14,16091
1/1/2020,7,11639,235,3143,1236,0,15,16268
1/1/2020,8,11633,443,3303,1044,0,16,16439
1/1/2020,9,11637,481,3410,990,4,14,16536
1/1/2020,10,11632,454,3375,1358,22,14,16855
1/1/2020,11,11637,434,3423,1713,46,13,17266
1/1/2020,12,11635,405,3372,1968,58,13,17451
1/1/2020,13,11639,374,3412,2195,59,13,17692
1/1/2020,14,11639,366,3349,2273,58,14,17699
1/1/2020,15,11644,355,3372,2249,78,13,17711
1/1/2020,16,11681,355,3372,1702,63,14,17187
1/1/2020,17,11679,270,3533,2157,13,15,17667
1/1/2020,18,11681,237,3765,2856,0,14,18553
1/1/2020,19,11678,236,3638,2952,0,15,18519
1/1/2020,20,11680,236,3559,2809,0,14,18298
1/1/2020,21,11674,235,3463,2852,0,14,18238
1/1/2020,22,11681,235,3436,3196,0,13,18561
1/1/2020,23,11678,236,3325,2740,0,13,17992
1/1/2020,24,11674,235,3086,2112,0,14,17121
1/2/2020,1,11679,235,3098,1378,0,14,16404
1/2/2020,2,11675,235,3055,1468,0,14,16447
1/2/2020,3,11674,234,3054,1138,0,14,16114
1/2/2020,4,11683,234,3046,950,0,14,15927
1/2/2020,5,11688,234,3119,1038,0,15,16094
1/2/2020,6,11682,233,3258,1387,0,18,16578
1/2/2020,7,11685,235,3385,2207,0,25,17537
1/2/2020,8,11690,235,3668,3371,1,43,19008
1/2/2020,9,11689,379,3734,3609,23,43,19477
1/2/2020,10,11683,504,3706,3477,100,36,19506
1/2/2020,11,11668,405,3721,3040,154,49,19037
1/2/2020,12,11687,499,3682,2903,171,49,18991
1/2/2020,13,11689,406,3766,2536,174,51,18622
1/2/2020,14,11690,502,3668,3139,87,53,19139
1/2/2020,15,11691,404,3704,3186,58,49,19092
1/2/2020,16,11691,501,3810,3017,25,40,19084
1/2/2020,17,11684,301,3770,3223,7,35,19020
1/2/2020,18,11681,272,4089,3546,0,35,19623
1/2/2020,19,11682,238,4084,3599,0,35,19638
1/2/2020,20,11678,233,3986,3497,0,35,19429
1/2/2020,21,11677,233,3712,3346,0,35,19003
1/2/2020,22,11673,233,3706,2945,0,34,18591
1/2/2020,23,11682,232,3520,2748,0,34,18216
1/2/2020,24,11689,232,3165,2162,0,27,17275
1/3/2020,1,11681,230,3003,1462,0,21,16397
1/3/2020,2,11683,235,3042,1208,0,18,16186
1/3/2020,3,11679,234,3091,851,0,18,15873
1/3/2020,4,11681,272,3069,928,0,18,15968
1/3/2020,5,11691,287,3190,1243,0,18,16429
1/3/2020,6,11693,340,3303,1294,0,18,16648
1/3/2020,7,11692,338,3387,1178,0,25,16620
1/3/2020,8,11691,367,4033,1087,0,33,17211
1/3/2020,9,11690,540,4530,1020,3,40,17823
1/3/2020,10,11697,612,4397,845,14,39,17604
1/3/2020,11,11713,900,4750,662,22,37,18084
1/3/2020,12,11717,944,4483,623,34,34,17835
1/3/2020,13,11729,1092,4576,602,33,34,18066
1/3/2020,14,11744,1276,4658,520,44,34,18276
1/3/2020,15,11749,1200,4660,461,39,34,18143
1/3/2020,16,11761,1354,4708,424,18,34,18299
1/3/2020,17,11767,1432,5137,360,2,34,18732
1/3/2020,18,11775,1529,5675,326,0,34,19339
1/3/2020,19,11786,1421,5562,313,0,35,19117
1/3/2020,20,11790,1396,5314,335,0,36,18871
1/3/2020,21,11783,1160,4942,316,0,36,18237
1/3/2020,22,11824,802,4769,343,0,36,17774
1/3/2020,23,11819,591,4309,322,0,35,17076
1/3/2020,24,11839,434,3607,270,0,21,16171
1/4/2020,1,11863,272,3592,278,0,1,16006
1/4/2020,2,11893,236,3380,402,0,0,15911
1/4/2020,3,11909,236,3060,314,0,0,15519
1/4/2020,4,11908,236,3225,241,0,0,15610
1/4/2020,5,11931,236,3258,188,0,0,15613
1/4/2020,6,11949,244,3653,250,0,0,16096
1/4/2020,7,11956,236,3673,307,0,0,16172
1/4/2020,8,11964,236,4137,289,0,0,16626
1/4/2020,9,11958,333,4370,337,2,0,17000
1/4/2020,10,11958,384,4934,302,6,0,17584
1/4/2020,11,11951,543,5106,436,17,0,18053
1/4/2020,12,11948,507,4747,689,26,0,17917
1/4/2020,13,11947,544,4499,961,38,0,17989
1/4/2020,14,11952,588,4620,1109,61,0,18330
1/4/2020,15,11954,308,4049,1281,35,0,17627
1/4/2020,16,11950,308,4017,1407,15,0,17697
1/4/2020,17,11952,428,4303,1843,1,0,18527
1/4/2020,18,11953,431,4996,2038,0,0,19418
1/4/2020,19,11962,431,4736,2375,0,0,19504
1/4/2020,20,11959,433,4704,2286,0,0,19382
1/4/2020,21,11958,304,4495,2186,0,0,18943
1/4/2020,22,11959,306,3979,2415,0,0,18659
1/4/2020,23,11961,237,3398,2229,0,0,17825
1/4/2020,24,11927,237,3064,1822,0,0,17050
1/5/2020,1,11960,235,3013,1753,0,0,16961
1/5/2020,2,11963,238,2989,1885,0,0,17075
1/5/2020,3,11967,238,3000,1555,0,0,16760
1/5/2020,4,11972,238,3013,1902,0,0,17125
1/5/2020,5,11969,238,3058,1614,0,0,16879
1/5/2020,6,11956,238,3112,1796,0,0,17102
1/5/2020,7,11964,238,3248,1464,0,0,16914
1/5/2020,8,11962,238,3431,1125,2,3,16761
1/5/2020,9,11966,352,3672,995,12,2,16999
1/5/2020,10,11964,482,3785,1182,48,0,17461
1/5/2020,11,11960,373,3896,1348,87,0,17664
1/5/2020,12,11955,363,3950,1485,91,0,17844
1/5/2020,13,11949,527,3934,1668,176,0,18254
1/5/2020,14,11953,459,4028,1878,150,0,18468
1/5/2020,15,11965,541,4158,1995,82,0,18741
1/5/2020,16,11927,704,3957,2305,47,0,18940
1/5/2020,17,11959,756,4432,1983,6,0,19136
1/5/2020,18,11968,639,5234,2364,0,0,20205
1/5/2020,19,11973,627,5071,2428,0,0,20099
1/5/2020,20,11973,626,4787,2756,0,0,20142
1/5/2020,21,11964,465,4580,3051,0,0,20060
1/5/2020,22,11964,437,3852,3026,0,0,19279
1/5/2020,23,11964,437,3480,2595,0,0,18476
1/5/2020,24,11978,437,3102,2735,0,0,18252
1/6/2020,1,11977,265,3006,2892,0,5,18145
1/6/2020,2,11984,236,3037,2668,0,14,17939
1/6/2020,3,11983,236,3011,2358,0,16,17604
1/6/2020,4,11983,236,2974,2503,0,17,17713
1/6/2020,5,11982,235,2997,2616,0,17,17847
1/6/2020,6,11974,235,3061,2572,0,23,17865
1/6/2020,7,11974,237,3251,3002,0,31,18495
1/6/2020,8,11976,238,4108,3638,1,50,20011
1/6/2020,9,11968,351,4159,3543,10,52,20083
1/6/2020,10,11966,358,3915,3726,42,52,20059
1/6/2020,11,11963,358,3940,3663,84,53,20061
1/6/2020,12,11972,356,3720,3468,133,53,19702
1/6/2020,13,11966,214,3742,3348,191,52,19513
1/6/2020,14,11972,199,3797,3401,192,52,19613
1/6/2020,15,11966,199,3904,3163,159,52,19443
1/6/2020,16,11961,200,4432,2905,79,52,19629
1/6/2020,17,11978,200,4602,3798,19,44,20641
1/6/2020,18,11978,234,5481,4172,0,35,21900
1/6/2020,19,12014,235,4884,4066,0,35,21234
1/6/2020,20,12021,235,4962,3888,0,35,21141
1/6/2020,21,12014,236,4232,3446,0,34,19962
1/6/2020,22,12005,237,4219,3202,0,34,19697
1/6/2020,23,12018,237,3654,2713,0,34,18656
1/6/2020,24,12064,237,3311,2216,0,21,17849
1/7/2020,1,12073,238,3075,1714,0,16,17116
1/7/2020,2,12081,236,3062,1605,0,18,17002
1/7/2020,3,12105,239,3086,1069,0,18,16517
1/7/2020,4,12110,238,3271,930,0,17,16566
1/7/2020,5,12110,238,3247,857,0,18,16470
1/7/2020,6,12110,237,3580,1022,0,21,16970
1/7/2020,7,12099,240,4275,989,0,28,17631
1/7/2020,8,12110,411,5302,1126,2,35,18986
1/7/2020,9,12111,420,5248,1335,17,35,19166
1/7/2020,10,12113,439,4886,1478,65,37,19018
1/7/2020,11,12114,630,4665,1388,107,37,18941
1/7/2020,12,12105,699,4605,1380,117,36,18942
1/7/2020,13,12087,773,4046,1514,147,35,18602
1/7/2020,14,12088,879,3886,1448,176,34,18511
1/7/2020,15,12085,1020,4009,1470,121,35,18740
1/7/2020,16,12085,1248,4282,1520,64,34,19233
1/7/2020,17,12096,1263,4618,1757,14,35,19783
1/7/2020,18,12099,964,4914,2947,0,35,20959
1/7/2020,19,12104,756,4971,2962,0,35,20828
1/7/2020,20,12108,599,4818,3400,0,35,20960
1/7/2020,21,12106,565,4668,3191,0,35,20565
1/7/2020,22,12117,568,4220,3005,0,35,19945
1/7/2020,23,12119,409,3634,2800,0,35,18997
1/7/2020,24,12133,377,3202,2843,0,24,18579
1/8/2020,1,12147,379,3087,2598,0,19,18230
1/8/2020,2,12160,379,3054,1769,0,18,17380
1/8/2020,3,12192,381,3036,2093,0,17,17719
1/8/2020,4,12189,381,3022,2280,0,18,17890
1/8/2020,5,12181,382,3227,2388,0,19,18197
1/8/2020,6,12200,382,3309,2399,0,18,18308
1/8/2020,7,12199,377,3456,2668,0,23,18723
1/8/2020,8,12204,546,4168,3417,2,30,20367
1/8/2020,9,12198,729,3852,3525,18,33,20355
1/8/2020,10,12194,785,3774,3576,90,33,20452
1/8/2020,11,12189,1080,3865,3171,162,33,20500
1/8/2020,12,12191,1126,3782,2874,160,36,20169
1/8/2020,13,12195,956,3904,3003,222,42,20322
1/8/2020,14,12198,1038,3971,2708,218,46,20179
1/8/2020,15,12202,1347,4140,1937,135,47,19808
1/8/2020,16,12204,1442,4613,2094,77,67,20497
1/8/2020,17,12199,1410,4857,2514,14,88,21082
1/8/2020,18,12200,1068,5770,2581,0,85,21704
1/8/2020,19,12204,1159,6288,2075,0,126,21852
1/8/2020,20,12204,1122,6413,1542,0,198,21479
1/8/2020,21,12198,1180,6117,1178,0,189,20862
1/8/2020,22,12191,971,5811,702,0,123,19798
1/8/2020,23,12190,642,5652,423,0,108,19015
1/8/2020,24,12192,609,5139,429,0,102,18471
1/9/2020,1,12197,560,4702,499,0,79,18037
1/9/2020,2,12200,561,4809,508,0,82,18160
1/9/2020,3,12196,561,4737,509,0,72,18075
1/9/2020,4,12191,561,4755,683,0,73,18263
1/9/2020,5,12203,568,5010,870,0,75,18726
1/9/2020,6,12200,512,4424,1340,0,81,18557
1/9/2020,7,12203,510,4439,1993,0,86,19231
1/9/2020,8,12207,684,4825,2471,1,89,20277
1/9/2020,9,12205,761,4744,2823,40,89,20662
1/9/2020,10,12205,897,4508,2543,124,89,20366
1/9/2020,11,12198,956,4297,2750,215,90,20506
1/9/2020,12,12208,728,3958,2980,188,51,20113
1/9/2020,13,12201,560,4020,3199,178,36,20194
1/9/2020,14,12197,696,4215,3506,153,35,20802
1/9/2020,15,12198,745,4779,3418,84,34,21258
1/9/2020,16,12191,950,4596,3481,43,34,21295
1/9/2020,17,12187,1015,4705,3626,9,34,21576
1/9/2020,18,12180,522,5349,3711,0,34,21796
1/9/2020,19,12188,529,5349,3614,0,35,21715
1/9/2020,20,12193,401,5333,3753,0,36,21716
1/9/2020,21,12183,380,4773,3950,0,37,21323
1/9/2020,22,12185,368,3765,4045,0,36,20399
1/9/2020,23,11672,367,3313,3926,0,36,19314
1/9/2020,24,11685,366,3110,3319,0,27,18507
1/10/2020,1,11694,365,2985,3163,0,19,18226
1/10/2020,2,11699,366,2969,2666,0,16,17716
1/10/2020,3,11696,366,2930,2444,0,18,17454
1/10/2020,4,11685,365,2962,2253,0,19,17284
1/10/2020,5,11691,363,2911,2309,0,20,17294
1/10/2020,6,11691,362,3086,2731,0,26,17896
1/10/2020,7,11691,361,3398,3186,0,31,18667
1/10/2020,8,11692,361,3916,3820,0,37,19826
1/10/2020,9,11695,517,4030,3941,1,36,20220
1/10/2020,10,11693,956,3920,3666,4,37,20276
1/10/2020,11,11688,1034,3983,3464,10,37,20216
1/10/2020,12,11684,1101,3958,3469,17,37,20266
1/10/2020,13,11677,1212,3983,2981,19,37,19909
1/10/2020,14,11667,1283,4141,2674,19,38,19822
1/10/2020,15,11672,1221,4175,2246,11,38,19363
1/10/2020,16,11683,724,5058,1730,4,40,19239
1/10/2020,17,11682,791,5747,1438,0,43,19701
1/10/2020,18,11683,809,5779,1158,0,42,19471
1/10/2020,19,11683,578,5345,1138,0,41,18785
1/10/2020,20,11688,423,5234,1279,0,43,18667
1/10/2020,21,11679,424,4851,1445,0,42,18441
1/10/2020,22,11671,326,4864,1333,0,40,18234
1/10/2020,23,11686,278,4309,1302,0,46,17621
1/10/2020,24,11686,161,3234,1401,0,32,16514
1/11/2020,1,11680,146,3044,1449,0,9,16328
1/11/2020,2,11678,146,3045,1508,0,0,16377
1/11/2020,3,11682,149,2987,1891,0,0,16709
1/11/2020,4,11685,149,3067,2044,0,0,16945
1/11/2020,5,11681,162,3150,1804,0,0,16797
1/11/2020,6,11682,169,3180,1903,0,0,16934
1/11/2020,7,11686,183,3240,2173,0,0,17282
1/11/2020,8,11683,311,3602,1995,2,0,17593
1/11/2020,9,11676,511,3705,2389,6,0,18287
1/11/2020,10,11668,663,3845,2773,8,0,18957
1/11/2020,11,11659,676,3880,3017,21,0,19253
1/11/2020,12,11661,679,4367,2533,18,2,19260
1/11/2020,13,11664,678,4702,2121,19,2,19186
1/11/2020,14,11655,686,4771,1904,21,0,19037
1/11/2020,15,11665,541,4697,1976,12,0,18891
1/11/2020,16,11665,609,4389,2270,4,0,18937
1/11/2020,17,11672,367,4372,2349,0,0,18760
1/11/2020,18,11679,343,4806,2628,0,0,19456
1/11/2020,19,11680,344,4895,2596,0,0,19515
1/11/2020,20,11681,341,4647,2383,0,0,19052
1/11/2020,21,11674,340,4544,2170,0,0,18728
1/11/2020,22,11679,341,4176,1968,0,0,18164
1/11/2020,23,11679,340,3782,1775,0,0,17576
1/11/2020,24,11678,343,3511,1718,0,0,17250
1/12/2020,1,11679,341,3442,1453,0,0,16915
1/12/2020,2,11676,345,3470,1695,0,0,17186
1/12/2020,3,11678,342,3405,2056,0,0,17481
1/12/2020,4,11682,324,3335,1797,0,0,17138
1/12/2020,5,11691,323,3433,1831,0,0,17278
1/12/2020,6,11688,320,3500,2131,0,0,17639
1/12/2020,7,11690,325,3948,2003,0,0,17966
1/12/2020,8,11686,571,4572,1745,1,0,18575
1/12/2020,9,11679,617,4510,1658,6,0,18470
1/12/2020,10,11676,624,4709,1433,20,0,18462
1/12/2020,11,11679,774,5317,1023,54,0,18847
1/12/2020,12,11678,844,5036,616,88,0,18262
1/12/2020,13,11677,820,4716,454,98,0,17765
1/12/2020,14,11675,947,5072,359,102,0,18155
1/12/2020,15,11636,1004,5284,192,80,0,18196
1/12/2020,16,11685,1211,4871,117,38,0,17922
1/12/2020,17,11680,1315,5110,106,5,0,18216
1/12/2020,18,11682,1353,5737,121,0,0,18893
1/12/2020,19,11691,1408,5700,169,0,0,18968
1/12/2020,20,11685,1182,5250,232,0,0,18349
1/12/2020,21,11670,1085,5129,347,0,0,18231
1/12/2020,22,11683,976,4752,438,0,0,17849
1/12/2020,23,11668,756,3954,488,0,2,16868
1/12/2020,24,11676,494,3675,474,0,3,16322
1/13/2020,1,11678,480,3474,553,0,9,16194
1/13/2020,2,11679,491,3407,531,0,15,16123
1/13/2020,3,11675,539,3628,406,0,23,16271
1/13/2020,4,10471,872,4322,322,0,23,16010
1/13/2020,5,10289,1427,3868,333,0,22,15939
1/13/2020,6,10285,1613,3833,217,0,13,15961
1/13/2020,7,10430,1861,4688,173,0,22,17174
1/13/2020,8,10788,2374,5279,224,1,27,18693
1/13/2020,9,10795,3060,5334,305,3,27,19524
1/13/2020,10,10798,3139,5220,435,11,29,19632
1/13/2020,11,10793,3101,5119,548,36,43,19640
1/13/2020,12,10783,2938,5074,565,42,46,19448
1/13/2020,13,10784,2646,5066,622,42,41,19201
1/13/2020,14,10789,2996,5057,770,32,51,19695
1/13/2020,15,10788,3235,5151,725,20,64,19983
1/13/2020,16,10594,3529,5374,579,13,95,20184
1/13/2020,17,10491,3443,5725,406,3,145,20213
1/13/2020,18,10494,3223,5931,259,0,155,20062
1/13/2020,19,10494,2893,5744,135,0,140,19406
1/13/2020,20,10502,3050,5740,122,0,133,19547
1/13/2020,21,10497,3118,5490,149,0,130,19384
1/13/2020,22,10495,3084,5173,170,0,122,19044
1/13/2020,23,10490,1851,4597,214,0,80,17232
1/13/2020,24,10488,1154,4006,248,0,66,15962
1/14/2020,1,10516,479,3710,227,0,63,14995
1/14/2020,2,10536,333,3563,363,0,23,14818
1/14/2020,3,10541,347,3396,598,0,12,14894
1/14/2020,4,10537,430,3508,457,0,12,14944
1/14/2020,5,10539,827,3405,594,0,14,15379
1/14/2020,6,10544,1358,3854,521,0,11,16288
1/14/2020,7,10549,1824,4335,1115,0,23,17846
1/14/2020,8,10548,1920,4969,1734,1,27,19199
1/14/2020,9,10543,2207,4973,1566,22,27,19338
1/14/2020,10,10537,2462,4966,1101,78,26,19170
1/14/2020,11,10529,2737,5265,633,85,26,19275
1/14/2020,12,10524,2897,5222,572,51,27,19293
1/14/2020,13,10530,2397,5031,603,138,27,18726
1/14/2020,14,10537,2704,5336,729,108,25,19439
1/14/2020,15,11189,2509,5082,925,25,23,19753
1/14/2020,16,11663,2165,4681,1110,16,19,19654
1/14/2020,17,11676,1976,5187,1552,4,19,20414
1/14/2020,18,11679,1593,5737,1754,0,19,20782
1/14/2020,19,11690,1384,5512,2013,0,19,20618
1/14/2020,20,11682,1156,5013,2130,0,19,20000
1/14/2020,21,11678,632,4932,2360,0,19,19621
1/14/2020,22,11668,488,4526,2336,0,20,19038
1/14/2020,23,11675,367,4298,2254,0,20,18614
1/14/2020,24,11678,331,3681,1922,0,17,17629
1/15/2020,1,11663,330,3290,1125,0,13,16421
1/15/2020,2,11664,336,3238,1255,0,12,16505
1/15/2020,3,11666,344,3111,1243,0,12,16376
1/15/2020,4,11672,422,3163,921,0,12,16190
1/15/2020,5,11680,672,3273,604,0,12,16241
1/15/2020,6,11677,956,3575,579,0,14,16801
1/15/2020,7,11679,1371,3853,370,0,23,17296
1/15/2020,8,11677,1553,4810,335,1,29,18405
1/15/2020,9,11675,1522,4506,339,8,51,18101
1/15/2020,10,11669,1517,4615,264,29,56,18150
1/15/2020,11,11650,1579,5096,177,66,52,18620
1/15/2020,12,11655,1817,5017,130,82,52,18753
1/15/2020,13,11650,2055,4764,141,55,52,18717
1/15/2020,14,11508,2109,4614,227,61,55,18574
1/15/2020,15,11479,1985,4386,149,51,52,18102
1/15/2020,16,11554,1856,4484,393,39,46,18372
1/15/2020,17,11639,1848,4767,175,7,43,18479
1/15/2020,18,11639,1938,5347,412,0,39,19375
1/15/2020,19,11646,1332,5801,566,0,32,19377
1/15/2020,20,11649,1169,5642,411,0,34,18905
1/15/2020,21,11649,1030,5512,304,0,38,18533
1/15/2020,22,11646,736,5028,225,0,42,17677
1/15/2020,23,11640,423,4143,506,0,44,16756
1/15/2020,24,11649,369,3563,630,0,33,16244
1/16/2020,1,11648,367,3211,686,0,16,15928
1/16/2020,2,11673,369,3186,925,0,10,16163
1/16/2020,3,11684,365,3063,1557,0,9,16678
1/16/2020,4,11686,368,3076,2024,0,9,17163
1/16/2020,5,11682,368,3093,2463,0,9,17615
1/16/2020,6,11678,367,3174,2233,0,14,17466
1/16/2020,7,11680,370,3485,2634,0,16,18185
1/16/2020,8,11678,549,4745,2696,0,25,19693
1/16/2020,9,11683,923,4756,2904,4,22,20292
1/16/2020,10,11683,1131,4175,2734,36,22,19781
1/16/2020,11,11683,1014,4152,2850,102,22,19823
1/16/2020,12,11677,871,4106,2985,97,22,19758
1/16/2020,13,11681,992,4000,3064,93,22,19852
1/16/2020,14,11683,947,3930,3067,80,26,19733
1/16/2020,15,11677,997,4026,2924,58,38,19720
1/16/2020,16,11668,1090,4127,2965,48,77,19975
1/16/2020,17,11667,1167,4290,3315,21,82,20542
1/16/2020,18,11670,1147,4874,3578,0,84,21353
1/16/2020,19,11669,1142,5012,3673,0,84,21580
1/16/2020,20,11668,982,5044,3593,0,88,21375
1/16/2020,21,11659,956,4786,3573,0,67,21041
1/16/2020,22,11648,458,4462,3319,0,93,19980
1/16/2020,23,11652,357,4014,3124,0,103,19250
1/16/2020,24,11651,332,3313,2935,0,81,18312
1/17/2020,1,11649,340,3290,2686,0,72,18037
1/17/2020,2,11648,365,3583,2071,0,70,17737
1/17/2020,3,11633,483,3877,1542,0,114,17649
1/17/2020,4,11622,569,3852,1300,0,121,17464
1/17/2020,5,11622,620,3722,906,0,74,16944
1/17/2020,6,11627,872,4171,683,0,69,17422
1/17/2020,7,11629,1315,4534,504,1,96,18079
1/17/2020,8,11629,2022,5631,357,2,177,19818
1/17/2020,9,11635,2316,5310,319,28,200,19808
1/17/2020,10,11627,1961,4951,267,114,108,19028
1/17/2020,11,11632,2128,4904,220,149,66,19099
1/17/2020,12,11634,2318,5026,207,132,110,19427
1/17/2020,13,11622,2528,4968,164,155,96,19533
1/17/2020,14,11613,2664,4731,164,138,65,19375
1/17/2020,15,11604,2972,4657,241,132,57,19663
1/17/2020,16,11607,3305,4546,304,66,56,19884
1/17/2020,17,11625,3262,4567,388,10,56,19908
1/17/2020,18,11410,3222,5670,601,0,66,20969
1/17/2020,19,11284,2990,5644,645,0,63,20626
1/17/2020,20,11117,2976,5555,553,0,125,20326
1/17/2020,21,10965,3058,4974,560,0,154,19711
1/17/2020,22,10888,2548,5195,747,0,126,19504
1/17/2020,23,10842,1997,4221,1056,0,90,18206
1/17/2020,24,10839,1412,3662,1537,0,73,17523
1/18/2020,1,10841,655,3512,1936,0,71,17015
1/18/2020,2,10842,422,3432,2323,0,70,17089
1/18/2020,3,10842,328,3564,2490,0,29,17253
1/18/2020,4,10843,329,3574,2840,0,16,17602
1/18/2020,5,10847,330,3552,3045,0,4,17778
1/18/2020,6,10849,331,3703,3193,0,0,18076
1/18/2020,7,10849,331,4037,3371,0,0,18588
1/18/2020,8,10842,542,4423,3216,0,0,19023
1/18/2020,9,10834,724,4587,3390,1,2,19538
1/18/2020,10,10826,767,5023,3456,4,2,20078
1/18/2020,11,10828,1034,5376,3633,7,0,20878
1/18/2020,12,10823,1071,4870,3831,8,0,20603
1/18/2020,13,10826,1309,4699,3760,7,0,20601
1/18/2020,14,10825,1573,4621,3751,6,0,20776
1/18/2020,15,10830,1831,4460,3783,5,0,20909
1/18/2020,16,10831,1569,4667,3924,5,0,20996
1/18/2020,17,10828,1218,5221,3944,2,0,21213
1/18/2020,18,10818,1473,5711,3919,0,7,21928
1/18/2020,19,10828,1452,5676,3861,0,9,21826
1/18/2020,20,10835,1191,5310,3721,0,14,21071
1/18/2020,21,10845,787,5015,3691,0,14,20352
1/18/2020,22,10836,335,4786,3706,0,8,19671
1/18/2020,23,10817,264,4140,3838,0,13,19072
1/18/2020,24,10830,204,3648,3414,0,3,18099
1/19/2020,1,10839,199,3436,3209,0,0,17683
1/19/2020,2,10849,201,3518,3073,0,0,17641
1/19/2020,3,10839,200,3446,3292,0,0,17777
1/19/2020,4,10837,200,3439,3189,0,0,17665
1/19/2020,5,10839,201,3438,2805,0,0,17283
1/19/2020,6,10838,200,3533,2614,0,3,17188
1/19/2020,7,10836,201,3720,2947,0,1,17705
1/19/2020,8,10837,201,3878,2625,0,1,17542
1/19/2020,9,10834,374,4182,3016,3,3,18412
1/19/2020,10,10830,472,4947,2940,13,8,19210
1/19/2020,11,10829,613,4340,2881,25,0,18688
1/19/2020,12,10829,725,4080,2792,47,0,18473
1/19/2020,13,10829,1495,4223,2676,61,0,19284
1/19/2020,14,10822,2148,4154,2528,50,4,19706
1/19/2020,15,10815,2683,3869,2284,48,9,19708
1/19/2020,16,10814,3118,3785,2121,57,31,19926
1/19/2020,17,10813,3178,4386,1875,21,56,20329
1/19/2020,18,10816,3177,5430,1825,0,58,21306
1/19/2020,19,10824,3134,4959,1938,0,58,20913
1/19/2020,20,10822,2657,5156,2114,0,58,20807
1/19/2020,21,10825,2298,5327,2061,0,69,20580
1/19/2020,22,10824,1717,4967,1952,0,56,19516
1/19/2020,23,10825,1378,4289,1746,0,9,18247
1/19/2020,24,10818,731,4123,1552,0,0,17224
1/20/2020,1,10820,624,3988,1442,0,0,16874
1/20/2020,2,10827,713,4110,1281,0,6,16937
1/20/2020,3,10834,668,3804,1225,0,9,16540
1/20/2020,4,10830,928,4216,1039,0,17,17030
1/20/2020,5,10834,1372,4097,791,0,20,17114
1/20/2020,6,10857,2092,4125,698,0,57,17829
1/20/2020,7,10864,2847,4611,678,0,92,19092
1/20/2020,8,10856,3178,4943,609,1,97,19684
1/20/2020,9,10838,3338,5028,578,25,119,19926
1/20/2020,10,10841,3507,4793,518,97,177,19933
1/20/2020,11,10795,3412,4752,398,168,150,19675
1/20/2020,12,10846,3104,4613,353,204,128,19248
1/20/2020,13,10844,3347,4609,393,220,139,19552
1/20/2020,14,10848,3404,4290,479,218,101,19340
1/20/2020,15,10848,3570,4103,638,198,87,19444
1/20/2020,16,10845,3721,3941,488,132,85,19212
1/20/2020,17,10848,3795,4453,518,43,86,19743
1/20/2020,18,10854,3878,5545,855,1,86,21219
1/20/2020,19,10855,3903,5317,1419,0,85,21579
1/20/2020,20,10854,3753,4680,1851,0,88,21226
1/20/2020,21,10843,2912,4825,1932,0,88,20600
1/20/2020,22,10847,2388,5021,1693,0,88,20037
1/20/2020,23,10842,1821,4477,1487,0,87,18714
1/20/2020,24,10853,1564,4223,1292,0,39,17971
1/21/2020,1,10854,1495,3972,1083,0,22,17426
1/21/2020,2,10865,1644,3948,953,0,18,17428
1/21/2020,3,10861,1809,3767,826,0,17,17280
1/21/2020,4,10865,1953,3428,868,0,18,17132
1/21/2020,5,10867,2283,3264,737,0,18,17169
1/21/2020,6,10867,2774,3395,912,0,18,17966
1/21/2020,7,10867,3135,4453,1119,0,48,19622
1/21/2020,8,10868,3662,5055,1256,2,93,20936
1/21/2020,9,10858,3612,5049,1243,9,134,20905
1/21/2020,10,10862,3548,4995,1306,32,94,20837
1/21/2020,11,10868,3742,4944,1367,71,134,21126
1/21/2020,12,10864,3502,4662,1617,94,95,20834
1/21/2020,13,10691,3317,4188,1701,99,87,20083
1/21/2020,14,10043,3474,4573,1808,104,109,20111
1/21/2020,15,10042,2893,4510,1794,126,87,19452
1/21/2020,16,10041,3149,4660,1784,95,98,19827
1/21/2020,17,10047,3104,4502,2040,29,100,19822
1/21/2020,18,10046,3094,4555,2461,1,103,20260
1/21/2020,19,10047,2871,4474,2567,0,105,20064
1/21/2020,20,10046,2872,4348,2489,0,105,19860
1/21/2020,21,10042,2443,4401,2190,0,110,19186
1/21/2020,22,10039,1453,4400,3275,0,99,19266
1/21/2020,23,10038,1095,3848,3158,0,56,18195
1/21/2020,24,10034,582,3563,3168,0,34,17381
1/22/2020,1,10042,451,3512,3118,0,21,17144
1/22/2020,2,10045,559,3533,3199,0,18,17354
1/22/2020,3,10043,663,3507,2879,0,18,17110
1/22/2020,4,10055,962,3511,2245,0,18,16791
1/22/2020,5,10055,1312,3508,2053,0,23,16951
1/22/2020,6,10047,1638,3653,2310,0,19,17667
1/22/2020,7,10053,1686,3882,2743,0,28,18392
1/22/2020,8,10049,2200,4803,3022,0,34,20108
1/22/2020,9,10052,2308,4546,3130,8,34,20078
1/22/2020,10,10045,1877,4591,3101,33,34,19681
1/22/2020,11,10053,1537,4612,3319,65,34,19620
1/22/2020,12,10057,1911,4127,3433,93,34,19655
1/22/2020,13,9892,2218,3877,3556,98,35,19676
1/22/2020,14,9977,2286,3942,3200,103,34,19542
1/22/2020,15,10047,2011,4096,3208,110,34,19506
1/22/2020,16,10028,2005,4377,2958,70,34,19472
1/22/2020,17,10046,2142,4886,2716,22,34,19846
1/22/2020,18,10051,2204,5285,2590,1,34,20165
1/22/2020,19,10054,2214,5345,2730,0,34,20377
1/22/2020,20,10059,1629,5017,3065,0,34,19804
1/22/2020,21,10324,1101,4962,3009,0,34,19430
1/22/2020,22,10542,947,5074,2849,0,34,19446
1/22/2020,23,10644,764,4742,2700,0,34,18884
1/22/2020,24,10750,618,3993,2346,0,21,17728
1/23/2020,1,10791,550,3593,1930,0,17,16881
1/23/2020,2,10788,626,3498,1660,0,17,16589
1/23/2020,3,10795,649,3598,1296,0,17,16355
1/23/2020,4,10794,895,3639,1159,0,17,16504
1/23/2020,5,10799,1309,3569,969,0,18,16664
1/23/2020,6,10802,1830,3702,755,0,21,17110
1/23/2020,7,10815,2160,4063,848,1,29,17916
1/23/2020,8,10813,2857,5103,988,1,36,19798
1/23/2020,9,10812,3018,5147,943,19,35,19974
1/23/2020,10,10810,3025,4960,762,35,34,19626
1/23/2020,11,10807,3083,5195,591,60,34,19770
1/23/2020,12,10811,3311,4691,321,85,34,19253
1/23/2020,13,10798,3237,4750,191,103,35,19114
1/23/2020,14,10794,3239,4533,103,95,37,18801
1/23/2020,15,10785,2969,4723,149,73,55,18754
1/23/2020,16,10745,2856,4403,235,42,89,18370
1/23/2020,17,10797,2944,4656,226,11,101,18735
1/23/2020,18,10818,2941,5060,545,0,126,19490
1/23/2020,19,10815,2937,5100,803,0,129,19784
1/23/2020,20,10808,2776,4764,1004,0,129,19481
1/23/2020,21,10801,2018,4942,1024,0,119,18904
1/23/2020,22,10802,1417,4573,1143,0,131,18066
1/23/2020,23,10792,896,4361,1353,0,130,17532
1/23/2020,24,10794,319,3769,1470,0,104,16456
1/24/2020,1,10799,203,3706,1043,0,70,15821
1/24/2020,2,10798,204,3747,1220,0,34,16003
1/24/2020,3,10798,299,3645,1470,0,20,16232
1/24/2020,4,10804,306,3613,1551,0,20,16294
1/24/2020,5,10798,649,3652,1444,0,23,16566
1/24/2020,6,10797,1082,3754,1259,0,24,16916
1/24/2020,7,10799,1245,4083,1365,0,60,17552
1/24/2020,8,10796,1179,4310,2209,0,84,18578
1/24/2020,9,10781,1179,4727,2154,24,86,18951
1/24/2020,10,10780,1222,4656,2746,73,88,19565
1/24/2020,11,10786,1222,4652,2373,138,102,19273
1/24/2020,12,10780,1220,4369,2349,137,105,18960
1/24/2020,13,10773,1364,4390,2211,200,122,19060
1/24/2020,14,10762,1571,4370,1685,159,94,18641
1/24/2020,15,10765,1255,4428,2330,143,56,18977
1/24/2020,16,10764,1396,4459,2498,71,44,19232
1/24/2020,17,10770,1396,4579,2982,12,45,19784
1/24/2020,18,10755,1389,4806,3559,0,43,20552
1/24/2020,19,10757,1373,4813,3354,0,41,20338
1/24/2020,20,10752,1377,4857,3194,0,36,20216
1/24/2020,21,10742,1374,4664,3114,0,35,19929
1/24/2020,22,10737,1224,4436,3013,0,37,19447
1/24/2020,23,10739,1023,4071,2725,0,36,18594
1/24/2020,24,10731,761,3805,2419,0,17,17733
1/25/2020,1,10731,412,3571,2710,0,3,17427
1/25/2020,2,10733,363,3565,2126,0,3,16790
1/25/2020,3,10730,363,3567,2027,0,0,16687
1/25/2020,4,10728,363,3652,1680,0,0,16423
1/25/2020,5,10734,361,3704,1864,0,3,16666
1/25/2020,6,10728,367,3893,1600,0,3,16591
1/25/2020,7,10722,366,3803,1461,0,0,16352
1/25/2020,8,10720,895,4011,1534,0,0,17160
1/25/2020,9,10719,1084,3996,1379,2,0,17180
1/25/2020,10,10711,1161,4253,1420,14,0,17559
1/25/2020,11,10708,1149,4791,1410,21,0,18079
1/25/2020,12,10708,1194,4886,1460,36,0,18284
1/25/2020,13,10712,1311,4622,1339,39,0,18023
1/25/2020,14,10712,1584,4603,1463,61,0,18423
1/25/2020,15,10675,1705,4620,1499,52,0,18551
1/25/2020,16,10723,1759,4775,1435,39,7,18738
1/25/2020,17,10729,1859,4664,1342,9,5,18608
1/25/2020,18,10724,1862,4999,1350,0,7,18942
1/25/2020,19,10723,1860,5147,1260,0,7,18997
1/25/2020,20,10728,1858,5129,1237,0,12,18964
1/25/2020,21,10723,1306,4905,1325,0,10,18269
1/25/2020,22,10733,777,4314,1394,0,5,17223
1/25/2020,23,10737,624,4108,1432,0,0,16901
1/25/2020,24,10743,552,3759,1574,0,0,16628
1/26/2020,1,10743,380,3813,1876,0,0,16812
1/26/2020,2,10741,351,3686,1873,0,0,16651
1/26/2020,3,10741,352,3633,1828,0,0,16554
1/26/2020,4,10744,351,3519,1769,0,0,16383
1/26/2020,5,10740,351,3545,1773,0,0,16409
1/26/2020,6,10737,351,3577,1891,0,0,16556
1/26/2020,7,10740,350,3797,1966,0,0,16853
1/26/2020,8,10735,875,3973,1516,0,0,17099
1/26/2020,9,10735,978,4102,1780,3,0,17598
1/26/2020,10,10737,803,4199,2161,15,0,17915
1/26/2020,11,10728,967,4100,2333,32,0,18160
1/26/2020,12,10740,1070,4039,2395,38,0,18282
1/26/2020,13,10737,1094,4009,2412,54,0,18306
1/26/2020,14,10737,1137,4075,2434,39,0,18422
1/26/2020,15,10734,1139,4135,2503,28,0,18539
1/26/2020,16,10738,1392,4076,2735,14,0,18955
1/26/2020,17,10733,1394,4735,2572,4,0,19438
1/26/2020,18,10736,1393,4897,3071,0,0,20097
1/26/2020,19,10738,1391,5011,3138,0,0,20278
1/26/2020,20,10733,1390,4836,2649,0,0,19608
1/26/2020,21,10733,1224,4644,2660,0,0,19261
1/26/2020,22,10743,588,4657,2624,0,0,18612
1/26/2020,23,10740,354,4353,2409,0,0,17856
1/26/2020,24,10737,354,3907,2247,0,0,17245
1/27/2020,1,10735,359,3757,2055,0,3,16909
1/27/2020,2,10734,415,3791,1811,0,14,16765
1/27/2020,3,10724,470,3880,1697,0,16,16787
1/27/2020,4,10728,578,3918,1536,0,16,16776
1/27/2020,5,10730,1004,3902,1186,0,16,16838
1/27/2020,6,10738,1345,3965,1297,0,20,17365
1/27/2020,7,10735,1570,4377,1070,1,47,17800
1/27/2020,8,10725,1894,4751,1079,2,92,18543
1/27/2020,9,10722,1998,4647,1016,9,116,18508
1/27/2020,10,10725,2206,5006,888,32,129,18986
1/27/2020,11,10726,2314,4986,785,95,131,19037
1/27/2020,12,10734,2354,4827,744,86,132,18877
1/27/2020,13,10726,2381,4565,855,59,132,18718
1/27/2020,14,10728,2393,4452,935,48,128,18684
1/27/2020,15,10725,2243,4599,777,35,101,18480
1/27/2020,16,10727,1926,4722,982,23,108,18488
1/27/2020,17,10727,1938,5160,1039,7,132,19003
1/27/2020,18,10727,1993,5739,922,0,132,19513
1/27/2020,19,10736,2074,5900,820,0,132,19662
1/27/2020,20,10737,2070,5810,886,0,149,19652
1/27/2020,21,10738,2055,5925,821,0,137,19676
1/27/2020,22,10741,1947,5463,717,0,139,19007
1/27/2020,23,10736,1428,4676,729,0,71,17640
1/27/2020,24,10743,817,4628,792,0,26,17006
1/28/2020,1,10735,666,3858,437,0,18,15714
1/28/2020,2,10738,586,3811,546,0,16,15697
1/28/2020,3,10738,647,3995,740,0,16,16136
1/28/2020,4,10734,662,3923,627,0,16,15962
1/28/2020,5,10734,942,3944,322,0,16,15958
1/28/2020,6,10738,1258,4072,405,0,20,16493
1/28/2020,7,10738,1443,4653,445,0,47,17326
1/28/2020,8,10738,2047,5726,630,1,94,19236
1/28/2020,9,10725,2491,5310,612,14,149,19301
1/28/2020,10,10732,2394,5156,520,57,156,19015
1/28/2020,11,10737,2625,4866,489,92,156,18965
1/28/2020,12,10731,2662,4413,244,143,144,18337
1/28/2020,13,10736,2754,4507,566,126,146,18835
1/28/2020,14,10737,2768,4755,610,98,156,19124
1/28/2020,15,10735,2964,4437,599,55,128,18918
1/28/2020,16,10749,2828,4513,488,24,145,18747
1/28/2020,17,10757,2782,4953,555,8,154,19209
1/28/2020,18,10800,2642,5649,637,0,158,19886
1/28/2020,19,10871,2591,5846,554,0,162,20024
1/28/2020,20,10876,2546,6023,565,0,169,20179
1/28/2020,21,10870,2523,5561,661,0,172,19787
1/28/2020,22,10869,1980,4914,611,0,143,18517
1/28/2020,23,10861,1476,4731,517,0,58,17643
1/28/2020,24,10871,726,4192,439,0,34,16262
1/29/2020,1,10874,580,4291,349,0,20,16114
1/29/2020,2,10885,538,4022,366,0,15,15826
1/29/2020,3,10885,549,3886,326,0,16,15662
1/29/2020,4,10883,709,3731,230,0,17,15570
1/29/2020,5,10884,1032,3936,157,0,24,16033
1/29/2020,6,10887,1384,4196,127,0,49,16643
1/29/2020,7,10883,2274,4692,100,1,113,18063
1/29/2020,8,10881,2816,5896,114,2,173,19882
1/29/2020,9,10871,2901,5395,146,33,187,19533
1/29/2020,10,10872,2873,4555,87,93,188,18668
1/29/2020,11,10875,2895,4470,39,109,182,18570
1/29/2020,12,10882,2759,4596,26,157,192,18612
1/29/2020,13,10881,2597,4058,22,165,190,17913
1/29/2020,14,10879,2623,4089,18,118,159,17886
1/29/2020,15,10881,2774,4133,33,124,168,18113
1/29/2020,16,10876,2941,4274,30,82,159,18362
1/29/2020,17,10883,3031,4904,51,34,181,19084
1/29/2020,18,10877,3135,5948,64,2,194,20220
1/29/2020,19,10886,3308,6119,89,0,196,20598
1/29/2020,20,10878,2968,5951,108,0,182,20087
1/29/2020,21,10881,2900,5573,191,0,178,19723
1/29/2020,22,10872,2715,5125,256,0,186,19154
1/29/2020,23,10874,1966,4772,268,0,160,18040
1/29/2020,24,10885,1348,4265,219,0,123,16840
1/30/2020,1,10880,1074,4163,199,0,97,16413
1/30/2020,2,10878,1146,4265,164,0,104,16557
1/30/2020,3,10876,1252,4225,139,0,113,16605
1/30/2020,4,10881,1269,3573,184,0,84,15991
1/30/2020,5,10805,1630,4015,224,0,90,16764
1/30/2020,6,10775,2439,3981,270,0,104,17569
1/30/2020,7,10777,2906,4822,345,1,171,19022
1/30/2020,8,10783,3652,5483,404,6,187,20515
1/30/2020,9,10772,3568,5292,403,42,187,20264
1/30/2020,10,10774,3367,4941,278,139,163,19662
1/30/2020,11,10776,3399,5119,166,238,158,19856
1/30/2020,12,10777,3257,4674,74,241,157,19180
1/30/2020,13,10773,2749,4296,42,259,162,18281
1/30/2020,14,10775,2551,4443,48,278,165,18260
1/30/2020,15,10778,2338,4650,63,197,163,18189
1/30/2020,16,10781,2388,4871,62,135,162,18399
1/30/2020,17,10821,2422,5411,52,45,165,18916
1/30/2020,18,10896,2770,5963,59,1,180,19869
1/30/2020,19,10889,3050,5855,52,0,202,20048
1/30/2020,20,10889,2959,5950,48,0,204,20050
1/30/2020,21,10889,3096,5612,46,0,212,19855
1/30/2020,22,10887,2859,5011,72,0,207,19036
1/30/2020,23,10884,2394,4403,69,0,175,17925
1/30/2020,24,10900,2123,4294,102,0,162,17581
1/31/2020,1,10897,1433,4371,120,0,148,16969
1/31/2020,2,10897,1190,4118,133,0,146,16484
1/31/2020,3,10895,1191,4148,122,0,148,16504
1/31/2020,4,10892,1312,3895,129,0,143,16371
1/31/2020,5,10833,1663,4088,107,0,142,16833
1/31/2020,6,10825,2002,4321,78,0,148,17374
1/31/2020,7,10831,2554,4950,71,0,165,18571
1/31/2020,8,10830,2565,5287,78,2,186,18948
1/31/2020,9,10825,2603,5418,83,16,194,19139
1/31/2020,10,10821,2467,5385,94,47,179,18993
1/31/2020,11,10821,2499,5390,81,62,171,19024
1/31/2020,12,10821,2683,5206,80,83,196,19069
1/31/2020,13,10811,2531,5168,84,85,203,18882
1/31/2020,14,10816,2687,4877,86,87,202,18755
1/31/2020,15,10064,2989,4948,71,71,189,18332
1/31/2020,16,9939,3356,4992,42,59,208,18596
1/31/2020,17,10003,3186,5492,21,15,203,18920
1/31/2020,18,10002,3285,5961,31,0,169,19448
1/31/2020,19,10002,3534,5940,45,0,75,19596
1/31/2020,20,10009,3336,5669,73,0,19,19106
1/31/2020,21,10003,3333,5500,83,0,20,18939
1/31/2020,22,10005,2805,5247,115,0,19,18191
1/31/2020,23,10017,2399,4399,258,0,20,17093
1/31/2020,24,10154,1617,3851,248,0,16,15886
2/1/2020,1,10449,1256,3829,274,0,0,15808
2/1/2020,2,10463,939,3625,349,0,0,15376
2/1/2020,3,10477,823,3534,489,0,0,15323
2/1/2020,4,10483,831,3484,439,0,0,15237
2/1/2020,5,10397,937,3492,400,0,0,15226
2/1/2020,6,10378,1102,3850,385,0,0,15715
2/1/2020,7,10378,1153,3990,469,2,0,15992
2/1/2020,8,10383,1238,4554,636,3,0,16814
2/1/2020,9,10384,1352,4787,727,18,0,17268
2/1/2020,10,10380,1513,5101,791,44,0,17829
2/1/2020,11,10374,1823,4643,931,71,0,17842
2/1/2020,12,10373,1992,4452,873,95,1,17786
2/1/2020,13,10465,1736,4520,909,144,0,17774
2/1/2020,14,10478,1340,4276,1477,137,0,17708
2/1/2020,15,10484,906,4283,1772,104,0,17549
2/1/2020,16,10480,1061,4307,1760,52,0,17660
2/1/2020,17,10476,1038,4801,1684,17,0,18016
2/1/2020,18,10475,1197,5585,1782,0,0,19039
2/1/2020,19,10480,1184,5425,1927,0,8,19024
2/1/2020,20,10486,1181,5025,1980,0,8,18680
2/1/2020,21,10480,921,4825,1847,0,0,18073
2/1/2020,22,10484,655,4859,2033,0,0,18031
2/1/2020,23,10480,524,3883,1849,0,0,16736
2/1/2020,24,10485,266,3945,1635,0,0,16331
2/2/2020,1,10480,234,3699,1656,0,0,16069
2/2/2020,2,10482,203,3425,1464,0,0,15574
2/2/2020,3,10489,203,3416,1434,0,0,15542
2/2/2020,4,10487,202,3323,1480,0,0,15492
2/2/2020,5,10490,202,3317,1533,0,0,15542
2/2/2020,6,10491,203,3464,1691,0,0,15849
2/2/2020,7,10499,207,3659,1853,0,0,16218
2/2/2020,8,10494,290,3879,2040,0,0,16703
2/2/2020,9,10492,299,3964,2659,3,0,17417
2/2/2020,10,10485,449,4573,2708,26,2,18243
2/2/2020,11,10484,579,4785,2507,73,1,18429
2/2/2020,12,10478,691,4898,1909,105,0,18081
2/2/2020,13,10479,755,4743,1556,129,0,17662
2/2/2020,14,10475,748,4457,1468,113,0,17261
2/2/2020,15,10480,961,4837,1286,89,2,17655
2/2/2020,16,10480,1122,4760,1357,59,2,17780
2/2/2020,17,10435,1136,4991,1376,25,0,17963
2/2/2020,18,10486,1202,5678,1400,3,0,18769
2/2/2020,19,10482,1100,5313,1435,0,0,18330
2/2/2020,20,10482,723,4937,1582,0,0,17724
2/2/2020,21,10472,494,4397,1592,0,0,16955
2/2/2020,22,10482,396,4196,1916,0,0,16990
2/2/2020,23,10463,397,3877,2123,0,0,16860
2/2/2020,24,10467,392,3705,2221,0,0,16785
2/3/2020,1,10492,227,3660,2267,0,8,16654
2/3/2020,2,10497,204,3735,1934,0,18,16388
2/3/2020,3,10489,231,3728,1409,0,21,15878
2/3/2020,4,10491,318,3627,1404,0,21,15861
2/3/2020,5,10491,539,3732,1331,0,18,16111
2/3/2020,6,10488,876,3779,1019,0,19,16181
2/3/2020,7,10490,1174,4171,1183,1,28,17047
2/3/2020,8,10492,1433,4874,1290,2,35,18126
2/3/2020,9,10484,1535,4895,1067,38,34,18053
2/3/2020,10,10481,1707,4952,793,106,34,18073
2/3/2020,11,10378,1892,4836,680,193,34,18013
2/3/2020,12,10163,1800,4802,514,195,34,17508
2/3/2020,13,10173,1784,4585,422,246,34,17244
2/3/2020,14,10177,1867,4449,336,236,34,17099
2/3/2020,15,9700,1635,4748,353,218,34,16688
2/3/2020,16,9353,1612,5073,398,197,34,16667
2/3/2020,17,9369,1570,5133,476,66,34,16648
2/3/2020,18,9653,1495,5154,547,3,34,16886
2/3/2020,19,9670,1677,5471,964,0,34,17816
2/3/2020,20,9669,1587,5240,1306,0,34,17836
2/3/2020,21,9668,1158,5223,1443,0,34,17526
2/3/2020,22,9669,1016,5136,1406,0,34,17261
2/3/2020,23,9717,924,4742,1188,0,34,16605
2/3/2020,24,9884,598,4348,1026,0,28,15884
2/4/2020,1,9882,492,4055,765,0,20,15214
2/4/2020,2,9882,559,3837,695,0,18,14991
2/4/2020,3,9884,484,3751,917,0,18,15054
2/4/2020,4,9887,575,3621,913,0,20,15016
2/4/2020,5,9889,675,3632,685,0,27,14908
2/4/2020,6,9885,885,3660,817,0,35,15282
2/4/2020,7,9884,1016,3981,1476,0,46,16403
2/4/2020,8,9884,1041,4748,2110,2,48,17833
2/4/2020,9,9876,1035,4727,2109,9,49,17805
2/4/2020,10,9868,1055,5159,2042,23,46,18193
2/4/2020,11,9953,1114,5126,2183,40,48,18464
2/4/2020,12,10003,1082,4801,2158,67,50,18161
2/4/2020,13,9996,1202,4717,2360,91,50,18416
2/4/2020,14,10019,1367,4565,2468,144,51,18614
2/4/2020,15,10027,1632,4500,2652,117,50,18978
2/4/2020,16,10026,1634,4571,2396,65,51,18743
2/4/2020,17,10028,1509,4770,2964,16,47,19334
2/4/2020,18,10027,1573,4848,2807,0,46,19301
2/4/2020,19,10030,1477,4792,2880,0,40,19219
2/4/2020,20,10032,1414,5009,3049,0,35,19539
2/4/2020,21,10032,1113,5108,3053,0,35,19341
2/4/2020,22,10028,592,4803,3148,1,35,18607
2/4/2020,23,10027,239,4061,3073,1,35,17436
2/4/2020,24,10024,209,3932,2794,0,29,16988
2/5/2020,1,10056,208,3832,2522,0,21,16639
2/5/2020,2,10064,212,3786,2186,0,17,16265
2/5/2020,3,10056,306,3690,2183,0,17,16252
2/5/2020,4,10057,617,3661,1864,0,18,16217
2/5/2020,5,10058,962,3763,1297,0,22,16102
2/5/2020,6,10059,1191,3825,1457,0,35,16567
2/5/2020,7,10065,1540,4560,1230,2,77,17474
2/5/2020,8,10068,2161,5342,848,6,120,18545
2/5/2020,9,10061,2150,5115,764,93,122,18305
2/5/2020,10,10060,1631,4870,679,220,91,17551
2/5/2020,11,10056,1585,4896,576,287,91,17491
2/5/2020,12,10062,1654,4878,473,323,91,17481
2/5/2020,13,10066,1764,5031,420,328,89,17698
2/5/2020,14,10061,1788,4579,433,323,91,17275
2/5/2020,15,9905,1906,4713,355,299,92,17270
2/5/2020,16,9960,2259,4894,428,193,92,17826
2/5/2020,17,10063,2504,5373,504,49,93,18586
2/5/2020,18,10063,2742,5741,704,1,125,19376
2/5/2020,19,10060,3172,5668,794,0,170,19864
2/5/2020,20,10161,2884,5608,856,0,146,19655
2/5/2020,21,10254,2258,5481,1083,0,122,19198
2/5/2020,22,10249,1850,4854,1081,0,41,18075
2/5/2020,23,10257,1377,4397,1074,0,34,17139
2/5/2020,24,10262,1234,4322,890,0,26,16734
2/6/2020,1,10225,1141,4063,1093,0,20,16542
2/6/2020,2,10227,620,3866,1399,0,18,16130
2/6/2020,3,10369,474,3656,1181,0,17,15697
2/6/2020,4,10419,588,3741,1566,0,17,16331
2/6/2020,5,10583,759,3650,1166,0,17,16175
2/6/2020,6,10705,1208,3808,1190,0,19,16930
2/6/2020,7,10705,1424,4390,1066,0,46,17631
2/6/2020,8,10702,1696,5024,1384,0,89,18895
2/6/2020,9,10706,1747,5261,1447,1,91,19253
2/6/2020,10,10723,1664,5268,1500,4,91,19250
2/6/2020,11,10718,1726,5029,1727,9,91,19300
2/6/2020,12,10724,1575,5052,1803,14,98,19266
2/6/2020,13,10725,1496,5089,1720,17,112,19159
2/6/2020,14,10737,1787,5067,1638,16,123,19368
2/6/2020,15,10737,1758,5008,1831,19,93,19446
2/6/2020,16,10732,1843,5072,1747,13,88,19495
2/6/2020,17,10740,2033,5475,1538,4,94,19884
2/6/2020,18,10811,2321,5787,1449,0,151,20519
2/6/2020,19,10836,2451,5878,1393,0,172,20730
2/6/2020,20,10832,2209,5898,1372,0,167,20478
2/6/2020,21,10831,2093,5843,1485,0,123,20375
2/6/2020,22,10827,1688,5286,1698,0,86,19585
2/6/2020,23,10828,650,4802,1679,0,48,18007
2/6/2020,24,10828,344,4106,1639,0,27,16944
2/7/2020,1,10835,273,3807,1660,0,20,16595
2/7/2020,2,10836,267,3828,1061,0,18,16010
2/7/2020,3,10843,272,3752,1311,0,18,16196
2/7/2020,4,10835,338,3729,1527,0,21,16450
2/7/2020,5,10828,669,3672,1413,0,21,16603
2/7/2020,6,10850,977,3815,1137,0,23,16802
2/7/2020,7,10850,1170,4189,1722,0,65,17996
2/7/2020,8,10856,1185,4574,2776,0,86,19477
2/7/2020,9,10850,1283,4668,2575,2,85,19463
2/7/2020,10,10853,1312,4664,2771,10,82,19692
2/7/2020,11,10852,1346,4606,2642,21,82,19549
2/7/2020,12,10842,1370,4588,2731,34,81,19646
2/7/2020,13,10848,1255,4755,2941,46,80,19925
2/7/2020,14,10847,1331,4398,2723,55,79,19433
2/7/2020,15,10855,1613,4426,2480,63,79,19516
2/7/2020,16,10858,1733,4508,2455,49,79,19682
2/7/2020,17,10863,1710,4950,2461,25,79,20088
2/7/2020,18,10856,1730,5748,2049,2,80,20465
2/7/2020,19,10856,2199,5980,1756,0,74,20865
2/7/2020,20,10850,1898,5621,1929,0,69,20367
2/7/2020,21,10864,1725,5677,1639,0,78,19983
2/7/2020,22,10860,1499,5594,1423,0,78,19454
2/7/2020,23,10852,1567,5091,1439,0,46,18995
2/7/2020,24,10846,1117,4188,1127,0,16,17294
2/8/2020,1,10845,555,4042,961,0,3,16406
2/8/2020,2,10850,628,3875,887,0,4,16244
2/8/2020,3,10838,874,3626,822,0,0,16160
2/8/2020,4,10842,1140,3553,808,0,0,16343
2/8/2020,5,10851,1289,3846,655,0,1,16642
2/8/2020,6,10850,1383,3805,510,0,31,16579
2/8/2020,7,10855,1379,4216,542,0,51,17043
2/8/2020,8,10855,1411,4872,577,2,51,17768
2/8/2020,9,10853,1436,5480,510,15,56,18350
2/8/2020,10,10850,1502,5645,349,45,122,18513
2/8/2020,11,10855,1664,5767,201,67,188,18742
2/8/2020,12,10853,1777,5380,137,82,162,18391
2/8/2020,13,10852,2079,4861,104,88,81,18065
2/8/2020,14,10855,2086,4781,73,100,74,17969
2/8/2020,15,10859,2314,4819,96,92,74,18254
2/8/2020,16,10862,1992,4642,109,63,54,17722
2/8/2020,17,10859,2068,5017,122,25,51,18142
2/8/2020,18,10851,2130,5875,163,3,81,19103
2/8/2020,19,10856,2375,5948,324,0,165,19668
2/8/2020,20,10856,2202,5560,523,0,121,19262
2/8/2020,21,10843,1720,5028,667,0,53,18311
2/8/2020,22,10843,1614,4684,710,0,56,17907
2/8/2020,23,10860,1549,4366,703,0,56,17534
2/8/2020,24,10868,1551,4045,775,0,61,17300
2/9/2020,1,10866,893,4141,772,0,17,16689
2/9/2020,2,10866,815,3886,795,0,0,16362
2/9/2020,3,10866,749,4022,844,0,1,16482
2/9/2020,4,10864,806,3826,837,0,2,16335
2/9/2020,5,10867,1064,3996,841,0,0,16768
2/9/2020,6,10873,1171,4130,881,0,0,17055
2/9/2020,7,10872,1208,3972,976,1,0,17029
2/9/2020,8,10872,1170,4003,1062,2,0,17109
2/9/2020,9,10865,1301,4316,1080,15,0,17577
2/9/2020,10,10867,1567,4522,1020,50,0,18026
2/9/2020,11,10866,1498,4516,1047,76,0,18003
2/9/2020,12,10870,1398,4746,1238,88,0,18340
2/9/2020,13,10866,1416,4659,1725,101,0,18767
2/9/2020,14,10866,1416,4588,2081,96,0,19047
2/9/2020,15,10814,1379,4344,2305,100,0,18942
2/9/2020,16,10866,1033,4474,2337,44,0,18754
2/9/2020,17,10864,708,4811,2669,17,0,19069
2/9/2020,18,10865,627,4968,3141,1,0,19602
2/9/2020,19,10866,624,4703,3426,0,0,19619
2/9/2020,20,10864,624,4865,3546,0,0,19899
2/9/2020,21,10862,533,4676,3523,0,0,19594
2/9/2020,22,10862,291,4124,3311,0,0,18588
2/9/2020,23,10866,205,3887,3102,0,0,18060
2/9/2020,24,10868,204,3626,3002,0,0,17700
2/10/2020,1,10866,209,3433,2732,0,0,17240
2/10/2020,2,10870,231,3429,2352,0,0,16882
2/10/2020,3,10864,300,3507,1896,0,0,16567
2/10/2020,4,10867,543,3329,1876,0,0,16615
2/10/2020,5,10867,841,3385,1569,0,0,16662
2/10/2020,6,10864,1072,3452,877,0,3,16268
2/10/2020,7,10865,1219,4309,1192,0,23,17608
2/10/2020,8,10859,1701,5411,1211,1,27,19210
2/10/2020,9,10859,2026,5634,803,5,27,19354
2/10/2020,10,10863,2338,5616,692,17,27,19553
2/10/2020,11,10864,2105,5318,698,36,27,19048
2/10/2020,12,10865,1948,4444,600,92,27,17976
2/10/2020,13,10860,1963,4060,427,199,27,17536
2/10/2020,14,10859,1781,4352,467,236,27,17722
2/10/2020,15,10673,2177,4536,370,167,28,17951
2/10/2020,16,10393,2385,4737,146,97,28,17786
2/10/2020,17,10361,2739,5539,104,49,29,18821
2/10/2020,18,10375,2941,6198,136,5,27,19682
2/10/2020,19,10379,2764,6170,195,0,35,19543
2/10/2020,20,10380,2450,5993,211,0,29,19063
2/10/2020,21,10376,2091,6005,189,0,30,18691
2/10/2020,22,10379,2055,5562,204,0,28,18228
2/10/2020,23,10374,1807,4961,249,0,27,17418
2/10/2020,24,10377,1410,4360,276,0,16,16439
2/11/2020,1,10374,1096,4135,212,0,12,15829
2/11/2020,2,10372,1137,3864,246,0,12,15631
2/11/2020,3,10368,1096,3750,243,0,12,15469
2/11/2020,4,10376,1042,3675,215,0,12,15320
2/11/2020,5,10368,1159,3691,253,0,13,15484
2/11/2020,6,10365,1256,3794,635,0,15,16065
2/11/2020,7,10367,1552,4518,568,2,22,17029
2/11/2020,8,10374,2034,5441,613,3,27,18492
2/11/2020,9,10375,2079,5552,574,19,27,18626
2/11/2020,10,10364,1922,5448,634,61,38,18467
2/11/2020,11,10369,1755,5427,866,114,36,18567
2/11/2020,12,10372,1439,4674,1127,174,28,17814
2/11/2020,13,10373,1103,4710,1035,209,27,17457
2/11/2020,14,10373,864,4707,1497,183,27,17651
2/11/2020,15,10374,870,4842,2000,140,27,18253
2/11/2020,16,10374,900,4657,2113,94,27,18165
2/11/2020,17,10367,1001,4690,2361,42,27,18488
2/11/2020,18,10365,1032,5106,2791,5,26,19325
2/11/2020,19,10369,994,5105,3047,0,27,19542
2/11/2020,20,10374,998,4934,3318,0,27,19651
2/11/2020,21,10371,657,4875,3319,0,27,19249
2/11/2020,22,10367,579,4564,3387,0,27,18924
2/11/2020,23,10366,472,4292,3198,0,28,18356
2/11/2020,24,10371,235,4005,2524,0,16,17151
2/12/2020,1,10374,209,3934,2277,0,12,16806
2/12/2020,2,10371,281,3698,2070,0,12,16432
2/12/2020,3,10374,309,3743,1743,0,12,16181
2/12/2020,4,10369,508,3752,1658,0,13,16300
2/12/2020,5,10374,840,3764,1598,0,13,16589
2/12/2020,6,10370,1173,3846,1434,0,12,16835
2/12/2020,7,10375,1414,4384,1439,2,21,17635
2/12/2020,8,10377,1421,5137,1612,5,28,18580
2/12/2020,9,10370,1423,4747,1714,42,27,18323
2/12/2020,10,10370,1257,4619,1550,130,27,17953
2/12/2020,11,10363,1232,4655,1582,162,27,18021
2/12/2020,12,10362,1243,4298,1678,189,27,17797
2/12/2020,13,10227,1099,4346,2464,167,27,18330
2/12/2020,14,10215,752,4409,2641,119,27,18163
2/12/2020,15,10330,1100,4465,2395,98,26,18414
2/12/2020,16,10363,877,4622,1977,75,26,17940
2/12/2020,17,10374,779,4845,1940,28,26,17992
2/12/2020,18,10377,702,5715,1869,3,26,18692
2/12/2020,19,10380,783,5992,1719,0,27,18901
2/12/2020,20,10376,739,5962,1720,0,27,18824
2/12/2020,21,10378,746,5879,1619,0,27,18649
2/12/2020,22,10379,708,5096,1488,0,27,17698
2/12/2020,23,10371,358,4341,1345,0,27,16442
2/12/2020,24,10380,294,4048,1217,0,17,15956
2/13/2020,1,10380,334,4348,926,0,12,16000
2/13/2020,2,10381,475,3978,964,0,10,15808
2/13/2020,3,10380,469,3772,859,0,10,15490
2/13/2020,4,10380,701,3622,665,0,9,15377
2/13/2020,5,10381,999,3789,640,0,9,15818
2/13/2020,6,10378,1215,4084,637,0,14,16328
2/13/2020,7,10379,1425,4570,613,0,21,17008
2/13/2020,8,10379,1860,5483,697,1,25,18445
2/13/2020,9,10374,1702,5841,771,3,31,18722
2/13/2020,10,10368,1599,5725,935,15,28,18670
2/13/2020,11,10362,1550,5460,1296,46,30,18744
2/13/2020,12,10356,1431,5224,1239,54,28,18332
2/13/2020,13,10358,1482,5016,1843,50,27,18776
2/13/2020,14,10357,1605,4895,2235,61,27,19180
2/13/2020,15,10356,1792,4785,2413,52,34,19432
2/13/2020,16,10355,1721,4877,2481,45,29,19508
2/13/2020,17,10355,1786,4963,2489,23,27,19643
2/13/2020,18,10352,1857,5333,2493,3,27,20065
2/13/2020,19,10350,1983,5629,2551,0,27,20540
2/13/2020,20,10351,1972,5508,2625,0,27,20483
2/13/2020,21,10349,1880,5603,2361,0,27,20220
2/13/2020,22,10348,2128,5166,1973,0,27,19642
2/13/2020,23,10352,1448,4422,1942,0,27,18191
2/13/2020,24,10352,1224,4064,1727,0,17,17384
2/14/2020,1,10336,1169,3755,1458,0,13,16731
2/14/2020,2,10355,992,3838,1445,0,11,16641
2/14/2020,3,10365,935,3912,1272,0,9,16493
2/14/2020,4,10355,1155,4111,995,0,9,16625
2/14/2020,5,10349,1598,4048,930,0,9,16934
2/14/2020,6,10354,2131,4804,819,0,16,18124
2/14/2020,7,10353,2724,5397,798,2,21,19295
2/14/2020,8,10356,3590,5961,702,4,26,20639
2/14/2020,9,10351,3400,6082,483,44,26,20386
2/14/2020,10,10356,3710,5957,427,109,26,20585
2/14/2020,11,10353,3578,5356,425,177,27,19916
2/14/2020,12,10351,2873,5281,454,236,26,19221
2/14/2020,13,10350,2359,5035,417,269,26,18456
2/14/2020,14,10350,2205,5286,346,278,26,18491
2/14/2020,15,10355,2441,5332,391,275,26,18820
2/14/2020,16,10353,2402,5337,536,224,26,18878
2/14/2020,17,10356,2499,5583,736,122,26,19322
2/14/2020,18,10360,2857,6160,780,14,26,20197
2/14/2020,19,10403,3212,6203,969,0,26,20813
2/14/2020,20,10408,2896,6152,1366,0,27,20849
2/14/2020,21,10394,2655,6012,1572,0,26,20659
2/14/2020,22,9842,2788,5632,1883,0,27,20172
2/14/2020,23,9555,2468,4908,2129,0,26,19086
2/14/2020,24,9548,1913,4492,2426,0,11,18390
2/15/2020,1,9570,1470,4328,2523,0,0,17891
2/15/2020,2,9564,1336,4327,2548,0,0,17775
2/15/2020,3,9564,920,4142,2651,0,0,17277
2/15/2020,4,9563,867,3964,2784,0,0,17178
2/15/2020,5,9567,823,3722,3146,0,0,17258
2/15/2020,6,9563,797,3766,3214,0,0,17340
2/15/2020,7,9561,641,3999,3267,2,0,17470
2/15/2020,8,9564,719,4380,3539,4,0,18206
2/15/2020,9,9567,865,4770,3799,37,0,19038
2/15/2020,10,9556,710,4459,3664,95,1,18485
2/15/2020,11,9563,599,4451,3685,153,1,18452
2/15/2020,12,9557,602,4315,3719,188,0,18381
2/15/2020,13,9559,611,4165,3732,192,0,18259
2/15/2020,14,9564,532,3937,3970,218,0,18221
2/15/2020,15,9563,606,4168,3864,139,0,18340
2/15/2020,16,9564,681,4441,4027,65,0,18778
2/15/2020,17,9563,797,4530,4057,33,0,18980
2/15/2020,18,9563,795,4968,4205,3,0,19534
2/15/2020,19,9560,796,4959,4128,0,0,19443
2/15/2020,20,9564,796,5015,4060,0,0,19435
2/15/2020,21,9563,629,4719,4195,0,0,19106
2/15/2020,22,9563,580,4205,4185,0,0,18533
2/15/2020,23,9560,512,3952,4007,0,0,18031
2/15/2020,24,9561,221,3747,3835,0,0,17364
2/16/2020,1,9558,191,3751,3208,0,0,16708
2/16/2020,2,9564,191,3796,2547,0,0,16098
2/16/2020,3,9564,197,3847,2816,0,0,16424
2/16/2020,4,9562,198,3802,2678,0,0,16240
2/16/2020,5,9560,206,3770,2381,0,0,15917
2/16/2020,6,9557,287,3913,1936,0,0,15693
2/16/2020,7,9563,441,4115,1749,2,1,15871
2/16/2020,8,9570,613,4243,1634,2,1,16063
2/16/2020,9,9559,826,4058,1474,19,0,15936
2/16/2020,10,9562,850,4310,1476,61,0,16259
2/16/2020,11,9560,1005,4058,1191,116,0,15930
2/16/2020,12,9560,1065,3975,1046,163,0,15809
2/16/2020,13,9560,1199,4288,892,205,0,16144
2/16/2020,14,9559,1230,4230,1206,221,0,16446
2/16/2020,15,9564,1263,4013,1061,215,1,16117
2/16/2020,16,9562,1301,4130,762,150,30,15935
2/16/2020,17,9558,1040,4641,1069,109,67,16484
2/16/2020,18,9557,1021,5245,1143,18,69,17053
2/16/2020,19,9554,1024,5951,1215,0,73,17817
2/16/2020,20,9559,1025,5452,1324,0,75,17435
2/16/2020,21,9556,861,5081,1297,0,74,16869
2/16/2020,22,9558,673,5146,1165,0,72,16614
2/16/2020,23,9558,851,4549,1244,0,22,16224
2/16/2020,24,9555,575,4146,1237,0,1,15514
2/17/2020,1,9558,689,4256,947,0,3,15453
2/17/2020,2,9556,580,3723,840,0,4,14703
2/17/2020,3,9552,705,3437,734,0,0,14428
2/17/2020,4,9554,937,3337,605,0,0,14433
2/17/2020,5,9554,1058,3721,642,0,0,14975
2/17/2020,6,9554,900,3669,765,0,0,14888
2/17/2020,7,9552,854,4317,800,2,0,15525
2/17/2020,8,9557,857,4810,750,9,0,15983
2/17/2020,9,9556,898,4839,645,76,0,16014
2/17/2020,10,9556,1036,4900,494,185,0,16171
2/17/2020,11,9559,1080,4920,440,300,0,16299
2/17/2020,12,9553,1241,4551,523,304,0,16172
2/17/2020,13,9549,1355,4558,607,294,0,16363
2/17/2020,14,9552,997,4076,744,272,0,15641
2/17/2020,15,9558,1000,3914,717,291,0,15480
2/17/2020,16,9558,916,4214,697,251,0,15636
2/17/2020,17,9560,811,4828,1340,112,0,16651
2/17/2020,18,9553,870,5464,1387,11,0,17285
2/17/2020,19,9553,1040,5864,1686,0,0,18143
2/17/2020,20,9556,839,5567,2053,0,0,18015
2/17/2020,21,9552,808,5064,2483,0,0,17907
2/17/2020,22,9555,479,4395,2952,0,0,17381
2/17/2020,23,9553,397,3993,3102,0,0,17045
2/17/2020,24,9557,237,3757,2896,0,0,16447
2/18/2020,1,9551,205,3617,2912,0,0,16285
2/18/2020,2,9551,210,3700,3000,0,12,16473
2/18/2020,3,9550,213,3638,2904,0,12,16317
2/18/2020,4,9545,213,3597,2936,0,12,16303
2/18/2020,5,9546,291,3741,2926,0,13,16517
2/18/2020,6,9550,316,3999,2950,0,14,16829
2/18/2020,7,9550,311,4349,3413,0,24,17647
2/18/2020,8,9558,308,4515,3610,0,27,18018
2/18/2020,9,9557,310,4654,3919,6,27,18473
2/18/2020,10,9558,447,5200,3999,14,27,19245
2/18/2020,11,9557,552,5132,3962,27,27,19257
2/18/2020,12,9540,599,4436,4171,47,27,18820
2/18/2020,13,9561,780,4200,4341,54,28,18964
2/18/2020,14,9560,1236,4283,3799,95,28,19001
2/18/2020,15,9558,1464,4423,3810,82,27,19364
2/18/2020,16,9553,1662,4571,3954,67,27,19834
2/18/2020,17,9543,1908,4889,3977,43,27,20387
2/18/2020,18,9548,2072,5432,3819,12,27,20910
2/18/2020,19,9547,2034,5742,3479,0,29,20831
2/18/2020,20,9543,2000,5434,3196,0,28,20201
2/18/2020,21,9541,1586,5323,3197,0,27,19674
2/18/2020,22,9544,959,4509,3143,0,27,18182
2/18/2020,23,9543,319,4381,3082,0,27,17352
2/18/2020,24,9550,208,3739,2992,0,16,16505
2/19/2020,1,9556,207,3532,2939,0,12,16246
2/19/2020,2,9555,219,3764,2497,0,9,16044
2/19/2020,3,9549,228,3899,2598,0,10,16284
2/19/2020,4,9548,310,3826,2628,0,10,16322
2/19/2020,5,9551,573,3569,2828,0,10,16531
2/19/2020,6,9550,973,3629,2172,0,15,16339
2/19/2020,7,9550,1149,4323,2645,1,24,17692
2/19/2020,8,9552,1386,4869,2701,18,27,18553
2/19/2020,9,9551,1470,5051,2420,109,27,18628
2/19/2020,10,9545,1436,4726,1882,209,27,17825
2/19/2020,11,9551,1445,4523,2045,297,27,17888
2/19/2020,12,9555,1535,4414,1697,354,27,17582
2/19/2020,13,9552,1681,4452,1702,333,27,17747
2/19/2020,14,9553,1958,4461,1178,313,27,17490
2/19/2020,15,9550,2014,4429,938,264,27,17222
2/19/2020,16,9555,2104,4549,1041,213,44,17506
2/19/2020,17,9549,2184,4864,1456,121,69,18243
2/19/2020,18,9553,2200,5306,1848,25,82,19014
2/19/2020,19,9556,2359,5712,1830,0,137,19594
2/19/2020,20,9559,2289,5752,1875,0,140,19615
2/19/2020,21,9558,2035,5464,1794,0,84,18935
2/19/2020,22,9548,2040,5082,1793,0,90,18553
2/19/2020,23,9544,1552,4219,2032,0,78,17425
2/19/2020,24,9550,1131,3737,2037,0,59,16514
2/20/2020,1,9543,752,3629,2047,0,13,15984
2/20/2020,2,9544,859,3515,2042,0,10,15970
2/20/2020,3,9548,883,3608,2058,0,9,16106
2/20/2020,4,9548,1141,4051,1590,0,9,16339
2/20/2020,5,9544,1562,3881,1380,0,10,16377
2/20/2020,6,9548,1944,4027,1215,0,14,16748
2/20/2020,7,9553,2612,4969,1188,3,24,18349
2/20/2020,8,9546,2858,5216,1213,18,27,18878
2/20/2020,9,9547,2849,5274,1386,148,28,19232
2/20/2020,10,9550,2378,5091,1617,269,28,18933
2/20/2020,11,9547,2431,4819,1493,301,27,18618
2/20/2020,12,9552,2690,4659,1395,295,28,18619
2/20/2020,13,9550,3148,4555,1133,330,27,18743
2/20/2020,14,9550,2943,4496,1081,308,27,18405
2/20/2020,15,9549,2976,4803,1220,262,28,18838
2/20/2020,16,9544,2973,4766,981,209,50,18523
2/20/2020,17,9550,3176,4836,787,110,76,18535
2/20/2020,18,9552,3639,5550,985,19,108,19853
2/20/2020,19,9552,4262,5588,982,0,183,20567
2/20/2020,20,9555,4316,5528,1059,0,199,20657
2/20/2020,21,9552,4311,5368,1075,0,200,20506
2/20/2020,22,9560,3388,5054,1204,0,194,19400
2/20/2020,23,9566,2971,4809,1427,0,188,18961
2/20/2020,24,9562,1812,4167,1801,0,92,17434
2/21/2020,1,9562,1019,4215,1873,0,68,16737
2/21/2020,2,9566,659,4348,1972,0,66,16611
2/21/2020,3,9565,565,4046,2182,0,71,16429
2/21/2020,4,9569,643,3800,2192,0,80,16284
2/21/2020,5,9567,1015,4319,2024,0,85,17010
2/21/2020,6,9567,1569,4693,1965,0,85,17879
2/21/2020,7,9570,2301,4844,2207,2,93,19017
2/21/2020,8,9567,2493,5437,2420,32,95,20044
2/21/2020,9,9560,2585,5151,2216,172,92,19776
2/21/2020,10,9561,2536,4795,2439,317,91,19739
2/21/2020,11,9554,2418,4720,2178,390,59,19319
2/21/2020,12,9559,1954,4409,2148,416,40,18526
2/21/2020,13,9560,1863,4299,2618,414,40,18794
2/21/2020,14,9561,1643,4204,2843,426,37,18714
2/21/2020,15,9557,1446,4166,2873,417,27,18486
2/21/2020,16,9553,1399,4150,3078,335,25,18540
2/21/2020,17,9554,1488,4570,2783,184,26,18605
2/21/2020,18,9565,1704,4605,3713,34,26,19647
2/21/2020,19,9564,1710,4542,4393,0,26,20235
2/21/2020,20,9562,1701,4485,4087,0,27,19862
2/21/2020,21,9566,1646,4372,3981,0,27,19592
2/21/2020,22,9566,887,4253,3914,0,27,18647
2/21/2020,23,9570,557,3640,4316,0,27,18110
2/21/2020,24,9570,374,3545,4079,0,16,17584
2/22/2020,1,9575,279,3333,3927,0,10,17124
2/22/2020,2,9575,280,3340,3844,0,0,17039
2/22/2020,3,9575,280,3384,3730,0,0,16969
2/22/2020,4,9567,280,3336,3251,0,0,16434
2/22/2020,5,9563,434,3380,3358,0,0,16735
2/22/2020,6,9560,542,3308,3338,0,0,16748
2/22/2020,7,9561,654,3438,3325,2,0,16980
2/22/2020,8,9553,662,3670,3312,28,0,17225
2/22/2020,9,9547,658,3675,3119,169,0,17168
2/22/2020,10,9540,658,3815,2771,320,0,17104
2/22/2020,11,9548,659,3781,2866,411,0,17265
2/22/2020,12,9551,659,3794,2659,426,0,17089
2/22/2020,13,9549,698,3656,2931,431,0,17265
2/22/2020,14,9553,743,3705,2398,429,0,16828
2/22/2020,15,9506,847,3770,2520,407,0,17050
2/22/2020,16,9535,1016,4098,2300,308,0,17257
2/22/2020,17,9535,1078,4359,2440,164,0,17576
2/22/2020,18,9528,1069,4755,2870,32,0,18254
2/22/2020,19,9540,1069,4514,3161,0,2,18286
2/22/2020,20,9549,1069,4296,3183,0,5,18102
2/22/2020,21,9553,1070,4298,3436,0,1,18358
2/22/2020,22,9545,734,3838,3790,0,0,17907
2/22/2020,23,9547,683,3534,3660,0,0,17424
2/22/2020,24,9562,682,3061,3204,0,0,16509
2/23/2020,1,9553,454,3005,3308,0,0,16320
2/23/2020,2,9553,272,3092,3111,0,0,16028
2/23/2020,3,9556,271,3100,3117,0,0,16044
2/23/2020,4,9566,273,3009,3118,0,0,15966
2/23/2020,5,9570,273,2990,2845,0,0,15678
2/23/2020,6,9573,153,3073,2907,0,0,15706
2/23/2020,7,9575,145,3234,2950,2,0,15906
2/23/2020,8,9577,145,3533,2883,26,0,16164
2/23/2020,9,9567,144,3636,2403,170,0,15920
2/23/2020,10,9565,143,3782,2141,296,0,15927
2/23/2020,11,9567,143,3822,2003,384,0,15919
2/23/2020,12,9570,144,3686,2346,415,0,16161
2/23/2020,13,9389,143,3686,2831,372,0,16421
2/23/2020,14,9538,142,3664,2622,399,0,16365
2/23/2020,15,9576,144,3777,2747,344,0,16588
2/23/2020,16,9573,143,3980,2277,297,0,16270
2/23/2020,17,9571,142,4575,2362,157,0,16807
2/23/2020,18,9575,143,4850,3309,29,0,17906
2/23/2020,19,9571,144,4813,3718,0,0,18246
2/23/2020,20,9573,143,4765,4168,0,0,18649
2/23/2020,21,9582,143,4679,4099,0,0,18503
2/23/2020,22,9580,142,4209,4247,0,0,18178
2/23/2020,23,9574,142,3700,4094,0,0,17510
2/23/2020,24,9575,142,3522,3176,0,0,16415
2/24/2020,1,9578,167,3425,2893,0,0,16063
2/24/2020,2,9575,191,3444,2707,0,10,15927
2/24/2020,3,9580,255,3431,2764,0,8,16038
2/24/2020,4,9566,342,3336,2676,0,9,15929
2/24/2020,5,9562,635,3476,1809,0,9,15491
2/24/2020,6,9571,1078,3737,1804,0,14,16204
2/24/2020,7,9565,1285,4155,2027,2,19,17053
2/24/2020,8,9549,1386,4598,1722,36,26,17317
2/24/2020,9,9557,1268,5181,1184,160,26,17376
2/24/2020,10,9560,1195,5140,838,263,27,17023
2/24/2020,11,9557,1275,4978,525,311,27,16673
2/24/2020,12,9553,1253,4409,510,309,27,16061
2/24/2020,13,9553,1289,4160,268,339,26,15635
2/24/2020,14,9560,1421,4311,245,284,29,15850
2/24/2020,15,9569,2059,4945,299,229,44,17145
2/24/2020,16,9573,1880,4940,290,128,79,16890
2/24/2020,17,9564,1858,5010,189,53,80,16754
2/24/2020,18,9566,2305,5457,240,12,117,17697
2/24/2020,19,9564,2423,5557,248,0,154,17946
2/24/2020,20,9561,2252,5491,263,0,107,17674
2/24/2020,21,9562,1628,5356,338,0,88,16972
2/24/2020,22,9553,1239,5124,423,0,99,16438
2/24/2020,23,9558,881,4536,614,0,38,15627
2/24/2020,24,9572,529,4099,899,0,18,15117
2/25/2020,1,9568,401,3618,1082,0,13,14682
2/25/2020,2,9565,303,3415,1019,0,11,14313
2/25/2020,3,9561,221,3373,1128,0,10,14293
2/25/2020,4,9570,335,3420,1383,0,10,14718
2/25/2020,5,9572,775,3509,1099,0,11,14966
2/25/2020,6,9571,1152,3524,743,0,12,15002
2/25/2020,7,9562,1247,3980,1356,1,28,16174
2/25/2020,8,9565,1364,4759,2042,6,30,17766
2/25/2020,9,9556,1708,4708,1796,47,29,17844
2/25/2020,10,9553,1361,4662,1652,93,27,17348
2/25/2020,11,9556,1229,4615,1606,149,27,17182
2/25/2020,12,9554,1183,4644,1537,208,28,17154
2/25/2020,13,9552,1216,4363,1664,188,28,17011
2/25/2020,14,9555,1371,4179,1721,170,28,17024
2/25/2020,15,9561,1652,4150,1823,141,27,17354
2/25/2020,16,9556,1706,4124,2125,92,27,17630
2/25/2020,17,9557,1415,4388,2159,53,27,17599
2/25/2020,18,9549,1432,4565,2365,10,27,17948
2/25/2020,19,9551,1581,4931,2550,0,26,18639
2/25/2020,20,9551,1581,4923,2649,0,26,18730
2/25/2020,21,9555,1159,4564,2720,0,26,18024
2/25/2020,22,9566,684,4428,2640,0,26,17344
2/25/2020,23,9554,440,3894,2613,0,26,16527
2/25/2020,24,9568,261,3686,2355,0,19,15889
2/26/2020,1,9574,222,3430,2387,0,13,15626
2/26/2020,2,9576,225,3451,2364,0,10,15626
2/26/2020,3,9570,346,3435,2401,0,10,15762
2/26/2020,4,9575,492,3406,2096,0,10,15579
2/26/2020,5,9568,746,3549,1638,0,11,15512
2/26/2020,6,9567,962,3774,1998,0,13,16314
2/26/2020,7,9560,1109,4265,2031,1,23,16989
2/26/2020,8,9570,1280,4976,2341,2,27,18196
2/26/2020,9,9564,1618,4924,2349,11,27,18493
2/26/2020,10,9563,1904,5020,2134,30,27,18678
2/26/2020,11,9560,2155,4888,2035,50,29,18717
2/26/2020,12,9560,1733,4760,2189,66,28,18336
2/26/2020,13,9560,1510,4734,2270,67,32,18173
2/26/2020,14,9552,1594,4836,2273,64,34,18353
2/26/2020,15,9559,1980,4987,2136,54,28,18744
2/26/2020,16,9567,2197,5031,2103,37,27,18962
2/26/2020,17,9556,2123,5339,2185,20,27,19250
2/26/2020,18,9563,2026,5323,2285,3,27,19227
2/26/2020,19,9556,1904,4979,2487,0,26,18952
2/26/2020,20,9558,1832,4617,2831,0,27,18865
2/26/2020,21,9558,1832,4659,3029,0,27,19105
2/26/2020,22,9562,1581,4915,2990,0,27,19075
2/26/2020,23,9563,1411,4524,3025,0,27,18550
2/26/2020,24,9563,750,3865,3084,0,17,17279
2/27/2020,1,9561,659,3912,3169,0,12,17313
2/27/2020,2,9564,283,3628,3275,0,12,16762
2/27/2020,3,9564,300,3396,3362,0,12,16634
2/27/2020,4,9570,391,3367,3325,0,11,16664
2/27/2020,5,9577,447,3360,3445,0,12,16841
2/27/2020,6,9575,511,3666,3508,0,13,17273
2/27/2020,7,9575,642,3902,3766,1,23,17909
2/27/2020,8,9576,1087,4479,4004,2,27,19175
2/27/2020,9,9571,1194,4391,4156,16,27,19355
2/27/2020,10,9567,1283,4480,4276,54,27,19687
2/27/2020,11,9570,1247,5002,4150,75,27,20071
2/27/2020,12,9567,1022,4852,4280,80,27,19828
2/27/2020,13,9575,951,4411,4268,92,27,19324
2/27/2020,14,9575,771,4486,4265,89,27,19213
2/27/2020,15,9579,711,4641,4267,77,27,19302
2/27/2020,16,9575,878,4559,4304,62,27,19405
2/27/2020,17,9576,1000,4597,4341,45,27,19586
2/27/2020,18,9572,1165,5149,4376,8,27,20297
2/27/2020,19,9570,1442,5325,4361,0,27,20725
2/27/2020,20,9563,1451,5146,4373,0,27,20560
2/27/2020,21,9566,1450,4866,4443,0,30,20355
2/27/2020,22,9568,1452,4732,4478,0,30,20260
2/27/2020,23,9566,956,4129,4426,0,27,19104
2/27/2020,24,9561,876,3742,4034,0,15,18228
2/28/2020,1,9561,479,3688,4153,0,13,17894
2/28/2020,2,9559,252,3653,4297,0,12,17773
2/28/2020,3,9555,256,3607,4054,0,11,17483
2/28/2020,4,9558,263,3549,4205,0,10,17585
2/28/2020,5,9560,266,3557,3870,0,10,17263
2/28/2020,6,9554,376,3758,3772,0,11,17471
2/28/2020,7,9563,512,4609,3907,1,19,18611
2/28/2020,8,9563,832,5070,3894,10,26,19395
2/28/2020,9,9564,941,5188,3843,54,27,19617
2/28/2020,10,9560,951,5198,3825,89,27,19650
2/28/2020,11,9563,1001,4958,3784,170,30,19506
2/28/2020,12,9565,1016,4571,3826,262,30,19270
2/28/2020,13,9563,1034,4281,3856,287,28,19049
2/28/2020,14,9562,1079,4254,3818,290,26,19029
2/28/2020,15,9567,1202,4120,3883,248,28,19048
2/28/2020,16,9567,1430,4184,3784,139,45,19149
2/28/2020,17,9567,1467,4766,3835,77,73,19785
2/28/2020,18,9561,1539,5280,3572,17,83,20052
2/28/2020,19,9559,1596,5412,3486,0,80,20133
2/28/2020,20,9559,1583,4868,3546,0,78,19634
2/28/2020,21,9554,1523,5008,3575,0,76,19736
2/28/2020,22,9555,1157,4804,3546,0,76,19138
2/28/2020,23,9553,1113,4634,3406,0,79,18785
2/28/2020,24,9560,925,4196,3292,0,26,17999
2/29/2020,1,9556,668,3829,3088,0,1,17142
2/29/2020,2,9554,630,3920,2770,0,0,16874
2/29/2020,3,9561,637,4041,2597,0,0,16836
2/29/2020,4,9565,638,4054,2726,0,0,16983
2/29/2020,5,9563,711,4021,2599,0,0,16894
2/29/2020,6,9558,960,4395,2337,0,0,17250
2/29/2020,7,9558,1261,4496,2264,2,0,17581
2/29/2020,8,9563,1234,5000,2110,23,0,17930
2/29/2020,9,9559,1221,5091,2121,87,0,18079
2/29/2020,10,9559,1349,5205,1986,189,0,18288
2/29/2020,11,9561,1150,4988,2283,243,0,18225
2/29/2020,12,9554,1036,4607,2159,290,0,17646
2/29/2020,13,9558,1119,4533,2193,328,0,17731
2/29/2020,14,9563,1217,4053,2397,325,0,17555
2/29/2020,15,9563,1461,4014,2259,305,1,17603
2/29/2020,16,9564,1759,4086,2254,264,23,17950
2/29/2020,17,9568,1924,4757,1933,164,53,18399
2/29/2020,18,9562,1840,5111,1759,40,51,18363
2/29/2020,19,9563,1846,5500,1558,0,51,18518
2/29/2020,20,9565,1959,5444,1629,0,63,18660
2/29/2020,21,9567,1693,5036,1842,0,50,18188
2/29/2020,22,9547,1514,4603,2098,0,49,17811
2/29/2020,23,9545,1086,3925,2184,0,51,16791
2/29/2020,24,9566,1009,3905,2139,0,6,16625
3/1/2020,1,9593,930,4086,1917,0,0,16526
3/1/2020,2,9596,987,4193,1723,0,0,16499
3/1/2020,3,9630,1103,4152,1503,0,0,16388
3/1/2020,4,9641,1167,3989,1422,0,0,16219
3/1/2020,5,9662,1144,4069,1280,0,0,16155
3/1/2020,6,9713,1440,4182,1031,0,0,16366
3/1/2020,7,9773,1650,4286,1163,2,0,16874
3/1/2020,8,9784,1068,4852,1153,61,0,16918
3/1/2020,9,9810,883,4982,1106,209,0,16990
3/1/2020,10,9834,817,5031,1175,337,0,17194
3/1/2020,11,9808,598,4946,1236,369,0,16957
3/1/2020,12,9809,337,4521,1824,351,0,16842
3/1/2020,13,9806,280,3937,2306,359,0,16688
3/1/2020,14,9807,537,3620,2283,359,0,16606
3/1/2020,15,9811,619,3632,2521,277,0,16860
3/1/2020,16,9810,731,4146,2654,223,0,17564
3/1/2020,17,9808,733,4774,3127,95,0,18537
3/1/2020,18,9815,737,5420,3417,23,0,19412
3/1/2020,19,9815,783,5748,3684,0,0,20030
3/1/2020,20,9818,770,5300,3797,0,0,19685
3/1/2020,21,9813,576,4603,4097,0,0,19089
3/1/2020,22,9832,345,4275,3846,0,0,18298
3/1/2020,23,9937,199,4079,3557,0,0,17772
3/1/2020,24,10004,198,3723,3083,0,0,17008
3/2/2020,1,10001,204,3543,2878,0,0,16626
3/2/2020,2,9994,202,3477,2211,0,10,15894
3/2/2020,3,10006,252,3447,2482,0,12,16199
3/2/2020,4,10019,301,3555,2478,0,13,16366
3/2/2020,5,10019,523,3476,2282,0,13,16313
3/2/2020,6,10021,896,3579,2060,0,15,16571
3/2/2020,7,10039,1081,4048,2626,2,22,17818
3/2/2020,8,10047,1049,4738,2691,12,49,18586
3/2/2020,9,10057,1067,4716,2838,29,52,18759
3/2/2020,10,10078,1071,4297,3053,56,53,18608
3/2/2020,11,10075,1119,4337,2951,62,53,18597
3/2/2020,12,10076,1304,4302,2796,56,37,18571
3/2/2020,13,10076,1263,4414,2670,72,41,18536
3/2/2020,14,10072,1289,4543,2378,90,35,18407
3/2/2020,15,10074,1728,4483,2013,86,32,18416
3/2/2020,16,10052,1977,4681,1653,78,28,18469
3/2/2020,17,10062,1559,5162,1375,53,27,18238
3/2/2020,18,10071,1252,5555,1287,13,27,18205
3/2/2020,19,10074,1224,5450,1343,0,27,18118
3/2/2020,20,10072,1246,5309,1295,0,27,17949
3/2/2020,21,10075,1261,5658,1015,0,27,18036
3/2/2020,22,10076,1498,5071,808,0,27,17480
3/2/2020,23,10072,978,4767,713,0,27,16557
3/2/2020,24,10086,943,4156,762,0,18,15965
3/3/2020,1,10085,924,3608,442,0,15,15074
3/3/2020,2,10087,854,3564,611,0,11,15127
3/3/2020,3,10091,832,3566,417,0,10,14916
3/3/2020,4,10077,896,3643,274,0,10,14900
3/3/2020,5,10065,1038,3552,239,0,10,14904
3/3/2020,6,10063,1248,3864,198,0,15,15388
3/3/2020,7,10065,1264,4701,239,1,24,16294
3/3/2020,8,10063,1553,4962,354,10,26,16968
3/3/2020,9,10061,1597,5149,381,46,26,17260
3/3/2020,10,10069,1592,5307,370,75,27,17440
3/3/2020,11,10078,1571,5503,250,100,26,17528
3/3/2020,12,10074,1436,5284,216,112,26,17148
3/3/2020,13,10075,1314,5065,192,98,26,16770
3/3/2020,14,10077,1308,5078,322,86,27,16898
3/3/2020,15,10076,1339,4832,668,77,27,17019
3/3/2020,16,10060,1122,4677,1115,59,26,17059
3/3/2020,17,10054,1160,4924,1438,27,27,17630
3/3/2020,18,10054,1398,5010,1675,14,27,18178
3/3/2020,19,10054,1402,4884,2082,0,27,18449
3/3/2020,20,10064,1405,5055,2406,0,33,18963
3/3/2020,21,10066,1542,4562,2835,0,27,19032
3/3/2020,22,10064,823,4275,3298,0,27,18487
3/3/2020,23,10065,423,3875,3126,0,26,17515
3/3/2020,24,10068,334,3716,2414,0,16,16548
3/4/2020,1,10089,227,3567,1954,0,11,15848
3/4/2020,2,10085,209,3437,1549,0,9,15289
3/4/2020,3,10083,207,3462,1207,0,9,14968
3/4/2020,4,10085,277,3436,1026,0,10,14834
3/4/2020,5,10080,369,3493,1176,0,11,15129
3/4/2020,6,10084,377,3480,1796,1,14,15752
3/4/2020,7,10083,490,3717,2349,3,22,16664
3/4/2020,8,10079,550,4274,2521,29,26,17479
3/4/2020,9,10083,701,4381,2444,89,26,17724
3/4/2020,10,10084,839,4272,2160,174,26,17555
3/4/2020,11,10083,845,4274,2230,170,26,17628
3/4/2020,12,10084,885,4430,1953,166,26,17544
3/4/2020,13,9948,892,4309,1940,182,26,17297
3/4/2020,14,10019,865,3915,2080,237,26,17142
3/4/2020,15,10087,771,3966,2134,207,26,17191
3/4/2020,16,10087,844,4103,2167,160,26,17387
3/4/2020,17,10083,1012,4598,2095,43,26,17857
3/4/2020,18,10082,1011,5144,1625,18,26,17906
3/4/2020,19,10086,1155,5678,1380,0,26,18325
3/4/2020,20,10082,1075,5389,1421,0,26,17993
3/4/2020,21,10078,1004,5216,1577,0,27,17902
3/4/2020,22,10078,896,4949,1627,0,27,17577
3/4/2020,23,10085,1014,4724,1555,0,26,17404
3/4/2020,24,10084,446,4233,1593,0,17,16373
3/5/2020,1,10088,244,4013,1556,0,14,15915
3/5/2020,2,10088,247,4089,1428,0,15,15867
3/5/2020,3,10064,326,3848,1164,0,15,15417
3/5/2020,4,10078,587,4005,819,0,14,15503
3/5/2020,5,10079,896,4095,442,0,14,15526
3/5/2020,6,10073,1223,3935,331,1,15,15578
3/5/2020,7,10068,1423,4420,420,1,21,16353
3/5/2020,8,10070,1378,4844,626,61,26,17005
3/5/2020,9,10071,1287,4628,892,205,26,17109
3/5/2020,10,10071,1300,4524,1034,342,26,17297
3/5/2020,11,10073,1421,4329,1120,407,27,17377
3/5/2020,12,10073,1310,4598,962,411,27,17381
3/5/2020,13,10070,1302,4391,870,406,27,17066
3/5/2020,14,10071,1317,4291,838,380,27,16924
3/5/2020,15,10069,1491,3920,859,377,28,16744
3/5/2020,16,10068,1510,4230,893,269,29,16999
3/5/2020,17,10073,1543,4427,1088,155,27,17313
3/5/2020,18,10073,1549,4661,1429,39,27,17778
3/5/2020,19,10073,1552,4634,1887,0,27,18173
3/5/2020,20,10075,1557,4822,1929,0,28,18411
3/5/2020,21,10081,1559,4551,2445,0,29,18665
3/5/2020,22,10083,1555,4432,2035,0,26,18131
3/5/2020,23,10082,2067,4622,1123,0,27,17921
3/5/2020,24,10076,1972,4223,870,0,19,17160
3/6/2020,1,10077,977,3771,940,0,16,15781
3/6/2020,2,10076,850,3628,897,0,16,15467
3/6/2020,3,10073,639,3541,1046,0,16,15315
3/6/2020,4,10075,497,3378,1059,0,16,15025
3/6/2020,5,10069,581,3658,1061,0,16,15385
3/6/2020,6,10062,656,3323,1206,0,22,15269
3/6/2020,7,10065,830,3944,1146,2,25,16012
3/6/2020,8,10072,1025,5011,1368,16,27,17519
3/6/2020,9,10070,1080,5242,1488,65,27,17972
3/6/2020,10,10073,1204,5279,1700,127,27,18410
3/6/2020,11,10073,1337,5047,2270,171,27,18925
3/6/2020,12,10043,1070,4430,2870,167,27,18607
3/6/2020,13,10044,1040,4023,3264,161,27,18559
3/6/2020,14,10042,1040,3526,3604,177,27,18416
3/6/2020,15,10044,1040,3597,3547,145,27,18400
3/6/2020,16,10044,1041,3686,3802,98,27,18698
3/6/2020,17,10058,1167,4304,3753,56,27,19365
3/6/2020,18,10059,1216,4816,3639,17,27,19774
3/6/2020,19,10061,978,4638,3789,0,27,19493
3/6/2020,20,10066,850,4677,3712,0,27,19332
3/6/2020,21,10057,845,4667,3650,0,27,19246
3/6/2020,22,10060,557,4344,3490,0,27,18478
3/6/2020,23,10063,234,4322,3236,0,27,17882
3/6/2020,24,10056,155,3856,2983,0,19,17069
3/7/2020,1,10063,153,3696,2795,0,11,16718
3/7/2020,2,10062,157,3792,2460,0,0,16471
3/7/2020,3,10062,235,3832,2010,0,0,16139
3/7/2020,4,10056,555,3934,1646,0,0,16191
3/7/2020,5,10060,835,3903,1278,0,0,16076
3/7/2020,6,10062,1168,4085,947,1,0,16263
3/7/2020,7,10066,1275,4325,561,3,0,16230
3/7/2020,8,10066,1314,4472,372,66,0,16290
3/7/2020,9,10063,1025,4767,303,203,1,16362
3/7/2020,10,10060,839,5067,230,333,0,16529
3/7/2020,11,10058,983,4973,199,410,0,16623
3/7/2020,12,10063,1039,4898,267,420,0,16687
3/7/2020,13,10062,1190,4480,494,410,0,16636
3/7/2020,14,10065,1018,3969,743,415,0,16210
3/7/2020,15,10068,964,3741,950,400,0,16123
3/7/2020,16,10067,966,3813,1064,332,0,16242
3/7/2020,17,10061,1022,4103,1444,206,0,16836
3/7/2020,18,10066,989,4610,1790,60,0,17515
3/7/2020,19,10063,1016,5127,2078,0,0,18284
3/7/2020,20,10065,1071,4861,2463,0,0,18460
3/7/2020,21,10066,857,4428,2713,0,0,18064
3/7/2020,22,10066,433,4182,2981,0,0,17662
3/7/2020,23,10064,172,3648,3172,0,0,17056
3/7/2020,24,10064,143,3232,3067,0,0,16506
3/8/2020,1,10041,143,3190,2810,0,0,16184
3/8/2020,2,10057,142,3220,3040,0,0,16459
3/8/2020,3,10065,143,3127,2925,0,0,16260
3/8/2020,4,10083,142,3177,2582,0,0,15984
3/8/2020,5,10080,142,3057,2653,0,0,15932
3/8/2020,6,10080,142,3233,2282,2,0,15739
3/8/2020,7,10082,142,3456,2363,3,0,16046
3/8/2020,8,10077,142,3693,2351,53,0,16316
3/8/2020,9,10096,141,3755,2577,174,0,16743
3/8/2020,10,10092,141,3718,2438,324,0,16713
3/8/2020,11,10094,141,3647,2292,393,2,16569
3/8/2020,12,10091,140,3487,2616,393,1,16728
3/8/2020,13,10096,139,3438,2774,412,0,16859
3/8/2020,14,10044,139,3429,2834,414,0,16860
3/8/2020,15,10089,139,3524,2745,382,0,16879
3/8/2020,16,10093,140,3663,3180,302,0,17378
3/8/2020,17,10088,139,3896,3751,143,0,18017
3/8/2020,18,10087,140,4280,3742,38,0,18287
3/8/2020,19,10087,141,4582,3974,0,0,18784
3/8/2020,20,10082,142,4271,3962,0,0,18457
3/8/2020,21,10086,142,3951,3756,0,2,17937
3/8/2020,22,10094,143,3548,3662,0,17,17464
3/8/2020,23,10092,143,3287,3517,0,29,17068
3/8/2020,24,10093,142,3222,3015,0,30,16502
3/9/2020,1,10097,142,3070,2849,0,29,16187
3/9/2020,2,10099,142,3121,2328,0,29,15719
3/9/2020,3,10097,142,3078,2379,0,31,15727
3/9/2020,4,10092,142,3094,2551,0,30,15909
3/9/2020,5,10089,143,3134,2928,0,38,16332
3/9/2020,6,10090,163,3279,3215,1,54,16802
3/9/2020,7,10086,199,3856,3754,3,60,17958
3/9/2020,8,10092,199,4058,3633,60,58,18100
3/9/2020,9,10088,201,3903,3110,180,59,17541
3/9/2020,10,10086,204,3863,2646,312,57,17168
3/9/2020,11,10085,203,4015,2665,344,63,17375
3/9/2020,12,10083,204,3852,2873,368,63,17443
3/9/2020,13,10087,204,3797,2896,337,65,17386
3/9/2020,14,10083,203,3657,2974,268,66,17251
3/9/2020,15,10086,204,3698,3186,236,63,17473
3/9/2020,16,10052,202,4240,2941,164,63,17662
3/9/2020,17,10037,202,4714,3299,66,63,18381
3/9/2020,18,10038,203,4915,3342,14,64,18576
3/9/2020,19,10039,202,4898,3478,0,66,18683
3/9/2020,20,10034,202,4748,3510,0,66,18560
3/9/2020,21,10040,202,4430,3790,0,60,18522
3/9/2020,22,10040,203,3904,3787,0,65,17999
3/9/2020,23,10045,202,3373,3601,0,60,17281
3/9/2020,24,10042,202,3212,3381,0,50,16887
3/10/2020,1,10029,202,3026,3275,0,48,16580
3/10/2020,2,10031,201,3103,2746,0,42,16123
3/10/2020,3,10028,201,3074,2746,0,43,16092
3/10/2020,4,10029,201,3037,2864,0,41,16172
3/10/2020,5,10029,201,3086,2989,0,46,16351
3/10/2020,6,10030,208,3268,3147,0,50,16703
3/10/2020,7,10032,209,3859,3871,2,57,18030
3/10/2020,8,10025,267,4216,3878,3,57,18446
3/10/2020,9,10022,310,4134,3608,13,57,18144
3/10/2020,10,10024,452,3759,3769,27,53,18084
3/10/2020,11,10021,770,3841,3497,46,53,18228
3/10/2020,12,10018,904,3593,3549,69,61,18194
3/10/2020,13,10013,880,3981,3314,91,85,18364
3/10/2020,14,10003,904,4058,2885,127,98,18075
3/10/2020,15,10006,975,3858,2586,123,105,17653
3/10/2020,16,10011,1215,4132,2231,141,102,17832
3/10/2020,17,10015,1225,4557,1944,119,101,17961
3/10/2020,18,10019,1258,4907,1447,59,102,17792
3/10/2020,19,10025,1457,5620,1036,1,110,18249
3/10/2020,20,10024,1779,5678,914,0,105,18500
3/10/2020,21,10013,1511,5453,657,0,101,17735
3/10/2020,22,10019,1283,5091,457,0,106,16956
3/10/2020,23,10021,688,4671,386,0,111,15877
3/10/2020,24,10024,579,4469,282,0,167,15521
3/11/2020,1,10024,620,3914,167,0,194,14919
3/11/2020,2,10025,730,3851,117,0,149,14872
3/11/2020,3,10013,948,3548,111,0,93,14713
3/11/2020,4,10004,1161,3607,125,0,90,14987
3/11/2020,5,10011,1469,3270,153,0,94,14997
3/11/2020,6,10021,1464,3969,130,1,102,15687
3/11/2020,7,10017,1867,4886,172,4,115,17061
3/11/2020,8,10013,1641,4923,298,67,111,17053
3/11/2020,9,10014,1270,4767,479,141,115,16786
3/11/2020,10,10016,1242,4770,373,155,112,16668
3/11/2020,11,10019,1360,4346,330,194,165,16414
3/11/2020,12,9880,1353,4233,244,208,254,16172
3/11/2020,13,9886,1306,4026,240,241,267,15966
3/11/2020,14,10015,1280,3697,130,195,267,15584
3/11/2020,15,10015,1287,3989,196,182,267,15936
3/11/2020,16,10013,1428,4515,233,107,204,16500
3/11/2020,17,10012,1567,5195,262,64,133,17233
3/11/2020,18,10013,1352,5234,259,26,111,16995
3/11/2020,19,10019,1274,5654,303,3,116,17369
3/11/2020,20,10015,1347,5757,298,0,107,17524
3/11/2020,21,10013,1399,5572,447,0,98,17529
3/11/2020,22,10017,1286,5150,506,0,62,17021
3/11/2020,23,10024,620,4883,511,0,48,16086
3/11/2020,24,10024,415,4111,577,0,40,15167
3/12/2020,1,10032,320,4068,496,0,38,14954
3/12/2020,2,10031,374,4215,503,0,35,15158
3/12/2020,3,10025,563,3881,480,0,33,14982
3/12/2020,4,10019,774,3661,430,0,34,14918
3/12/2020,5,10018,947,3475,387,0,35,14862
3/12/2020,6,10017,1068,4161,357,1,43,15647
3/12/2020,7,10019,1521,5291,384,1,53,17269
3/12/2020,8,10022,1704,5417,400,29,48,17620
3/12/2020,9,10023,1574,5314,468,104,47,17530
3/12/2020,10,10024,1407,5042,486,146,56,17161
3/12/2020,11,10020,1369,4606,607,228,48,16878
3/12/2020,12,10018,1419,4584,761,263,46,17091
3/12/2020,13,10016,1398,4332,980,259,46,17031
3/12/2020,14,10015,1548,4372,975,242,42,17194
3/12/2020,15,10018,1636,4373,1151,223,44,17445
3/12/2020,16,10018,1122,4542,1332,125,54,17193
3/12/2020,17,10015,1011,4719,1847,66,90,17748
3/12/2020,18,10015,945,4583,2072,19,96,17730
3/12/2020,19,10009,875,4672,2642,0,99,18297
3/12/2020,20,10014,841,4740,2705,0,100,18400
3/12/2020,21,10016,484,4545,2827,0,99,17971
3/12/2020,22,10020,291,4201,2726,0,99,17337
3/12/2020,23,10023,203,4055,2628,0,40,16949
3/12/2020,24,10022,208,3879,2663,0,30,16802
3/13/2020,1,10021,201,3133,3028,0,28,16411
3/13/2020,2,10028,201,3015,2896,0,26,16166
3/13/2020,3,10028,200,3104,3024,0,24,16380
3/13/2020,4,10033,199,3024,3328,0,27,16611
3/13/2020,5,10021,199,3111,3392,0,30,16753
3/13/2020,6,10024,200,3374,3603,0,37,17238
3/13/2020,7,10020,200,3762,4315,2,45,18344
3/13/2020,8,9995,200,4341,4331,15,28,18910
3/13/2020,9,9982,200,4312,4406,39,41,18980
3/13/2020,10,9992,200,4205,4061,126,41,18625
3/13/2020,11,10007,198,4126,4124,226,30,18711
3/13/2020,12,10003,200,3971,4257,229,26,18686
3/13/2020,13,10009,201,3710,4204,224,26,18374
3/13/2020,14,10011,201,3755,4229,211,26,18433
3/13/2020,15,10014,201,3554,4245,213,26,18253
3/13/2020,16,10015,201,3653,3823,149,26,17867
3/13/2020,17,10012,200,3997,3862,88,31,18190
3/13/2020,18,10015,202,4468,3924,24,26,18659
3/13/2020,19,10018,202,4826,3876,1,26,18949
3/13/2020,20,10016,240,4983,3856,0,26,19121
3/13/2020,21,10019,211,4616,3747,0,26,18619
3/13/2020,22,10020,214,4104,3660,0,26,18024
3/13/2020,23,10015,180,3619,3587,0,11,17412
3/13/2020,24,10013,167,3317,3411,0,1,16909
3/14/2020,1,10016,146,3170,3533,0,0,16865
3/14/2020,2,10017,149,3129,3446,0,0,16741
3/14/2020,3,10018,193,3275,3049,0,0,16535
3/14/2020,4,10014,246,3369,2587,0,0,16216
3/14/2020,5,10013,354,3377,2369,0,0,16113
3/14/2020,6,10018,531,3549,2001,1,2,16102
3/14/2020,7,10019,601,3996,1664,5,26,16311
3/14/2020,8,10013,625,4427,1325,71,52,16513
3/14/2020,9,10016,795,4663,1194,153,59,16880
3/14/2020,10,10017,832,4636,920,204,71,16680
3/14/2020,11,10012,1149,4543,719,224,118,16765
3/14/2020,12,10020,1327,4626,621,232,128,16954
3/14/2020,13,10017,1193,4379,636,244,118,16587
3/14/2020,14,10019,1146,4033,602,241,63,16104
3/14/2020,15,10021,1170,3942,670,212,88,16103
3/14/2020,16,10023,1165,4519,783,160,84,16734
3/14/2020,17,10026,1285,5088,850,82,102,17433
3/14/2020,18,10027,1276,5149,877,23,88,17440
3/14/2020,19,10032,1220,5372,1208,0,78,17910
3/14/2020,20,10029,1158,4948,1184,0,63,17382
3/14/2020,21,10037,1160,5278,964,0,64,17503
3/14/2020,22,10029,469,4920,923,0,79,16420
3/14/2020,23,10027,188,4196,966,0,21,15398
3/14/2020,24,10018,151,4018,1098,0,12,15297
3/15/2020,1,10019,142,3589,1383,0,13,15146
3/15/2020,2,10025,143,3449,1456,0,13,15086
3/15/2020,3,10004,142,3417,1580,0,2,15145
3/15/2020,4,10032,142,3282,1612,0,0,15068
3/15/2020,5,10032,142,3540,1641,0,0,15355
3/15/2020,6,10032,145,3392,1592,2,0,15163
3/15/2020,7,10022,153,3589,1501,7,0,15272
3/15/2020,8,10009,155,4363,1305,102,0,15934
3/15/2020,9,10011,155,4289,1334,262,0,16051
3/15/2020,10,10009,239,4030,1109,389,0,15776
3/15/2020,11,10008,253,4084,923,426,0,15694
3/15/2020,12,10044,445,4136,717,429,0,15771
3/15/2020,13,10070,712,3997,563,429,0,15771
3/15/2020,14,10071,833,3902,610,429,0,15845
3/15/2020,15,10085,970,3755,697,424,1,15932
3/15/2020,16,10086,973,3896,497,360,20,15832
3/15/2020,17,10075,1016,4434,915,239,52,16731
3/15/2020,18,10074,1161,4858,956,80,56,17185
3/15/2020,19,10071,1356,5943,662,3,72,18107
3/15/2020,20,10076,1645,5890,677,0,111,18399
3/15/2020,21,10074,1241,5516,738,0,65,17634
3/15/2020,22,10069,510,4891,855,0,47,16372
3/15/2020,23,10078,329,4745,973,0,54,16179
3/15/2020,24,10071,257,4256,1095,0,77,15756
3/16/2020,1,10075,176,3650,1375,0,20,15296
3/16/2020,2,10075,165,3654,1463,0,16,15373
3/16/2020,3,10073,245,3462,1661,0,18,15459
3/16/2020,4,10080,526,3378,1874,0,14,15872
3/16/2020,5,10066,893,3318,1785,0,16,16078
3/16/2020,6,10083,1011,3543,2273,1,31,16942
3/16/2020,7,10082,1035,4164,2472,8,31,17792
3/16/2020,8,10076,1081,4519,2096,92,27,17891
3/16/2020,9,10073,1213,4695,1574,228,27,17810
3/16/2020,10,10073,1217,4954,1323,288,26,17881
3/16/2020,11,10068,1255,5233,901,323,26,17806
3/16/2020,12,10069,1237,4377,634,334,27,16678
3/16/2020,13,10066,1241,4599,606,333,27,16872
3/16/2020,14,10061,1296,4829,503,330,28,17047
3/16/2020,15,10070,1307,4243,493,330,46,16489
3/16/2020,16,10071,1407,4392,515,229,74,16688
3/16/2020,17,10073,1644,5480,593,108,111,18009
3/16/2020,18,10076,1679,5803,703,28,145,18434
3/16/2020,19,10072,1549,5700,949,0,95,18365
3/16/2020,20,10068,1480,5714,1051,0,84,18397
3/16/2020,21,10072,1462,5500,1161,0,78,18273
3/16/2020,22,10075,1278,5118,1294,0,77,17842
3/16/2020,23,10075,514,4660,1608,0,27,16884
3/16/2020,24,10071,322,4017,1810,0,15,16235
3/17/2020,1,10074,263,3648,2002,0,14,16001
3/17/2020,2,10070,213,3318,1990,0,13,15604
3/17/2020,3,10075,217,3324,2176,0,12,15804
3/17/2020,4,10074,311,3328,2150,0,13,15876
3/17/2020,5,10072,478,3297,2355,0,13,16215
3/17/2020,6,10074,627,3488,2307,0,38,16534
3/17/2020,7,10071,819,4321,2538,1,76,17826
3/17/2020,8,10070,804,4657,2511,8,85,18135
3/17/2020,9,10072,834,4943,2430,28,91,18398
3/17/2020,10,10065,969,4856,2621,98,119,18728
3/17/2020,11,10079,965,4743,2817,117,102,18823
3/17/2020,12,10055,1002,4599,2847,130,97,18730
3/17/2020,13,10053,1029,4384,2758,131,103,18458
3/17/2020,14,10056,1053,4082,2619,221,85,18116
3/17/2020,15,10063,1212,4080,1897,235,83,17570
3/17/2020,16,10059,1061,4176,1688,230,83,17297
3/17/2020,17,10054,1027,4654,1923,183,83,17924
3/17/2020,18,10055,1042,4788,1741,65,83,17774
3/17/2020,19,10055,1051,5241,1816,5,83,18251
3/17/2020,20,10051,1060,5858,1668,0,83,18720
3/17/2020,21,10058,1068,5619,1468,0,83,18296
3/17/2020,22,10057,676,5361,1075,0,83,17252
3/17/2020,23,10066,695,5136,671,0,31,16599
3/17/2020,24,10060,466,4619,514,0,13,15672
3/18/2020,1,10057,378,4558,488,0,14,15495
3/18/2020,2,10061,372,4256,531,0,11,15231
3/18/2020,3,10060,457,4157,596,0,11,15281
3/18/2020,4,10064,694,3708,660,0,12,15138
3/18/2020,5,10063,1195,3691,722,0,13,15684
3/18/2020,6,10065,1448,3963,752,2,20,16250
3/18/2020,7,10062,1416,4719,1076,11,25,17309
3/18/2020,8,10064,1418,4875,1159,94,27,17637
3/18/2020,9,10065,1311,5250,987,160,28,17801
3/18/2020,10,10063,1062,5048,1038,227,43,17481
3/18/2020,11,10055,1143,5203,965,277,46,17689
3/18/2020,12,10050,1440,4824,1146,275,46,17781
3/18/2020,13,9912,1479,4755,1051,227,50,17474
3/18/2020,14,9955,1312,4688,970,207,48,17180
3/18/2020,15,10055,1458,4662,1060,138,63,17436
3/18/2020,16,10053,1479,4767,1509,109,83,18000
3/18/2020,17,10050,1423,5194,1523,59,84,18333
3/18/2020,18,10053,1420,5405,1565,22,87,18552
3/18/2020,19,10050,1417,5379,1667,1,82,18596
3/18/2020,20,10046,1419,5300,1528,0,82,18375
3/18/2020,21,10045,1262,4941,1762,0,83,18093
3/18/2020,22,10050,1228,4296,1853,0,81,17508
3/18/2020,23,10046,624,4133,1652,0,28,16483
3/18/2020,24,10043,398,3937,1441,0,13,15832
3/19/2020,1,10043,338,3886,1146,0,10,15423
3/19/2020,2,10047,431,3652,1060,0,9,15199
3/19/2020,3,10040,652,3759,691,0,15,15157
3/19/2020,4,10044,966,3742,599,0,17,15368
3/19/2020,5,10038,1253,3385,568,0,31,15275
3/19/2020,6,10037,1455,3974,395,2,70,15933
3/19/2020,7,10042,1622,5095,442,2,83,17286
3/19/2020,8,10038,1644,5168,295,20,86,17251
3/19/2020,9,10032,1604,5455,200,54,87,17432
3/19/2020,10,10028,1600,5299,184,125,91,17327
3/19/2020,11,10032,1836,5206,228,185,97,17584
3/19/2020,12,10033,1854,5129,244,168,110,17538
3/19/2020,13,10026,1813,4973,309,169,119,17409
3/19/2020,14,10027,1727,4994,414,115,95,17372
3/19/2020,15,10023,2012,4851,571,89,83,17629
3/19/2020,16,10022,2049,5068,710,60,78,17987
3/19/2020,17,10025,1685,5289,1164,35,79,18277
3/19/2020,18,10021,1600,5016,1765,11,80,18493
3/19/2020,19,10018,1604,4730,2158,0,80,18590
3/19/2020,20,10020,1495,4682,2366,0,81,18644
3/19/2020,21,10028,743,4587,2555,0,80,17993
3/19/2020,22,10033,440,3937,3064,0,36,17510
3/19/2020,23,10027,305,3603,2927,0,16,16878
3/19/2020,24,10035,216,3338,3255,0,14,16858
3/20/2020,1,10039,215,3239,3122,0,10,16625
3/20/2020,2,10035,213,3235,2956,0,9,16448
3/20/2020,3,10032,213,3129,2818,0,10,16202
3/20/2020,4,10034,212,3155,2923,0,9,16333
3/20/2020,5,10034,211,3233,2925,0,11,16414
3/20/2020,6,10030,211,3322,2997,0,17,16577
3/20/2020,7,10032,211,3640,3344,1,28,17256
3/20/2020,8,10030,211,3864,3586,7,30,17728
3/20/2020,9,10026,212,3968,3405,28,31,17670
3/20/2020,10,10009,214,3866,3594,71,46,17800
3/20/2020,11,9984,214,3722,3371,148,40,17479
3/20/2020,12,9974,216,3720,3639,129,38,17716
3/20/2020,13,9997,231,3732,3286,202,37,17485
3/20/2020,14,10013,232,3807,3010,250,36,17348
3/20/2020,15,10016,251,3954,2693,249,36,17199
3/20/2020,16,10016,255,4052,3407,131,35,17896
3/20/2020,17,10015,258,4387,3832,80,29,18601
3/20/2020,18,10017,262,4693,3873,27,26,18898
3/20/2020,19,10016,276,4942,3820,0,26,19080
3/20/2020,20,10015,275,4978,3745,0,26,19039
3/20/2020,21,10011,271,4764,3587,0,26,18659
3/20/2020,22,10008,270,4260,3293,0,26,17857
3/20/2020,23,10008,268,3991,3028,0,13,17308
3/20/2020,24,10021,232,3731,2732,0,3,16719
3/21/2020,1,10018,227,3546,2436,0,0,16227
3/21/2020,2,10018,266,3616,2258,0,0,16158
3/21/2020,3,10021,311,3803,2026,0,0,16161
3/21/2020,4,10017,427,3391,1885,0,0,15720
3/21/2020,5,10015,570,3276,1653,0,0,15514
3/21/2020,6,10010,672,3640,1486,1,0,15809
3/21/2020,7,10008,658,4032,1421,9,14,16142
3/21/2020,8,10011,697,4379,1163,75,44,16369
3/21/2020,9,10003,779,4368,882,217,53,16302
3/21/2020,10,9995,875,4252,711,346,54,16233
3/21/2020,11,9986,1008,4284,521,402,54,16255
3/21/2020,12,9997,1059,4280,413,414,54,16217
3/21/2020,13,10001,1083,4207,431,415,54,16191
3/21/2020,14,9966,891,3916,482,426,54,15735
3/21/2020,15,10000,800,3904,653,424,54,15835
3/21/2020,16,10006,691,4216,751,381,54,16099
3/21/2020,17,10004,673,5118,859,243,66,16963
3/21/2020,18,10008,692,5564,905,80,110,17359
3/21/2020,19,10001,724,5594,794,7,142,17262
3/21/2020,20,10002,718,5513,720,0,173,17126
3/21/2020,21,9993,535,4981,660,0,169,16338
3/21/2020,22,10000,538,4979,575,0,141,16233
3/21/2020,23,10001,585,4738,498,0,93,15915
3/21/2020,24,10001,371,4677,483,0,12,15544
3/22/2020,1,9991,300,4150,632,0,0,15073
3/22/2020,2,9989,217,3959,787,0,0,14952
3/22/2020,3,9993,218,3934,737,0,0,14882
3/22/2020,4,9991,205,3890,812,0,0,14898
3/22/2020,5,9989,198,3926,992,0,0,15105
3/22/2020,6,10003,199,4000,1167,1,0,15370
3/22/2020,7,10007,199,3900,1343,16,0,15465
3/22/2020,8,10003,199,3791,1509,127,0,15629
3/22/2020,9,10006,199,3927,1421,282,0,15835
3/22/2020,10,10005,201,3790,1578,389,0,15963
3/22/2020,11,9998,279,3704,1821,402,0,16204
3/22/2020,12,9998,289,3786,1831,406,0,16310
3/22/2020,13,9994,408,3756,1809,402,0,16369
3/22/2020,14,10004,421,3541,1805,404,0,16175
3/22/2020,15,10005,465,3608,1578,381,0,16037
3/22/2020,16,10005,495,4187,1753,312,0,16752
3/22/2020,17,10000,545,4857,1879,169,17,17467
3/22/2020,18,10002,626,5179,1989,51,44,17891
3/22/2020,19,9998,680,5451,2061,2,51,18243
3/22/2020,20,9988,665,5198,2233,0,53,18137
3/22/2020,21,9975,655,4451,2403,0,56,17540
3/22/2020,22,9662,655,3876,2371,0,56,16620
3/22/2020,23,9197,495,3911,2274,0,56,15933
3/22/2020,24,9195,464,3896,1870,0,12,15437
3/23/2020,1,9192,420,4365,1563,0,9,15549
3/23/2020,2,9196,487,4057,1313,0,11,15064
3/23/2020,3,9202,702,4092,1180,0,11,15187
3/23/2020,4,9200,853,3935,1313,0,13,15314
3/23/2020,5,9204,1265,3449,1437,0,45,15400
3/23/2020,6,9203,1481,3850,1267,0,76,15877
3/23/2020,7,9204,1902,4490,1061,3,82,16742
3/23/2020,8,9196,2362,4719,887,14,80,17258
3/23/2020,9,9191,2246,4744,632,31,79,16923
3/23/2020,10,9179,2431,4938,392,56,82,17078
3/23/2020,11,9180,2724,4687,280,75,93,17039
3/23/2020,12,9171,2952,4318,238,107,111,16897
3/23/2020,13,9174,2821,4364,286,95,171,16911
3/23/2020,14,9175,2595,4322,505,86,166,16849
3/23/2020,15,9172,2475,4309,674,72,100,16802
3/23/2020,16,9169,2576,4663,420,56,102,16986
3/23/2020,17,9171,2939,4785,340,32,91,17358
3/23/2020,18,9171,2822,4926,487,13,79,17498
3/23/2020,19,9170,2879,4978,507,1,77,17612
3/23/2020,20,9168,2827,4914,319,0,77,17305
3/23/2020,21,9167,2462,4430,161,0,77,16297
3/23/2020,22,9165,2253,4219,108,0,40,15785
3/23/2020,23,9166,2200,3602,90,0,17,15075
3/23/2020,24,9168,1846,3558,129,0,17,14718
3/24/2020,1,9176,1384,3729,199,0,9,14497
3/24/2020,2,9185,1468,3701,194,0,9,14557
3/24/2020,3,9181,1610,3879,132,0,9,14811
3/24/2020,4,9174,1681,3892,110,0,10,14867
3/24/2020,5,9175,1797,3872,89,0,12,14945
3/24/2020,6,9173,2055,3857,79,2,22,15188
3/24/2020,7,9178,2274,4479,72,6,27,16036
3/24/2020,8,9175,2289,4921,42,36,27,16490
3/24/2020,9,9178,2270,4920,29,98,27,16522
3/24/2020,10,9173,1918,4702,59,160,27,16039
3/24/2020,11,9174,1859,4425,129,205,27,15819
3/24/2020,12,9178,1832,4440,115,213,27,15805
3/24/2020,13,9173,1748,4252,141,208,27,15549
3/24/2020,14,9172,1868,4216,204,226,28,15714
3/24/2020,15,9174,1711,4066,214,200,30,15395
3/24/2020,16,9174,1750,4400,290,146,41,15801
3/24/2020,17,9173,1953,4942,347,60,75,16550
3/24/2020,18,9172,1896,5255,470,31,82,16906
3/24/2020,19,9174,1945,5236,585,4,78,17022
3/24/2020,20,9168,1853,5044,718,0,77,16860
3/24/2020,21,9335,1808,4888,827,0,77,16935
3/24/2020,22,9414,1180,4801,1160,0,80,16635
3/24/2020,23,9572,635,4152,1433,0,33,15825
3/24/2020,24,9606,504,4118,1353,0,16,15597
3/25/2020,1,9584,361,3832,1274,0,15,15066
3/25/2020,2,9644,288,3678,1058,0,14,14682
3/25/2020,3,9755,369,3610,980,0,14,14728
3/25/2020,4,9757,662,3661,821,0,14,14915
3/25/2020,5,9741,1046,3771,680,0,14,15252
3/25/2020,6,9735,1169,3853,613,3,20,15393
3/25/2020,7,9732,1317,4419,524,13,57,16062
3/25/2020,8,9731,1489,4693,426,67,83,16489
3/25/2020,9,9732,1700,4630,233,182,83,16560
3/25/2020,10,9731,1726,4745,219,191,84,16696
3/25/2020,11,9739,1810,4584,349,194,88,16764
3/25/2020,12,9789,1954,4231,454,208,85,16721
3/25/2020,13,9841,2023,4110,495,238,82,16789
3/25/2020,14,9835,2055,3907,283,207,83,16370
3/25/2020,15,9844,1980,3921,200,129,82,16156
3/25/2020,16,9850,1542,4289,464,192,82,16419
3/25/2020,17,9851,1279,4971,495,117,82,16795
3/25/2020,18,9846,1242,4957,463,54,83,16645
3/25/2020,19,9844,1256,5059,643,4,83,16889
3/25/2020,20,9837,1273,4968,868,0,84,17030
3/25/2020,21,9845,1250,4323,1276,0,84,16778
3/25/2020,22,9846,1214,3635,1215,0,84,15994
3/25/2020,23,9926,840,3441,1035,0,43,15285
3/25/2020,24,9984,358,3387,1504,0,11,15244
3/26/2020,1,9975,260,3239,1895,0,10,15379
3/26/2020,2,9984,259,3005,1890,0,9,15147
3/26/2020,3,9981,259,2957,2064,0,9,15270
3/26/2020,4,9988,258,2996,2161,0,10,15413
3/26/2020,5,9986,260,3130,2013,0,12,15401
3/26/2020,6,9985,270,3330,2182,2,21,15790
3/26/2020,7,9991,384,3512,2623,8,27,16545
3/26/2020,8,9983,567,3605,2759,56,28,16998
3/26/2020,9,9987,711,3578,2420,143,28,16867
3/26/2020,10,9985,771,3544,2439,271,27,17037
3/26/2020,11,9979,1152,3706,2150,294,27,17308
3/26/2020,12,9982,1380,3864,2135,258,32,17651
3/26/2020,13,9975,1421,3877,1743,264,33,17313
3/26/2020,14,9978,1430,3851,1487,219,33,16998
3/26/2020,15,9976,1447,4161,1260,123,30,16997
3/26/2020,16,9972,1519,4911,870,114,43,17429
3/26/2020,17,9976,1741,5261,647,71,82,17778
3/26/2020,18,9981,1120,4761,974,26,83,16945
3/26/2020,19,9983,928,4771,905,1,82,16670
3/26/2020,20,9978,864,4759,874,0,80,16555
3/26/2020,21,9982,697,5192,664,0,81,16616
3/26/2020,22,9986,705,4765,827,0,96,16379
3/26/2020,23,9985,468,4232,724,0,37,15446
3/26/2020,24,9991,273,4012,772,0,11,15059
3/27/2020,1,9997,326,3690,885,0,10,14908
3/27/2020,2,9996,343,3167,926,0,9,14441
3/27/2020,3,10002,396,3454,738,0,9,14599
3/27/2020,4,10004,584,3365,536,0,10,14499
3/27/2020,5,10017,859,3648,569,0,13,15106
3/27/2020,6,10020,1263,3937,566,1,19,15806
3/27/2020,7,10016,1512,4348,431,5,25,16337
3/27/2020,8,10021,1426,4722,355,39,25,16588
3/27/2020,9,10030,1582,4865,246,99,25,16847
3/27/2020,10,10028,1623,4730,87,178,25,16671
3/27/2020,11,10015,1378,4402,66,289,26,16176
3/27/2020,12,10014,1407,4009,98,321,26,15875
3/27/2020,13,10015,1228,3756,52,121,27,15199
3/27/2020,14,10018,972,3468,82,343,25,14908
3/27/2020,15,10020,740,3489,55,255,25,14584
3/27/2020,16,10018,692,3675,93,277,26,14781
3/27/2020,17,10025,615,4507,185,207,25,15564
3/27/2020,18,10046,665,5200,176,85,26,16198
3/27/2020,19,10044,579,5396,274,6,27,16326
3/27/2020,20,10042,590,5318,537,0,27,16514
3/27/2020,21,10035,341,4951,789,0,27,16143
3/27/2020,22,10032,262,4283,1017,0,27,15621
3/27/2020,23,10044,206,3891,1252,0,15,15408
3/27/2020,24,10041,205,3351,1270,0,7,14874
3/28/2020,1,10045,205,3254,1374,0,0,14878
3/28/2020,2,10043,205,3293,1325,0,0,14866
3/28/2020,3,10051,205,3240,1566,0,0,15062
3/28/2020,4,10056,204,3306,1433,0,0,14999
3/28/2020,5,10059,203,3315,1566,0,0,15143
3/28/2020,6,10057,203,3470,1359,1,0,15090
3/28/2020,7,10054,201,3533,1486,8,0,15282
3/28/2020,8,10054,204,3550,1575,33,0,15416
3/28/2020,9,10055,205,3731,2178,66,1,16236
3/28/2020,10,10053,204,4054,2261,89,1,16662
3/28/2020,11,10050,260,4515,2034,101,0,16960
3/28/2020,12,10049,375,4991,1883,135,0,17433
3/28/2020,13,10056,430,4301,1919,122,1,16829
3/28/2020,14,10060,375,3962,1957,124,0,16478
3/28/2020,15,10062,249,4234,1767,121,0,16433
3/28/2020,16,10061,261,4849,1420,96,0,16687
3/28/2020,17,10060,653,5477,1173,52,0,17415
3/28/2020,18,10056,697,5052,1031,21,0,16857
3/28/2020,19,10054,469,4554,1359,1,0,16437
3/28/2020,20,10059,294,4176,1749,0,0,16278
3/28/2020,21,10053,206,3847,1982,0,0,16088
3/28/2020,22,10061,204,3605,1512,0,0,15382
3/28/2020,23,10075,204,3473,1487,0,0,15239
3/28/2020,24,10079,205,3293,1648,0,0,15225
3/29/2020,1,10083,205,3303,1736,0,0,15327
3/29/2020,2,10078,205,3366,1736,0,0,15385
3/29/2020,3,10064,204,3303,1693,0,0,15264
3/29/2020,4,10059,203,3416,1578,0,0,15256
3/29/2020,5,10075,202,3491,1710,0,0,15478
3/29/2020,6,10076,203,3487,2030,0,0,15796
3/29/2020,7,10074,203,3623,2294,2,0,16196
3/29/2020,8,10081,200,3703,2846,10,0,16840
3/29/2020,9,10077,201,3909,2740,28,0,16955
3/29/2020,10,10078,201,3865,2942,63,0,17149
3/29/2020,11,10076,202,3807,2904,162,0,17151
3/29/2020,12,10079,203,3553,3370,115,0,17320
3/29/2020,13,10077,202,3398,3390,123,0,17190
3/29/2020,14,10083,201,3414,3296,208,0,17202
3/29/2020,15,10088,227,3625,3177,201,0,17318
3/29/2020,16,10086,204,3709,3315,107,0,17421
3/29/2020,17,10084,205,3616,3509,46,0,17460
3/29/2020,18,10081,203,3618,3377,23,0,17302
3/29/2020,19,10075,203,3821,3052,3,0,17154
3/29/2020,20,10066,205,3947,3328,0,0,17546
3/29/2020,21,10077,202,3789,3209,0,0,17277
3/29/2020,22,10079,205,3666,3208,0,0,17158
3/29/2020,23,10073,205,3787,2302,0,0,16367
3/29/2020,24,10079,204,3563,2035,0,0,15881
3/30/2020,1,10075,203,3519,1743,0,7,15547
3/30/2020,2,10077,204,3444,1420,0,8,15153
3/30/2020,3,10083,202,3421,1282,0,8,14996
3/30/2020,4,10070,201,3517,1343,0,9,15140
3/30/2020,5,10090,213,3508,1760,0,13,15584
3/30/2020,6,10083,250,3687,1870,2,20,15912
3/30/2020,7,10074,316,3855,2099,2,26,16372
3/30/2020,8,10076,404,3988,2340,19,26,16853
3/30/2020,9,10075,437,3932,2373,43,26,16886
3/30/2020,10,10079,646,3900,2225,75,27,16952
3/30/2020,11,10073,804,3704,2334,87,26,17028
3/30/2020,12,10071,1034,3725,2292,99,28,17249
3/30/2020,13,10072,1157,3799,2320,137,29,17514
3/30/2020,14,10072,1199,3727,2272,112,27,17409
3/30/2020,15,10072,1203,4005,1942,82,27,17331
3/30/2020,16,10073,1206,4191,1806,70,27,17373
3/30/2020,17,10077,956,5123,1586,50,27,17819
3/30/2020,18,10078,1010,5380,1309,16,27,17820
3/30/2020,19,10079,981,5550,1270,0,27,17907
3/30/2020,20,10076,1036,5596,1205,0,27,17940
3/30/2020,21,10074,579,4949,1109,0,27,16738
3/30/2020,22,10073,361,4787,983,0,26,16230
3/30/2020,23,10076,270,4576,774,0,19,15715
3/30/2020,24,10080,266,4232,617,0,13,15208
3/31/2020,1,10082,309,4015,482,0,10,14898
3/31/2020,2,10081,319,3793,427,0,10,14630
3/31/2020,3,10067,410,3461,461,0,10,14409
3/31/2020,4,10079,455,3627,570,0,10,14741
3/31/2020,5,10082,559,3671,658,0,18,14988
3/31/2020,6,10081,768,4011,721,2,31,15614
3/31/2020,7,10080,954,4479,781,5,60,16359
3/31/2020,8,10080,1123,4842,693,30,78,16846
3/31/2020,9,10081,1264,4789,598,66,76,16874
3/31/2020,10,10083,1371,4747,542,95,76,16914
3/31/2020,11,10085,1477,4834,442,118,76,17032
3/31/2020,12,10084,1511,4857,354,113,76,16995
3/31/2020,13,10079,1510,4698,256,118,76,16737
3/31/2020,14,10076,1512,4294,287,212,76,16457
3/31/2020,15,10066,1261,4363,427,151,76,16344
3/31/2020,16,10069,1096,4525,710,89,76,16565
3/31/2020,17,10074,1089,4797,825,72,76,16933
3/31/2020,18,10085,1010,5057,885,30,75,17142
3/31/2020,19,10084,1033,4968,1133,2,75,17295
3/31/2020,20,10079,989,4803,1329,0,75,17275
3/31/2020,21,10074,473,4844,1284,0,75,16750
3/31/2020,22,10076,268,4294,1115,0,75,15828
3/31/2020,23,10075,260,3993,1070,0,33,15431
3/31/2020,24,10072,260,3792,1048,0,14,15186
4/1/2020,1,10072,260,3784,1094,0,10,15220
4/1/2020,2,10071,260,3706,849,0,10,14896
4/1/2020,3,10072,260,3714,801,0,10,14857
4/1/2020,4,10071,262,3995,718,0,10,15056
4/1/2020,5,10067,300,4046,682,0,13,15108
4/1/2020,6,10112,444,4236,754,2,24,15572
4/1/2020,7,10125,481,4444,922,20,27,16019
4/1/2020,8,10120,381,4522,797,121,29,15970
4/1/2020,9,10116,322,4450,695,267,30,15880
4/1/2020,10,10115,296,4390,554,378,27,15760
4/1/2020,11,10117,291,4440,603,388,27,15866
4/1/2020,12,10123,291,4342,745,377,27,15905
4/1/2020,13,10118,291,4120,833,370,27,15759
4/1/2020,14,10083,291,3986,879,345,27,15611
4/1/2020,15,10106,313,3988,953,295,27,15682
4/1/2020,16,10113,331,4221,875,280,27,15847
4/1/2020,17,10117,361,4560,1020,172,27,16257
4/1/2020,18,10081,486,4707,1033,59,26,16392
4/1/2020,19,10065,501,5393,770,5,27,16761
4/1/2020,20,10060,472,5484,616,0,27,16659
4/1/2020,21,10059,506,5209,691,0,27,16492
4/1/2020,22,10070,288,4723,725,0,27,15833
4/1/2020,23,10074,265,4108,792,0,17,15256
4/1/2020,24,10074,265,3663,989,0,13,15004
4/2/2020,1,10074,265,3453,915,0,12,14719
4/2/2020,2,10076,266,3452,1059,0,12,14865
4/2/2020,3,10082,266,3461,1251,0,12,15072
4/2/2020,4,10079,266,3439,1255,0,12,15051
4/2/2020,5,10080,262,3474,1151,0,12,14979
4/2/2020,6,10083,263,3820,1445,2,22,15635
4/2/2020,7,10085,264,4187,1441,27,27,16031
4/2/2020,8,10074,266,4334,1059,145,27,15905
4/2/2020,9,10072,265,4730,681,295,27,16070
4/2/2020,10,10072,264,4219,594,395,27,15571
4/2/2020,11,10066,263,3881,630,417,27,15284
4/2/2020,12,10064,263,3918,758,416,27,15446
4/2/2020,13,10063,263,3748,962,408,27,15471
4/2/2020,14,10064,263,3746,745,413,27,15258
4/2/2020,15,10063,268,3820,927,401,27,15506
4/2/2020,16,10060,272,3858,1065,329,27,15611
4/2/2020,17,10063,307,4241,1354,213,27,16205
4/2/2020,18,10066,450,4699,1325,87,27,16654
4/2/2020,19,10065,453,5372,1319,8,27,17244
4/2/2020,20,10065,454,5152,1379,0,27,17077
4/2/2020,21,10067,455,4993,1447,0,27,16989
4/2/2020,22,10068,298,4877,1504,0,26,16773
4/2/2020,23,10070,266,3917,1575,0,16,15844
4/2/2020,24,10063,265,3488,1574,0,11,15401
4/3/2020,1,10067,267,3462,1543,0,10,15349
4/3/2020,2,10068,266,3492,1406,0,11,15243
4/3/2020,3,10072,265,3658,1346,0,11,15352
4/3/2020,4,10072,264,3516,1463,0,12,15327
4/3/2020,5,10067,263,3597,1219,0,15,15161
4/3/2020,6,10063,264,3745,1372,2,18,15464
4/3/2020,7,10063,263,4153,1636,15,27,16157
4/3/2020,8,10064,264,4575,1355,85,27,16370
4/3/2020,9,10068,340,4825,1249,188,27,16697
4/3/2020,10,10068,367,4676,1322,276,27,16736
4/3/2020,11,10067,367,4236,1323,290,27,16310
4/3/2020,12,10063,366,4289,1370,275,27,16390
4/3/2020,13,10065,366,4180,1462,274,27,16374
4/3/2020,14,10064,399,4002,1386,243,27,16121
4/3/2020,15,10062,474,3919,1202,225,27,15909
4/3/2020,16,10064,474,4336,1327,173,27,16401
4/3/2020,17,10062,542,5025,1166,105,27,16927
4/3/2020,18,10060,488,5054,1080,52,27,16761
4/3/2020,19,10059,596,5385,872,6,27,16945
4/3/2020,20,10055,633,5266,692,0,27,16673
4/3/2020,21,10054,384,5085,697,0,27,16247
4/3/2020,22,10049,270,4709,686,0,27,15741
4/3/2020,23,10054,209,4061,685,0,19,15028
4/3/2020,24,10049,227,4031,609,0,4,14920
4/4/2020,1,10051,215,3898,526,0,0,14690
4/4/2020,2,10035,207,3740,437,0,0,14419
4/4/2020,3,10031,208,3639,412,0,0,14290
4/4/2020,4,10036,208,3537,381,0,0,14162
4/4/2020,5,10032,209,3905,305,0,0,14451
4/4/2020,6,10034,245,4189,202,2,0,14672
4/4/2020,7,10040,256,3997,186,19,0,14498
4/4/2020,8,10038,206,4159,151,79,0,14633
4/4/2020,9,10031,205,4276,171,178,0,14861
4/4/2020,10,10039,204,4292,122,258,0,14915
4/4/2020,11,10037,204,4217,118,296,0,14872
4/4/2020,12,10029,292,4531,168,317,0,15337
4/4/2020,13,10029,486,4183,189,374,0,15261
4/4/2020,14,10036,476,4025,169,361,2,15069
4/4/2020,15,10036,501,4132,155,254,1,15079
4/4/2020,16,10034,572,4398,130,180,0,15314
4/4/2020,17,10036,594,5117,135,108,0,15990
4/4/2020,18,10034,586,5088,165,48,0,15921
4/4/2020,19,10039,574,5264,187,6,0,16070
4/4/2020,20,10030,453,5145,597,0,0,16225
4/4/2020,21,10033,294,4820,660,0,0,15807
4/4/2020,22,10039,210,4581,500,0,0,15330
4/4/2020,23,10035,218,4111,607,0,0,14971
4/4/2020,24,10039,210,3614,717,0,0,14580
4/5/2020,1,10048,211,3435,547,0,0,14241
4/5/2020,2,10043,210,3432,626,0,0,14311
4/5/2020,3,10049,210,3486,654,0,0,14399
4/5/2020,4,10057,209,3507,861,0,0,14634
4/5/2020,5,10059,206,3442,1192,0,0,14899
4/5/2020,6,10066,205,3402,1321,2,0,14996
4/5/2020,7,10065,204,3509,1434,7,0,15219
4/5/2020,8,10063,204,3733,1406,39,0,15445
4/5/2020,9,10060,206,3853,1381,91,0,15591
4/5/2020,10,10059,210,3882,1166,168,0,15485
4/5/2020,11,10060,209,3915,1137,231,0,15552
4/5/2020,12,10060,207,3898,1039,271,0,15475
4/5/2020,13,10064,207,3843,804,315,0,15233
4/5/2020,14,10033,205,3788,566,313,0,14905
4/5/2020,15,10077,205,3905,535,331,0,15053
4/5/2020,16,10077,204,4104,409,261,0,15055
4/5/2020,17,10075,203,4515,552,220,0,15565
4/5/2020,18,10077,204,4903,602,99,0,15885
4/5/2020,19,10091,204,5332,468,10,0,16105
4/5/2020,20,10083,215,5488,474,0,0,16260
4/5/2020,21,10082,236,5215,409,0,0,15942
4/5/2020,22,10082,237,4811,381,0,0,15511
4/5/2020,23,10084,207,4321,353,0,0,14965
4/5/2020,24,10086,224,4131,293,0,0,14734
4/6/2020,1,10082,180,3814,298,0,10,14384
4/6/2020,2,10079,259,3745,295,0,9,14387
4/6/2020,3,10081,288,3603,276,0,10,14258
4/6/2020,4,10080,331,3669,303,0,12,14395
4/6/2020,5,10080,512,3701,299,0,16,14608
4/6/2020,6,10083,764,4335,240,2,34,15458
4/6/2020,7,10086,789,4872,155,36,38,15976
4/6/2020,8,10083,820,5024,81,156,30,16194
4/6/2020,9,10079,788,4632,29,277,26,15831
4/6/2020,10,10054,788,4495,33,369,26,15765
4/6/2020,11,10056,785,4412,62,314,26,15655
4/6/2020,12,10072,848,4167,254,412,26,15779
4/6/2020,13,10075,887,3992,391,410,26,15781
4/6/2020,14,10069,929,3943,382,358,26,15707
4/6/2020,15,10068,1002,3991,396,273,26,15756
4/6/2020,16,10059,999,4057,335,252,26,15728
4/6/2020,17,10068,1002,4495,454,192,26,16237
4/6/2020,18,10074,1017,4940,459,69,27,16586
4/6/2020,19,10077,1046,5023,620,7,27,16800
4/6/2020,20,10073,1047,4970,645,0,27,16762
4/6/2020,21,10064,1007,4573,581,0,27,16252
4/6/2020,22,10063,381,4635,535,0,26,15640
4/6/2020,23,10065,201,4244,542,0,17,15069
4/6/2020,24,10066,202,3785,482,0,11,14546
4/7/2020,1,10076,202,3726,382,0,9,14395
4/7/2020,2,10073,201,3569,344,0,10,14197
4/7/2020,3,10071,209,3536,251,0,9,14076
4/7/2020,4,10069,324,3591,201,0,9,14194
4/7/2020,5,10058,579,3552,249,0,13,14451
4/7/2020,6,10056,966,3632,421,2,19,15096
4/7/2020,7,10055,1009,4127,219,25,26,15461
4/7/2020,8,10052,1014,4111,653,125,27,15982
4/7/2020,9,10053,1015,4172,310,241,27,15818
4/7/2020,10,10062,1014,4218,497,305,28,16124
4/7/2020,11,10054,1016,4255,630,339,29,16323
4/7/2020,12,10053,1113,4669,497,309,38,16679
4/7/2020,13,10065,1229,4629,551,256,42,16772
4/7/2020,14,10067,1351,3957,683,223,41,16322
4/7/2020,15,10065,1400,4008,350,213,40,16076
4/7/2020,16,10066,1470,4157,410,130,40,16273
4/7/2020,17,10062,1472,4741,599,76,30,16980
4/7/2020,18,10064,1475,4796,738,28,27,17128
4/7/2020,19,10063,1475,4647,818,3,27,17033
4/7/2020,20,10068,1473,4382,822,0,27,16772
4/7/2020,21,10076,1208,4591,921,0,27,16823
4/7/2020,22,10079,342,4122,996,0,31,15570
4/7/2020,23,10082,203,3741,868,0,20,14914
4/7/2020,24,10081,201,3826,677,0,11,14796
4/8/2020,1,10076,199,3751,396,0,9,14431
4/8/2020,2,10072,200,3651,236,0,9,14168
4/8/2020,3,10078,200,3619,177,0,10,14084
4/8/2020,4,10077,201,3579,422,0,10,14289
4/8/2020,5,10077,200,3509,173,0,13,13972
4/8/2020,6,10078,199,3904,671,2,21,14875
4/8/2020,7,10078,206,4792,586,8,26,15696
4/8/2020,8,10076,242,5327,609,44,26,16324
4/8/2020,9,10078,242,5430,678,91,27,16546
4/8/2020,10,10074,203,4802,727,124,27,15957
4/8/2020,11,10076,202,4931,517,165,28,15919
4/8/2020,12,10073,275,4826,619,225,28,16046
4/8/2020,13,10076,346,4323,926,200,26,15897
4/8/2020,14,10076,487,4134,889,244,27,15857
4/8/2020,15,10080,543,4170,534,215,27,15569
4/8/2020,16,10062,545,4203,707,217,27,15761
4/8/2020,17,10080,545,4592,792,143,27,16179
4/8/2020,18,10084,545,4953,796,59,27,16464
4/8/2020,19,10080,549,5187,654,9,32,16511
4/8/2020,20,10076,550,5185,984,0,33,16828
4/8/2020,21,10081,542,4995,1047,0,27,16692
4/8/2020,22,10081,442,4407,1002,0,27,15959
4/8/2020,23,10077,418,3762,840,0,22,15119
4/8/2020,24,10085,289,3574,998,0,13,14959
4/9/2020,1,10083,198,3413,1139,0,11,14844
4/9/2020,2,10084,199,3357,906,0,11,14557
4/9/2020,3,10086,198,3320,1329,0,11,14944
4/9/2020,4,10078,263,3341,1196,0,10,14888
4/9/2020,5,10078,359,3396,1361,0,18,15212
4/9/2020,6,10076,420,3646,1511,1,30,15684
4/9/2020,7,10076,422,3931,1840,4,43,16316
4/9/2020,8,10073,423,4169,2110,28,46,16849
4/9/2020,9,10071,422,3985,2482,86,50,17096
4/9/2020,10,10080,422,3817,1961,163,47,16490
4/9/2020,11,10074,420,3939,1629,221,46,16329
4/9/2020,12,10070,276,3835,2239,244,42,16706
4/9/2020,13,10076,200,3742,2427,248,31,16724
4/9/2020,14,10072,199,3655,2586,240,27,16779
4/9/2020,15,10073,200,3622,2464,202,27,16588
4/9/2020,16,10065,216,3642,2599,158,27,16707
4/9/2020,17,10065,229,3749,2672,103,27,16845
4/9/2020,18,10069,229,3782,2741,45,27,16893
4/9/2020,19,10070,202,3772,3005,6,27,17082
4/9/2020,20,10051,199,3621,3347,0,27,17245
4/9/2020,21,10070,201,3679,3381,0,27,17358
4/9/2020,22,10075,202,3478,3067,0,27,16849
4/9/2020,23,10080,149,3422,2592,0,14,16257
4/9/2020,24,10089,146,3369,2395,0,1,16000
4/10/2020,1,10090,146,3372,1886,0,0,15494
4/10/2020,2,10092,145,3293,1844,0,3,15377
4/10/2020,3,10090,145,3292,1707,0,4,15238
4/10/2020,4,10087,147,3293,1663,0,1,15191
4/10/2020,5,10091,145,3347,1671,0,0,15254
4/10/2020,6,10084,146,3513,1861,2,0,15606
4/10/2020,7,10088,144,3516,2150,16,0,15914
4/10/2020,8,10075,147,3605,2620,66,0,16513
4/10/2020,9,10077,145,3604,2164,134,0,16124
4/10/2020,10,10076,145,3600,2417,178,0,16416
4/10/2020,11,10076,145,3600,2243,222,0,16286
4/10/2020,12,10078,147,3589,2378,240,0,16432
4/10/2020,13,10074,146,3606,1914,261,0,16001
4/10/2020,14,9931,146,3658,1860,234,0,15829
4/10/2020,15,9907,147,3582,2033,219,0,15888
4/10/2020,16,9991,147,3666,2072,231,0,16107
4/10/2020,17,10079,147,3735,2895,183,0,17039
4/10/2020,18,10081,148,4113,2723,72,0,17137
4/10/2020,19,10084,146,4088,2503,9,0,16830
4/10/2020,20,10080,151,4771,2002,0,1,17005
4/10/2020,21,10084,167,4829,1911,0,0,16991
4/10/2020,22,10087,149,4010,1943,0,0,16189
4/10/2020,23,10079,147,3455,1604,0,0,15285
4/10/2020,24,10081,148,3372,1560,0,0,15161
4/11/2020,1,10083,146,3406,1073,0,0,14708
4/11/2020,2,10086,148,3430,1210,0,0,14874
4/11/2020,3,10080,147,3379,1266,0,0,14872
4/11/2020,4,10081,147,3521,1164,0,0,14913
4/11/2020,5,10075,146,3343,1147,1,0,14712
4/11/2020,6,10075,145,3498,947,2,0,14667
4/11/2020,7,10076,145,3494,785,45,0,14545
4/11/2020,8,10072,145,3543,524,151,0,14435
4/11/2020,9,10067,145,3599,512,284,0,14607
4/11/2020,10,10072,145,3772,828,370,0,15187
4/11/2020,11,10076,145,3931,1170,362,0,15684
4/11/2020,12,10071,145,3810,1702,337,0,16065
4/11/2020,13,10075,144,3523,1512,332,0,15586
4/11/2020,14,10073,143,3488,1705,319,0,15728
4/11/2020,15,10072,143,3450,1831,322,0,15818
4/11/2020,16,10071,143,3728,1691,301,0,15934
4/11/2020,17,10073,142,3875,1619,213,0,15922
4/11/2020,18,10076,142,4217,1561,92,0,16088
4/11/2020,19,10078,145,4264,1503,14,0,16004
4/11/2020,20,10068,143,4433,1638,0,0,16282
4/11/2020,21,10074,144,4222,1745,0,0,16185
4/11/2020,22,10050,143,3753,1615,0,0,15561
4/11/2020,23,10082,144,3631,1715,0,0,15572
4/11/2020,24,10087,143,3599,1637,0,0,15466
4/12/2020,1,10084,142,3521,1288,0,0,15035
4/12/2020,2,10090,142,3395,1213,0,0,14840
4/12/2020,3,10090,144,3326,1191,0,0,14751
4/12/2020,4,10088,142,3494,846,0,0,14570
4/12/2020,5,10084,144,3494,1150,1,0,14873
4/12/2020,6,10088,144,3599,1204,3,0,15038
4/12/2020,7,10090,143,4074,1062,15,0,15384
4/12/2020,8,10081,144,4246,976,44,0,15491
4/12/2020,9,10079,142,3988,1039,79,2,15329
4/12/2020,10,10079,144,4442,1192,65,1,15923
4/12/2020,11,10077,141,4509,1058,110,0,15895
4/12/2020,12,10077,143,4362,1020,161,0,15763
4/12/2020,13,10078,143,4020,1026,246,0,15513
4/12/2020,14,10076,141,3675,1164,268,0,15324
4/12/2020,15,10079,141,3711,1328,209,0,15468
4/12/2020,16,10085,143,4212,1449,142,0,16031
4/12/2020,17,10085,143,4433,1536,89,0,16286
4/12/2020,18,10094,143,4684,1539,37,0,16497
4/12/2020,19,10082,143,4137,1354,5,0,15721
4/12/2020,20,10079,145,4032,1975,0,0,16231
4/12/2020,21,10084,143,3944,1579,0,0,15750
4/12/2020,22,10079,143,3853,1621,0,0,15696
4/12/2020,23,10077,144,3760,1385,0,0,15366
4/12/2020,24,10077,142,3616,1229,0,0,15064
4/13/2020,1,10080,144,3392,1143,0,10,14769
4/13/2020,2,10084,142,3375,854,0,14,14469
4/13/2020,3,10081,143,3364,866,0,13,14467
4/13/2020,4,10084,142,3442,865,0,15,14548
4/13/2020,5,10083,151,3811,802,0,14,14861
4/13/2020,6,10089,181,3700,1715,0,20,15705
4/13/2020,7,10088,198,4053,1642,2,26,16009
4/13/2020,8,10086,198,4166,2150,11,28,16639
4/13/2020,9,10087,199,4193,2223,24,27,16753
4/13/2020,10,10092,198,4288,3083,56,26,17743
4/13/2020,11,10097,198,4323,3276,53,26,17973
4/13/2020,12,10092,199,4349,3161,66,26,17893
4/13/2020,13,10087,199,4362,3384,77,27,18136
4/13/2020,14,10091,197,4307,3415,64,30,18104
4/13/2020,15,10080,197,4283,3322,68,31,17981
4/13/2020,16,10075,196,4327,3701,53,35,18387
4/13/2020,17,10071,197,4324,4002,41,26,18661
4/13/2020,18,10080,198,4309,3939,27,26,18579
4/13/2020,19,10070,201,4304,3592,4,26,18197
4/13/2020,20,10043,202,4432,3532,0,26,18235
4/13/2020,21,10052,202,4361,3238,0,26,17879
4/13/2020,22,10055,201,4149,2602,0,26,17033
4/13/2020,23,10061,202,4135,2023,0,17,16438
4/13/2020,24,10058,201,3920,1842,0,10,16031
4/14/2020,1,10072,201,3738,1613,0,9,15633
4/14/2020,2,9783,200,3793,1656,0,9,15441
4/14/2020,3,9563,201,3785,2018,0,9,15576
4/14/2020,4,9567,201,3658,2239,0,9,15674
4/14/2020,5,9562,201,3449,2052,0,11,15275
4/14/2020,6,9563,200,3801,1864,1,16,15445
4/14/2020,7,9557,204,4374,1510,31,23,15699
4/14/2020,8,9559,305,4386,1312,116,24,15702
4/14/2020,9,9561,361,4217,1370,216,26,15751
4/14/2020,10,9549,359,3889,2027,295,29,16148
4/14/2020,11,9558,359,3872,2137,301,28,16255
4/14/2020,12,9562,366,3727,2827,309,28,16819
4/14/2020,13,9564,421,3782,2701,281,27,16776
4/14/2020,14,9570,536,3890,2833,243,27,17099
4/14/2020,15,9572,543,3881,3096,243,27,17362
4/14/2020,16,9563,547,3962,3108,218,26,17424
4/14/2020,17,9564,547,4062,3307,145,27,17652
4/14/2020,18,9559,550,4126,3143,55,27,17460
4/14/2020,19,9556,549,4265,3003,7,27,17407
4/14/2020,20,9555,462,4597,2981,0,27,17622
4/14/2020,21,9558,445,4899,2570,0,27,17499
4/14/2020,22,9554,296,4203,2260,0,27,16340
4/14/2020,23,9558,205,3785,2148,0,22,15718
4/14/2020,24,9560,202,4075,1916,0,12,15765
4/15/2020,1,9562,203,4211,1677,0,11,15664
4/15/2020,2,9564,204,3900,1589,0,11,15268
4/15/2020,3,9557,203,4094,1477,0,17,15348
4/15/2020,4,9555,204,3609,1444,0,14,14826
4/15/2020,5,9555,203,3489,1551,1,33,14832
4/15/2020,6,9560,203,4023,1503,1,66,15356
4/15/2020,7,9561,204,4490,1303,18,76,15652
4/15/2020,8,9560,234,4877,1201,82,78,16032
4/15/2020,9,9562,243,4622,1429,172,83,16111
4/15/2020,10,9555,206,4327,1640,198,81,16007
4/15/2020,11,9554,210,4739,1591,214,82,16390
4/15/2020,12,9538,227,5021,1453,207,82,16528
4/15/2020,13,9382,372,4942,1315,230,86,16327
4/15/2020,14,9473,495,4727,1168,163,112,16138
4/15/2020,15,9563,701,4449,989,173,117,15992
4/15/2020,16,9561,844,4638,866,138,110,16157
4/15/2020,17,9563,850,5138,995,105,140,16791
4/15/2020,18,9564,865,4962,1057,42,142,16632
4/15/2020,19,9567,873,5197,876,11,121,16645
4/15/2020,20,9561,727,5400,649,0,123,16460
4/15/2020,21,9559,772,5388,587,0,133,16439
4/15/2020,22,9559,565,5188,704,0,134,16150
4/15/2020,23,9557,354,4872,872,0,115,15770
4/15/2020,24,9554,249,4281,954,0,111,15149
4/16/2020,1,9556,205,3967,964,0,109,14801
4/16/2020,2,9559,204,3761,1040,0,77,14641
4/16/2020,3,9561,204,3892,983,0,70,14710
4/16/2020,4,9605,204,4044,914,0,73,14840
4/16/2020,5,9609,203,4248,1011,0,74,15145
4/16/2020,6,9608,204,4555,1051,3,117,15538
4/16/2020,7,9608,244,4582,1096,31,126,15687
4/16/2020,8,9604,278,4657,1213,111,126,15989
4/16/2020,9,9587,206,4314,1481,215,123,15926
4/16/2020,10,9584,205,4087,1790,281,89,16036
4/16/2020,11,9583,204,4058,2405,233,80,16563
4/16/2020,12,9590,201,4014,2855,273,67,17000
4/16/2020,13,9609,201,3709,2682,279,27,16507
4/16/2020,14,9569,201,3622,2958,269,27,16646
4/16/2020,15,9555,200,3532,3072,288,32,16679
4/16/2020,16,9555,201,3909,2754,208,29,16656
4/16/2020,17,9553,201,4245,2656,155,27,16837
4/16/2020,18,9550,203,4300,2779,116,27,16975
4/16/2020,19,9550,203,4300,2779,116,27,16975
4/16/2020,20,9542,476,5046,2096,85,149,17394
4/16/2020,21,9551,487,4544,1981,80,126,16769
4/16/2020,22,9558,339,4431,2089,80,94,16591
4/16/2020,23,9560,201,3968,1858,80,66,15733
4/16/2020,24,9557,205,3886,1947,80,61,15736
4/17/2020,1,9556,314,3754,1762,80,60,15526
4/17/2020,2,9552,338,3638,1288,80,59,14955
4/17/2020,3,9555,356,3588,1120,80,59,14758
4/17/2020,4,9555,487,3534,978,80,59,14693
4/17/2020,5,9548,649,3657,854,31,61,14800
4/17/2020,6,9550,821,4278,798,6,69,15522
4/17/2020,7,9541,674,5025,680,28,140,16088
4/17/2020,8,9539,640,5019,545,101,182,16026
4/17/2020,9,9543,873,4839,498,192,197,16142
4/17/2020,10,9546,1248,4294,599,194,118,15999
4/17/2020,11,9545,1201,4204,465,220,48,15683
4/17/2020,12,9553,1244,4273,575,221,27,15893
4/17/2020,13,9549,1197,4244,1083,216,27,16316
4/17/2020,14,9548,1158,4198,1011,192,27,16134
4/17/2020,15,9548,1325,4312,753,176,28,16142
4/17/2020,16,9551,1387,4595,770,138,43,16484
4/17/2020,17,9550,1420,4950,583,91,77,16671
4/17/2020,18,9547,1599,5573,494,47,136,17396
4/17/2020,19,9550,1601,5419,569,10,177,17326
4/17/2020,20,9556,1565,5260,504,0,153,17038
4/17/2020,21,9558,1350,5033,484,0,93,16518
4/17/2020,22,9557,580,5166,459,0,101,15863
4/17/2020,23,9561,342,4827,477,0,74,15281
4/17/2020,24,9563,181,4711,489,0,54,14998
4/18/2020,1,9563,151,4416,449,0,52,14631
4/18/2020,2,9560,150,4442,442,0,53,14647
4/18/2020,3,9556,151,4412,458,0,54,14631
4/18/2020,4,9558,152,4345,442,0,55,14552
4/18/2020,5,9555,148,4410,449,0,94,14656
4/18/2020,6,9557,149,4550,564,3,98,14921
4/18/2020,7,9560,148,4275,688,38,97,14806
4/18/2020,8,9562,150,4236,585,118,98,14749
4/18/2020,9,9553,149,4387,605,224,98,15016
4/18/2020,10,9553,140,4259,810,355,94,15211
4/18/2020,11,9546,148,3886,1378,373,52,15383
4/18/2020,12,9545,148,3565,1730,379,47,15414
4/18/2020,13,9546,147,3428,1821,349,10,15301
4/18/2020,14,9513,146,3329,1796,333,0,15117
4/18/2020,15,9549,148,3317,1902,335,0,15251
4/18/2020,16,9552,147,3421,2161,306,1,15588
4/18/2020,17,9550,146,3613,2777,213,2,16301
4/18/2020,18,9554,147,3653,3109,90,0,16553
4/18/2020,19,9554,146,3718,3216,15,1,16650
4/18/2020,20,9552,148,3823,3470,0,1,16994
4/18/2020,21,9552,148,3692,3642,0,0,17034
4/18/2020,22,9551,146,3477,3527,0,0,16701
4/18/2020,23,9556,147,3343,2601,0,0,15647
4/18/2020,24,9554,149,3240,2083,0,0,15026
4/19/2020,1,9550,149,3185,1546,0,0,14430
4/19/2020,2,9557,149,3173,1306,0,0,14185
4/19/2020,3,9551,149,3204,1106,0,0,14010
4/19/2020,4,9551,148,3158,1195,0,0,14052
4/19/2020,5,9554,149,3215,1321,2,0,14241
4/19/2020,6,9560,149,3272,1522,3,0,14506
4/19/2020,7,9556,147,3263,1562,28,0,14556
4/19/2020,8,9555,149,3306,1857,104,0,14971
4/19/2020,9,9558,151,3476,2306,189,0,15680
4/19/2020,10,9554,151,3655,2644,191,0,16195
4/19/2020,11,9555,150,3803,2589,134,0,16231
4/19/2020,12,9551,147,3576,2524,141,0,15939
4/19/2020,13,9406,148,3589,2189,136,0,15468
4/19/2020,14,9389,147,3568,2011,105,0,15220
4/19/2020,15,9526,147,3735,2089,162,0,15659
4/19/2020,16,9533,147,3777,2576,204,0,16237
4/19/2020,17,9531,147,3870,2989,105,0,16642
4/19/2020,18,9536,147,3952,2847,52,0,16534
4/19/2020,19,9536,146,4325,2305,12,1,16325
4/19/2020,20,9529,149,4634,2529,0,1,16842
4/19/2020,21,9537,149,4631,2600,0,0,16917
4/19/2020,22,9555,149,4449,2189,0,0,16342
4/19/2020,23,9556,149,4416,1588,0,0,15709
4/19/2020,24,9557,151,4560,1244,0,0,15512
4/20/2020,1,9564,149,3871,976,0,4,14564
4/20/2020,2,9569,149,3743,708,0,42,14211
4/20/2020,3,9563,150,3879,558,0,65,14215
4/20/2020,4,9565,150,4020,551,0,64,14350
4/20/2020,5,9561,154,4364,537,2,64,14682
4/20/2020,6,9562,309,4614,660,4,72,15221
4/20/2020,7,9568,337,4877,625,58,78,15543
4/20/2020,8,9566,505,5039,448,180,78,15816
4/20/2020,9,9553,916,4592,538,322,86,16007
4/20/2020,10,9556,1077,4277,623,395,85,16013
4/20/2020,11,9551,1166,4095,584,413,85,15894
4/20/2020,12,9546,1166,3960,907,407,85,16071
4/20/2020,13,9547,1168,3546,1086,409,72,15828
4/20/2020,14,9546,1162,3522,962,406,34,15632
4/20/2020,15,9548,1148,3546,1134,397,34,15807
4/20/2020,16,9549,927,3654,1328,360,35,15853
4/20/2020,17,9551,994,3994,1869,224,35,16667
4/20/2020,18,9555,1148,4102,2174,71,35,17085
4/20/2020,19,9559,1139,4347,2316,15,35,17411
4/20/2020,20,9556,907,4219,2921,0,35,17638
4/20/2020,21,9552,981,4135,2391,0,35,17094
4/20/2020,22,9546,1143,4056,1291,0,35,16071
4/20/2020,23,9551,993,3643,1011,0,24,15222
4/20/2020,24,9558,328,3333,1419,0,20,14658
4/21/2020,1,9559,174,3301,1252,0,17,14303
4/21/2020,2,9556,175,3218,1178,0,17,14144
4/21/2020,3,9558,186,3249,1046,0,17,14056
4/21/2020,4,9559,199,3234,1243,0,17,14252
4/21/2020,5,9555,209,3314,1492,0,17,14587
4/21/2020,6,9552,341,3424,2035,3,25,15380
4/21/2020,7,9547,619,3574,2088,20,34,15882
4/21/2020,8,9541,972,3756,2349,63,35,16716
4/21/2020,9,9541,1021,3650,1977,192,35,16416
4/21/2020,10,9539,1039,3673,1870,238,35,16394
4/21/2020,11,9539,995,3677,1709,256,35,16211
4/21/2020,12,9540,998,3664,1856,294,35,16387
4/21/2020,13,9536,998,3661,2155,279,27,16656
4/21/2020,14,9536,1002,3657,1817,265,27,16304
4/21/2020,15,9537,1002,3644,1632,244,27,16086
4/21/2020,16,9535,1008,3712,2032,187,28,16502
4/21/2020,17,9539,1113,3661,2865,129,27,17334
4/21/2020,18,9541,1160,3880,2718,59,27,17385
4/21/2020,19,9541,1165,3820,2832,13,27,17398
4/21/2020,20,9538,1167,3962,3160,0,27,17854
4/21/2020,21,9538,1171,3819,3016,0,27,17571
4/21/2020,22,9543,1175,3793,2956,0,27,17494
4/21/2020,23,9547,1019,3550,2793,0,14,16923
4/21/2020,24,9553,321,3432,3147,0,11,16464
4/22/2020,1,9556,207,3296,3006,0,11,16076
4/22/2020,2,9555,207,3397,2871,0,11,16041
4/22/2020,3,9559,207,3295,2709,0,10,15780
4/22/2020,4,9559,206,3331,2208,0,10,15314
4/22/2020,5,9555,207,3420,2167,1,11,15361
4/22/2020,6,9562,207,3909,2167,3,18,15866
4/22/2020,7,9564,205,4227,2133,46,26,16201
4/22/2020,8,9558,202,4268,2186,156,26,16396
4/22/2020,9,9554,206,4134,2057,235,29,16215
4/22/2020,10,9555,204,4149,1632,307,29,15876
4/22/2020,11,9556,206,4226,1850,337,28,16203
4/22/2020,12,9556,204,4279,1821,335,26,16221
4/22/2020,13,9557,206,4051,1862,347,26,16049
4/22/2020,14,9558,208,4040,1769,354,33,15962
4/22/2020,15,9556,264,4172,1466,360,34,15852
4/22/2020,16,9558,271,4415,1255,347,62,15908
4/22/2020,17,9564,304,4820,1167,234,97,16186
4/22/2020,18,9565,281,4965,958,101,95,15965
4/22/2020,19,9565,284,5180,753,16,102,15900
4/22/2020,20,9561,312,5224,592,0,141,15830
4/22/2020,21,9559,457,5413,498,0,201,16128
4/22/2020,22,9554,369,5197,461,0,155,15736
4/22/2020,23,9561,317,5009,484,0,60,15431
4/22/2020,24,9559,213,4478,521,0,35,14806
4/23/2020,1,9559,207,4386,538,0,27,14717
4/23/2020,2,9560,208,3938,795,0,26,14527
4/23/2020,3,9556,208,3884,981,0,22,14651
4/23/2020,4,9561,208,3824,1186,0,21,14800
4/23/2020,5,9563,212,3821,1556,1,24,15177
4/23/2020,6,9562,211,3824,2003,5,34,15639
4/23/2020,7,9562,212,3976,2092,41,39,15922
4/23/2020,8,9551,212,4137,2061,124,40,16125
4/23/2020,9,9547,210,4004,2003,207,39,16010
4/23/2020,10,9550,210,4086,2176,243,37,16302
4/23/2020,11,9549,211,4012,2089,250,37,16148
4/23/2020,12,9553,211,4341,2096,261,43,16505
4/23/2020,13,9552,214,4147,1932,299,55,16199
4/23/2020,14,9551,228,4185,1630,281,58,15933
4/23/2020,15,9550,238,4227,1259,251,74,15599
4/23/2020,16,9561,256,4468,1163,202,85,15735
4/23/2020,17,9562,390,4967,1161,138,85,16303
4/23/2020,18,9561,392,5336,1271,61,94,16715
4/23/2020,19,9555,386,5235,1269,13,113,16571
4/23/2020,20,9556,387,5019,1188,0,85,16235
4/23/2020,21,9556,389,4876,1154,0,83,16058
4/23/2020,22,9553,389,4666,1293,0,83,15984
4/23/2020,23,9562,224,4485,1219,0,72,15562
4/23/2020,24,9563,207,4151,902,0,65,14888
4/24/2020,1,9564,208,4190,777,0,60,14799
4/24/2020,2,9564,208,4135,645,0,59,14611
4/24/2020,3,9560,214,4032,704,0,59,14569
4/24/2020,4,9565,321,3815,700,0,60,14461
4/24/2020,5,9564,358,3973,934,1,70,14900
4/24/2020,6,9563,390,4310,947,4,80,15294
4/24/2020,7,9561,575,4656,1054,19,87,15952
4/24/2020,8,9552,965,4838,825,58,94,16332
4/24/2020,9,9552,1019,5024,714,103,137,16549
4/24/2020,10,9558,1107,4999,635,194,181,16674
4/24/2020,11,9548,1014,4811,474,189,129,16165
4/24/2020,12,9534,1055,4771,547,235,124,16266
4/24/2020,13,9539,1227,4628,555,250,98,16297
4/24/2020,14,9538,1031,4784,611,259,117,16340
4/24/2020,15,9535,943,5118,556,266,119,16537
4/24/2020,16,9541,992,4966,620,191,133,16443
4/24/2020,17,9542,1020,5319,606,95,126,16708
4/24/2020,18,9538,1024,5000,457,54,82,16155
4/24/2020,19,9541,946,5259,327,16,90,16179
4/24/2020,20,9536,993,5022,329,0,86,15966
4/24/2020,21,9556,1000,5118,351,0,86,16111
4/24/2020,22,9558,1002,4678,327,0,84,15649
4/24/2020,23,9559,829,4341,267,1,72,15069
4/24/2020,24,9569,240,4220,265,0,60,14354
4/25/2020,1,9568,150,3924,264,0,57,13963
4/25/2020,2,9564,150,3793,170,0,8,13685
4/25/2020,3,9561,149,3808,335,0,0,13853
4/25/2020,4,9564,149,3760,404,0,0,13877
4/25/2020,5,9559,149,3483,552,2,0,13745
4/25/2020,6,9561,150,3625,660,7,0,14003
4/25/2020,7,9560,150,3639,602,57,0,14008
4/25/2020,8,9557,150,3674,360,176,0,13917
4/25/2020,9,9552,148,3660,240,293,2,13895
4/25/2020,10,9553,148,3593,434,360,0,14088
4/25/2020,11,9556,149,3491,306,412,0,13914
4/25/2020,12,9554,143,3564,366,420,0,14047
4/25/2020,13,9552,142,3528,238,394,1,13855
4/25/2020,14,9550,142,3526,399,377,0,13994
4/25/2020,15,9554,141,3521,334,359,0,13909
4/25/2020,16,9552,141,3549,479,236,0,13957
4/25/2020,17,9555,142,3799,1236,187,0,14919
4/25/2020,18,9554,142,4092,1558,79,0,15425
4/25/2020,19,9557,173,4340,1547,18,0,15635
4/25/2020,20,9557,176,4309,1580,0,0,15622
4/25/2020,21,9554,174,4234,1592,0,0,15554
4/25/2020,22,9543,175,4201,1653,0,0,15572
4/25/2020,23,9537,152,3380,1475,0,0,14544
4/25/2020,24,9558,147,3179,1408,0,0,14292
4/26/2020,1,9563,146,3079,835,0,0,13623
4/26/2020,2,9566,149,3088,1085,0,0,13888
4/26/2020,3,9571,152,3113,1089,0,0,13925
4/26/2020,4,9575,154,3089,1095,0,0,13913
4/26/2020,5,9572,154,3081,1244,1,0,14052
4/26/2020,6,9571,149,3227,1282,2,0,14231
4/26/2020,7,9571,146,3217,1293,14,1,14242
4/26/2020,8,9563,146,3279,2038,47,1,15074
4/26/2020,9,9564,146,3268,2069,79,4,15130
4/26/2020,10,9560,145,3175,1644,116,4,14644
4/26/2020,11,9556,146,3181,1968,134,8,14993
4/26/2020,12,9554,148,3179,2423,175,7,15486
4/26/2020,13,9522,238,3163,2551,179,1,15654
4/26/2020,14,9558,255,3197,2720,174,0,15904
4/26/2020,15,9555,255,3203,2579,156,0,15748
4/26/2020,16,9558,254,3345,2867,153,0,16177
4/26/2020,17,9558,256,3530,3147,122,0,16613
4/26/2020,18,9560,297,3981,2909,75,0,16822
4/26/2020,19,9553,366,4136,2636,18,0,16709
4/26/2020,20,9551,368,4168,2244,0,0,16331
4/26/2020,21,9552,371,4325,1930,0,0,16178
4/26/2020,22,9556,371,4127,1467,0,0,15521
4/26/2020,23,9556,369,3773,1171,0,0,14869
4/26/2020,24,9555,367,3362,810,0,0,14094
4/27/2020,1,9556,240,3181,782,0,1,13760
4/27/2020,2,9559,147,3132,951,0,4,13793
4/27/2020,3,9558,147,3096,870,0,5,13676
4/27/2020,4,9555,262,3089,777,0,7,13690
4/27/2020,5,9559,289,3111,752,1,12,13724
4/27/2020,6,9557,365,3208,829,4,21,13984
4/27/2020,7,9558,547,3814,863,43,25,14850
4/27/2020,8,9553,898,3810,362,146,26,14795
4/27/2020,9,9550,979,3777,159,126,26,14617
4/27/2020,10,9551,978,3603,382,346,27,14887
4/27/2020,11,9555,976,3489,199,376,31,14626
4/27/2020,12,9552,975,3430,216,343,28,14544
4/27/2020,13,9553,1053,3439,374,395,28,14842
4/27/2020,14,9547,1108,3465,371,370,26,14887
4/27/2020,15,9551,1244,3552,556,352,27,15282
4/27/2020,16,9544,1305,3648,434,252,44,15227
4/27/2020,17,9547,674,4099,796,195,73,15384
4/27/2020,18,9547,548,4490,1038,99,79,15801
4/27/2020,19,9557,550,4606,1220,18,79,16030
4/27/2020,20,9551,550,4821,1070,0,77,16069
4/27/2020,21,9550,552,4690,905,0,77,15774
4/27/2020,22,9554,549,4488,886,0,77,15554
4/27/2020,23,9555,349,4191,1046,0,20,15161
4/27/2020,24,9556,202,3543,1296,0,4,14601
4/28/2020,1,9554,203,3317,661,0,4,13739
4/28/2020,2,9561,201,3336,1120,0,4,14222
4/28/2020,3,9560,202,3272,1916,0,4,14954
4/28/2020,4,9561,202,3396,1673,0,9,14841
4/28/2020,5,9562,202,3361,1760,1,14,14900
4/28/2020,6,9563,203,3525,1655,4,21,14971
4/28/2020,7,9560,202,3949,1724,44,26,15505
4/28/2020,8,9562,200,4483,1628,124,26,16023
4/28/2020,9,9552,200,4425,1366,179,26,15748
4/28/2020,10,9549,199,4625,1056,231,26,15686
4/28/2020,11,9549,193,4762,774,252,26,15556
4/28/2020,12,9542,195,4891,583,293,26,15530
4/28/2020,13,9546,184,4540,495,350,28,15143
4/28/2020,14,9548,205,4461,460,319,48,15041
4/28/2020,15,9557,199,4510,467,305,75,15113
4/28/2020,16,9543,220,4722,585,259,83,15412
4/28/2020,17,9548,225,4797,881,155,79,15685
4/28/2020,18,9549,220,4851,1145,83,75,15923
4/28/2020,19,9548,207,4857,1353,18,76,16059
4/28/2020,20,9551,205,4791,1588,0,79,16214
4/28/2020,21,9551,200,4449,1900,0,81,16181
4/28/2020,22,9557,202,4290,1712,0,82,15843
4/28/2020,23,9558,200,3789,2139,0,24,15710
4/28/2020,24,9559,202,3541,2036,0,5,15343
4/29/2020,1,9559,203,3462,1947,0,6,15177
4/29/2020,2,9564,201,3483,1686,0,5,14939
4/29/2020,3,9559,201,3390,1590,0,5,14745
4/29/2020,4,9559,201,3388,1494,0,9,14651
4/29/2020,5,9558,200,3370,1840,1,17,14986
4/29/2020,6,9555,199,3443,1860,7,21,15085
4/29/2020,7,9555,219,3865,2140,36,26,15841
4/29/2020,8,9550,224,4059,1532,88,26,15479
4/29/2020,9,9543,203,4015,1503,89,26,15379
4/29/2020,10,9546,222,3913,1915,118,27,15741
4/29/2020,11,9547,220,3920,2050,173,26,15936
4/29/2020,12,9545,203,3968,2274,115,26,16131
4/29/2020,13,9421,201,3931,2633,140,28,16354
4/29/2020,14,9442,197,3942,2858,114,27,16580
4/29/2020,15,9551,196,3911,2850,120,27,16655
4/29/2020,16,9549,197,3983,3214,111,27,17081
4/29/2020,17,9552,197,4406,3681,55,27,17918
4/29/2020,18,9562,198,4266,3673,24,27,17750
4/29/2020,19,9558,204,3961,3515,7,26,17271
4/29/2020,20,9557,201,4002,3294,0,26,17080
4/29/2020,21,9555,198,3991,2784,0,26,16554
4/29/2020,22,9559,197,4033,2523,0,26,16338
4/29/2020,23,9354,148,3842,2170,0,22,15536
4/29/2020,24,8676,141,3965,2213,0,10,15005
4/30/2020,1,8675,142,3349,1950,0,5,14121
4/30/2020,2,8675,143,3400,1684,0,4,13906
4/30/2020,3,8719,149,3337,1829,0,5,14039
4/30/2020,4,8973,151,3396,1588,0,6,14114
4/30/2020,5,9472,152,3344,1722,0,16,14706
4/30/2020,6,9546,332,3394,1732,2,20,15026
4/30/2020,7,9543,459,3981,1810,4,30,15827
4/30/2020,8,9541,523,3976,1880,18,44,15982
4/30/2020,9,9539,658,4040,1913,26,78,16254
4/30/2020,10,9534,727,4056,1737,40,85,16179
4/30/2020,11,9534,797,4511,1598,58,87,16585
4/30/2020,12,9535,792,4623,1344,97,88,16479
4/30/2020,13,9541,783,4426,1109,148,99,16106
4/30/2020,14,9542,642,4300,853,182,95,15614
4/30/2020,15,9543,640,4553,859,157,86,15838
4/30/2020,16,9543,736,4666,899,89,86,16019
4/30/2020,17,9544,675,4818,841,46,86,16010
4/30/2020,18,9546,645,5077,879,23,86,16256
4/30/2020,19,9543,654,4916,845,7,84,16049
4/30/2020,20,9539,427,4942,780,0,85,15773
4/30/2020,21,9545,368,5051,663,0,86,15713
4/30/2020,22,9548,367,4402,611,0,86,15014
4/30/2020,23,9551,204,3927,589,0,33,14304
4/30/2020,24,9558,138,3698,593,0,9,13996
5/1/2020,1,9558,140,3593,728,0,4,14023
5/1/2020,2,9561,139,3541,873,0,4,14118
5/1/2020,3,9562,139,3667,897,0,5,14270
5/1/2020,4,9560,139,3716,985,0,7,14407
5/1/2020,5,9555,139,3700,944,0,14,14352
5/1/2020,6,9557,156,3709,833,3,19,14277
5/1/2020,7,9555,198,4005,1018,25,26,14827
5/1/2020,8,9554,276,4140,1308,69,26,15373
5/1/2020,9,9549,408,4053,1207,149,26,15392
5/1/2020,10,9544,554,4083,1393,180,26,15780
5/1/2020,11,9546,574,4137,932,197,26,15412
5/1/2020,12,9545,575,4156,520,241,26,15063
5/1/2020,13,9550,573,4136,741,274,26,15300
5/1/2020,14,9556,565,4094,815,278,26,15334
5/1/2020,15,9551,425,4119,485,300,25,14905
5/1/2020,16,9549,428,4199,619,336,26,15157
5/1/2020,17,9549,434,4565,850,253,26,15677
5/1/2020,18,9552,434,4882,727,114,27,15736
5/1/2020,19,9546,436,4856,573,19,27,15457
5/1/2020,20,9544,486,5008,617,1,27,15683
5/1/2020,21,9544,493,4844,572,0,27,15480
5/1/2020,22,9542,519,4883,541,0,27,15512
5/1/2020,23,9545,459,4567,595,0,20,15186
5/1/2020,24,9549,484,3985,636,0,3,14657
5/2/2020,1,9548,487,3506,381,0,0,13922
5/2/2020,2,9540,189,3527,629,0,0,13885
5/2/2020,3,9534,140,3507,569,0,0,13750
5/2/2020,4,9539,139,3482,793,0,0,13953
5/2/2020,5,9552,138,3405,819,3,0,13917
5/2/2020,6,9557,137,3403,1025,10,0,14132
5/2/2020,7,9552,136,3406,1197,58,0,14349
5/2/2020,8,9545,137,3534,1013,136,0,14365
5/2/2020,9,9543,137,3621,837,199,0,14337
5/2/2020,10,9538,135,3633,1159,232,0,14697
5/2/2020,11,9541,136,3625,1727,245,0,15274
5/2/2020,12,9542,136,3553,2050,277,0,15558
5/2/2020,13,9543,136,3716,1346,221,0,14962
5/2/2020,14,9543,137,3724,1450,211,0,15065
5/2/2020,15,9539,137,3757,2018,211,0,15662
5/2/2020,16,9542,138,3889,2555,122,0,16246
5/2/2020,17,9546,138,4139,2878,62,0,16763
5/2/2020,18,9543,138,4096,2912,35,0,16724
5/2/2020,19,9539,138,4070,2464,8,0,16219
5/2/2020,20,9537,139,3985,2614,0,0,16275
5/2/2020,21,9532,137,3986,2353,0,0,16008
5/2/2020,22,9531,138,3982,1878,0,0,15529
5/2/2020,23,9534,139,4038,1147,0,0,14858
5/2/2020,24,9537,139,3709,1240,0,0,14625
5/3/2020,1,9538,140,3566,1195,0,0,14439
5/3/2020,2,9538,139,3472,865,0,0,14014
5/3/2020,3,9528,139,3435,803,0,0,13905
5/3/2020,4,9488,139,3413,734,0,0,13774
5/3/2020,5,9314,138,3418,448,1,0,13319
5/3/2020,6,9236,138,3491,652,2,0,13519
5/3/2020,7,9190,137,3476,585,39,0,13427
5/3/2020,8,9140,137,3333,1270,168,0,14048
5/3/2020,9,9143,139,3452,1114,283,0,14131
5/3/2020,10,9222,139,3481,1173,345,0,14360
5/3/2020,11,9368,139,3416,1178,397,0,14498
5/3/2020,12,9523,141,3499,1224,399,0,14786
5/3/2020,13,9522,152,3527,1018,402,0,14621
5/3/2020,14,9465,142,3474,933,383,0,14397
5/3/2020,15,9519,138,3448,993,368,0,14466
5/3/2020,16,9515,138,3561,1182,300,0,14696
5/3/2020,17,9507,140,3866,1641,186,0,15340
5/3/2020,18,9513,140,4068,1675,86,0,15482
5/3/2020,19,9513,144,4007,2017,19,0,15700
5/3/2020,20,9510,139,3569,2312,0,0,15530
5/3/2020,21,9506,140,3466,2103,0,5,15220
5/3/2020,22,9512,140,3442,2012,0,6,15112
5/3/2020,23,9515,142,3387,1663,0,0,14707
5/3/2020,24,9518,218,3469,1315,0,0,14520
5/4/2020,1,9518,251,3361,922,0,2,14054
5/4/2020,2,9517,250,3414,859,0,4,14044
5/4/2020,3,9522,251,3320,965,0,5,14063
5/4/2020,4,9514,257,3335,774,0,7,13887
5/4/2020,5,9519,404,3329,765,0,15,14032
5/4/2020,6,9519,619,3501,1415,5,20,15079
5/4/2020,7,9517,824,3488,2016,29,26,15900
5/4/2020,8,9512,1173,3508,2278,64,27,16562
5/4/2020,9,9519,1255,3508,2395,108,27,16812
5/4/2020,10,9526,1029,3531,2538,157,28,16809
5/4/2020,11,9575,1247,3612,1464,219,31,16148
5/4/2020,12,9614,991,3601,1505,266,28,16005
5/4/2020,13,9615,943,3694,1138,284,25,15699
5/4/2020,14,9645,1023,3565,1387,282,26,15928
5/4/2020,15,9719,1123,3788,1084,271,27,16012
5/4/2020,16,9770,954,3764,1325,260,33,16106
5/4/2020,17,9757,1213,3803,1230,230,57,16290
5/4/2020,18,9747,977,3957,1014,100,75,15870
5/4/2020,19,9750,698,4467,984,19,75,15993
5/4/2020,20,9751,507,5071,879,0,78,16286
5/4/2020,21,9764,459,4963,958,0,80,16224
5/4/2020,22,9763,411,3975,1122,0,80,15351
5/4/2020,23,9769,319,3696,1037,0,22,14843
5/4/2020,24,9771,202,3522,948,0,5,14448
5/5/2020,1,9794,142,3489,809,0,5,14239
5/5/2020,2,9903,141,3406,966,0,5,14421
5/5/2020,3,9963,141,3311,1197,0,5,14617
5/5/2020,4,9975,258,3355,1151,0,10,14749
5/5/2020,5,9977,382,3340,885,1,15,14600
5/5/2020,6,9977,553,3375,924,8,21,14858
5/5/2020,7,9978,621,3697,819,62,26,15203
5/5/2020,8,9968,688,4213,464,162,26,15521
5/5/2020,9,9967,550,4229,416,282,25,15469
5/5/2020,10,9965,553,3855,403,316,26,15118
5/5/2020,11,9969,611,4041,189,325,26,15161
5/5/2020,12,9970,537,3944,254,317,26,15048
5/5/2020,13,9968,577,3914,356,375,25,15215
5/5/2020,14,9975,593,4111,407,367,26,15479
5/5/2020,15,9975,593,4214,334,343,26,15485
5/5/2020,16,9989,600,4165,576,271,41,15642
5/5/2020,17,9993,587,4004,889,195,75,15743
5/5/2020,18,9998,449,4080,1041,89,82,15739
5/5/2020,19,9996,453,4386,1101,25,81,16042
5/5/2020,20,9999,280,4627,1289,1,80,16276
5/5/2020,21,10000,251,4573,1150,0,80,16054
5/5/2020,22,10022,264,4217,1052,0,80,15635
5/5/2020,23,10025,194,3859,853,0,21,14952
5/5/2020,24,10028,158,3669,911,0,5,14771
5/6/2020,1,10032,155,3340,1051,0,5,14583
5/6/2020,2,10026,155,3326,1082,0,5,14594
5/6/2020,3,10034,153,3306,1047,0,5,14545
5/6/2020,4,10073,152,3224,1093,0,10,14552
5/6/2020,5,10068,146,3523,1184,0,19,14940
5/6/2020,6,10067,194,3631,855,10,28,14785
5/6/2020,7,10066,206,4102,877,52,27,15330
5/6/2020,8,10059,261,4470,748,122,27,15687
5/6/2020,9,10057,405,4326,604,241,27,15660
5/6/2020,10,10059,449,4165,299,303,27,15302
5/6/2020,11,10056,449,3863,333,339,27,15067
5/6/2020,12,10065,448,3750,903,397,26,15589
5/6/2020,13,9920,477,3695,1061,396,27,15576
5/6/2020,14,9951,479,3695,1037,400,27,15589
5/6/2020,15,10051,509,3730,764,403,27,15484
5/6/2020,16,10045,510,3761,934,344,29,15623
5/6/2020,17,10046,533,4073,1274,230,62,16218
5/6/2020,18,10053,552,4078,1300,117,80,16180
5/6/2020,19,10050,233,4161,1088,25,80,15637
5/6/2020,20,10041,195,4450,1055,0,80,15821
5/6/2020,21,10044,193,4566,1104,0,81,15988
5/6/2020,22,10049,197,4297,985,0,80,15608
5/6/2020,23,10056,140,4110,928,0,63,15297
5/6/2020,24,10055,134,3691,753,0,47,14680
5/7/2020,1,10053,135,3431,664,0,5,14288
5/7/2020,2,10052,134,3241,640,0,5,14072
5/7/2020,3,10057,134,3196,852,0,5,14244
5/7/2020,4,10058,133,3270,972,0,9,14442
5/7/2020,5,10061,140,3477,922,1,16,14617
5/7/2020,6,10056,286,3541,894,11,25,14813
5/7/2020,7,10058,526,4193,775,69,28,15649
5/7/2020,8,10050,871,4542,434,163,29,16089
5/7/2020,9,10054,935,4392,681,265,26,16353
5/7/2020,10,10055,622,3865,998,297,27,15864
5/7/2020,11,10049,915,3613,1415,344,27,16363
5/7/2020,12,10048,704,3679,1750,329,27,16537
5/7/2020,13,10052,697,3584,2226,265,31,16855
5/7/2020,14,10052,696,3735,1869,272,39,16663
5/7/2020,15,10051,928,3621,1926,205,36,16767
5/7/2020,16,10058,706,3700,2296,141,35,16936
5/7/2020,17,10051,966,3696,2212,107,34,17066
5/7/2020,18,10056,764,4063,2110,90,34,17117
5/7/2020,19,10050,286,4371,1745,26,34,16512
5/7/2020,20,10049,232,4830,1634,0,36,16781
5/7/2020,21,10047,243,4338,1844,0,36,16508
5/7/2020,22,10046,261,4064,1579,0,32,15982
5/7/2020,23,10052,191,3725,1496,0,18,15482
5/7/2020,24,10051,147,3409,1224,0,14,14845
5/8/2020,1,9786,135,3353,1401,0,14,14689
5/8/2020,2,9273,135,3517,1852,0,14,14791
5/8/2020,3,9270,135,3381,1547,0,14,14347
5/8/2020,4,9269,134,3350,1481,0,20,14254
5/8/2020,5,9269,134,3587,1579,2,32,14603
5/8/2020,6,9267,155,3778,1907,10,40,15157
5/8/2020,7,9266,166,4057,1719,63,60,15331
5/8/2020,8,9264,193,4014,2239,148,85,15943
5/8/2020,9,9264,194,4056,2211,212,104,16041
5/8/2020,10,9261,194,4175,2391,222,100,16343
5/8/2020,11,9263,192,3878,2522,228,105,16188
5/8/2020,12,9260,195,4043,2476,259,106,16339
5/8/2020,13,9265,226,4304,2465,235,110,16605
5/8/2020,14,9261,231,3947,2220,215,111,15985
5/8/2020,15,9255,270,3989,2159,200,102,15975
5/8/2020,16,9256,299,4197,2312,202,100,16366
5/8/2020,17,9256,440,4136,2821,147,56,16856
5/8/2020,18,9260,409,4225,2827,71,29,16821
5/8/2020,19,9257,433,4566,2764,27,37,17084
5/8/2020,20,9252,380,4922,2731,3,28,17316
5/8/2020,21,9052,393,5083,2493,0,32,17053
5/8/2020,22,8439,648,5693,2152,0,63,16995
5/8/2020,23,8430,594,4839,2032,0,105,16000
5/8/2020,24,8434,290,4802,2097,0,102,15725
5/9/2020,1,8435,128,4364,2188,0,60,15175
5/9/2020,2,8441,127,3994,2128,0,49,14739
5/9/2020,3,8447,129,4105,1823,0,58,14562
5/9/2020,4,8447,129,4445,1984,0,100,15105
5/9/2020,5,8444,142,4272,2090,2,93,15043
5/9/2020,6,8425,171,4088,2038,3,51,14776
5/9/2020,7,8428,221,4209,2118,24,50,15050
5/9/2020,8,8423,319,4362,2201,57,51,15413
5/9/2020,9,8406,313,4322,2866,104,51,16062
5/9/2020,10,8405,309,3953,3018,171,52,15908
5/9/2020,11,8415,312,3876,3065,235,51,15954
5/9/2020,12,8422,312,3713,3282,273,51,16053
5/9/2020,13,8428,311,3503,3107,290,52,15691
5/9/2020,14,8437,314,3512,3073,268,51,15655
5/9/2020,15,8464,318,3606,3021,244,51,15704
5/9/2020,16,8461,331,3976,2983,226,51,16028
5/9/2020,17,8451,342,4563,2934,138,51,16479
5/9/2020,18,8448,214,5072,2664,71,52,16521
5/9/2020,19,8466,319,4988,2531,23,53,16380
5/9/2020,20,8460,319,5160,2197,1,53,16190
5/9/2020,21,8443,319,4870,1703,0,51,15386
5/9/2020,22,8456,320,5014,1513,0,57,15360
5/9/2020,23,8472,166,5027,1400,0,116,15181
5/9/2020,24,8470,129,4355,1715,0,87,14756
5/10/2020,1,8471,128,3791,1860,0,8,14258
5/10/2020,2,8467,128,3749,1448,0,0,13792
5/10/2020,3,8469,128,3534,1675,0,4,13810
5/10/2020,4,8467,128,3444,1751,0,4,13794
5/10/2020,5,8469,127,3848,1619,2,6,14071
5/10/2020,6,8471,128,3774,1596,10,14,13993
5/10/2020,7,8468,127,4334,1227,58,32,14246
5/10/2020,8,8465,126,4812,1388,122,52,14965
5/10/2020,9,8461,130,4882,1562,187,51,15273
5/10/2020,10,8462,142,4348,1736,231,50,14969
5/10/2020,11,8456,135,4204,1927,247,52,15021
5/10/2020,12,8463,156,4174,2171,226,51,15241
5/10/2020,13,8460,173,4173,2224,227,52,15309
5/10/2020,14,8452,210,4107,2234,268,53,15324
5/10/2020,15,8455,256,4253,2147,219,53,15383
5/10/2020,16,8462,308,4384,2066,143,53,15416
5/10/2020,17,8463,383,5249,1981,85,52,16213
5/10/2020,18,8464,524,5517,1775,46,52,16378
5/10/2020,19,8467,594,5854,1164,13,53,16145
5/10/2020,20,8453,831,5818,944,1,55,16102
5/10/2020,21,8460,782,4901,1163,0,59,15365
5/10/2020,22,8462,651,4623,1329,0,59,15124
5/10/2020,23,8465,211,4388,1648,0,70,14782
5/10/2020,24,8465,128,3803,1672,0,16,14084
5/11/2020,1,8467,244,3775,1550,0,4,14040
5/11/2020,2,8469,288,3663,1574,0,4,13998
5/11/2020,3,8469,288,3709,1915,0,5,14386
5/11/2020,4,8465,288,3826,2020,0,8,14607
5/11/2020,5,8467,297,3917,1872,1,27,14581
5/11/2020,6,8582,368,4221,1859,3,83,15116
5/11/2020,7,8705,532,4706,1920,16,93,15972
5/11/2020,8,8704,531,5327,1792,50,123,16527
5/11/2020,9,8700,557,5375,1724,123,131,16610
5/11/2020,10,8734,565,5255,1897,144,99,16694
5/11/2020,11,8862,541,4633,2204,171,109,16520
5/11/2020,12,8873,551,4753,2108,192,104,16581
5/11/2020,13,8954,587,4721,1938,226,97,16523
5/11/2020,14,9046,719,4583,1729,242,107,16426
5/11/2020,15,9043,857,4437,1865,217,94,16513
5/11/2020,16,9040,787,4812,1612,180,47,16478
5/11/2020,17,9045,1084,4879,1610,148,41,16807
5/11/2020,18,9049,1283,4901,1330,88,45,16696
5/11/2020,19,9058,1414,5148,1132,26,41,16819
5/11/2020,20,9052,1389,5358,754,2,54,16609
5/11/2020,21,9050,1231,5486,819,0,73,16659
5/11/2020,22,9062,879,4985,1225,0,82,16233
5/11/2020,23,9170,714,4409,1473,0,72,15838
5/11/2020,24,9231,546,3937,1270,0,63,15047
5/12/2020,1,9233,246,4363,888,0,112,14842
5/12/2020,2,9228,155,4177,974,0,158,14692
5/12/2020,3,9234,155,3746,1141,0,150,14426
5/12/2020,4,9237,155,3587,1362,0,71,14412
5/12/2020,5,9240,156,4065,1195,3,74,14733
5/12/2020,6,9255,159,4583,948,13,111,15069
5/12/2020,7,9251,190,5201,699,73,151,15565
5/12/2020,8,9247,199,5459,574,206,89,15774
5/12/2020,9,9245,204,5034,699,292,83,15557
5/12/2020,10,9244,170,4349,1034,323,82,15202
5/12/2020,11,9244,167,4133,1680,321,87,15632
5/12/2020,12,9252,168,3988,2195,320,82,16005
5/12/2020,13,9262,257,4148,2460,303,89,16519
5/12/2020,14,9261,389,3806,2143,307,91,15997
5/12/2020,15,9262,564,3860,1673,231,80,15670
5/12/2020,16,9259,646,3894,1944,282,79,16104
5/12/2020,17,9260,722,3911,2105,235,84,16317
5/12/2020,18,9265,726,4369,2028,126,84,16598
5/12/2020,19,9265,727,4646,1718,25,86,16467
5/12/2020,20,9259,734,5258,1562,4,80,16897
5/12/2020,21,9260,728,5178,1165,0,78,16409
5/12/2020,22,9266,637,5114,855,0,108,15980
5/12/2020,23,9265,435,4846,615,0,96,15257
5/12/2020,24,9262,233,4637,451,0,111,14694
5/13/2020,1,9266,142,4373,427,0,155,14363
5/13/2020,2,9257,141,3877,391,0,139,13805
5/13/2020,3,9271,142,3938,365,0,156,13872
5/13/2020,4,9279,141,4402,283,1,170,14276
5/13/2020,5,9433,141,4791,298,1,207,14871
5/13/2020,6,9480,154,4969,340,13,230,15186
5/13/2020,7,9479,173,4964,277,75,222,15190
5/13/2020,8,9469,211,4924,100,208,225,15137
5/13/2020,9,9424,311,4580,72,340,213,14940
5/13/2020,10,9435,358,4037,108,414,192,14544
5/13/2020,11,9432,353,4107,195,431,218,14736
5/13/2020,12,9428,196,4002,329,430,204,14589
5/13/2020,13,9430,254,3849,525,431,137,14626
5/13/2020,14,9428,323,3532,565,428,114,14390
5/13/2020,15,9433,470,3550,473,400,112,14438
5/13/2020,16,9429,510,4053,346,328,112,14778
5/13/2020,17,9370,513,4548,417,258,87,15193
5/13/2020,18,9349,515,5070,514,125,80,15653
5/13/2020,19,9378,515,5143,458,25,91,15610
5/13/2020,20,9411,516,5371,454,1,142,15895
5/13/2020,21,9433,518,5250,680,0,188,16069
5/13/2020,22,9654,422,4268,886,0,118,15348
5/13/2020,23,9746,233,4094,977,0,87,15137
5/13/2020,24,9899,142,3719,937,0,56,14753
5/14/2020,1,9904,139,3427,737,0,19,14226
5/14/2020,2,9906,140,3464,944,0,6,14460
5/14/2020,3,9903,258,3506,741,0,5,14413
5/14/2020,4,9909,287,3629,710,0,7,14542
5/14/2020,5,9908,365,3595,942,0,9,14819
5/14/2020,6,9906,541,3651,776,13,21,14908
5/14/2020,7,9905,679,3715,1470,57,26,15852
5/14/2020,8,9899,942,3911,1738,118,26,16634
5/14/2020,9,9902,968,4008,1845,156,26,16905
5/14/2020,10,9899,966,3869,1338,226,26,16324
5/14/2020,11,9897,962,3752,1153,247,25,16036
5/14/2020,12,9903,953,3749,1722,262,26,16615
5/14/2020,13,9902,946,3899,1662,215,26,16650
5/14/2020,14,9900,1009,4125,1791,162,25,17012
5/14/2020,15,9902,1021,4253,1550,115,31,16872
5/14/2020,16,9902,1030,4826,1240,79,28,17105
5/14/2020,17,9902,1223,4916,936,56,25,17058
5/14/2020,18,9898,1404,4505,900,29,26,16762
5/14/2020,19,9896,1363,4468,621,10,27,16385
5/14/2020,20,9899,1146,4352,688,0,27,16112
5/14/2020,21,9895,1054,4266,573,0,28,15816
5/14/2020,22,9905,480,4219,956,0,27,15587
5/14/2020,23,9906,141,3938,1163,0,23,15171
5/14/2020,24,9910,136,3570,1092,0,6,14714
5/15/2020,1,9907,138,3455,880,0,5,14385
5/15/2020,2,9912,138,3382,781,0,5,14218
5/15/2020,3,9913,138,3411,698,0,5,14165
5/15/2020,4,9909,137,3418,756,0,9,14229
5/15/2020,5,9902,137,3591,745,0,16,14391
5/15/2020,6,9909,169,3822,765,6,24,14695
5/15/2020,7,9808,196,3971,916,22,27,14940
5/15/2020,8,9805,223,4347,1108,50,27,15560
5/15/2020,9,9806,220,4469,1370,92,27,15984
5/15/2020,10,9801,194,4150,1638,172,26,15981
5/15/2020,11,9804,194,4011,1543,178,28,15758
5/15/2020,12,9841,195,4232,1808,148,28,16252
5/15/2020,13,9851,225,4786,1592,166,35,16655
5/15/2020,14,9855,357,5202,1069,88,60,16631
5/15/2020,15,9853,263,4909,973,92,116,16206
5/15/2020,16,9847,194,4791,869,97,97,15895
5/15/2020,17,9892,260,4679,585,77,76,15569
5/15/2020,18,9906,314,4899,564,57,77,15817
5/15/2020,19,9913,315,5104,306,33,80,15751
5/15/2020,20,9913,318,5427,284,2,136,16080
5/15/2020,21,9927,331,5539,332,0,212,16341
5/15/2020,22,9918,326,5109,402,0,215,15970
5/15/2020,23,9920,236,4424,458,0,136,15174
5/15/2020,24,9920,180,4083,362,0,78,14623
5/16/2020,1,9927,118,3609,448,0,79,14181
5/16/2020,2,10012,120,3370,516,0,56,14074
5/16/2020,3,10071,119,3250,501,0,56,13997
5/16/2020,4,10071,117,3125,578,0,50,13941
5/16/2020,5,10076,116,3205,528,2,54,13981
5/16/2020,6,10080,117,3155,580,12,55,13999
5/16/2020,7,10078,118,3506,553,51,90,14396
5/16/2020,8,10075,119,3960,425,105,175,14859
5/16/2020,9,10071,120,3897,336,152,145,14721
5/16/2020,10,10076,120,4031,258,225,149,14859
5/16/2020,11,10072,120,3739,215,288,92,14526
5/16/2020,12,10063,119,3881,338,315,79,14795
5/16/2020,13,10052,120,3815,479,299,54,14819
5/16/2020,14,10051,120,3710,508,298,55,14742
5/16/2020,15,10060,119,3647,452,265,56,14599
5/16/2020,16,10063,119,3943,373,230,56,14784
5/16/2020,17,10065,118,4182,807,225,56,15453
5/16/2020,18,10067,120,4281,759,105,56,15388
5/16/2020,19,10064,119,4368,851,29,56,15487
5/16/2020,20,10067,118,4388,917,2,63,15555
5/16/2020,21,10103,118,4428,1112,0,88,15849
5/16/2020,22,10102,119,3800,1252,0,66,15339
5/16/2020,23,10106,118,3506,1120,0,51,14901
5/16/2020,24,10104,118,3235,948,0,8,14413
5/17/2020,1,10103,117,3111,630,0,0,13961
5/17/2020,2,9835,118,3103,652,0,0,13708
5/17/2020,3,9511,116,3123,825,0,1,13576
5/17/2020,4,9515,115,3051,782,0,0,13463
5/17/2020,5,9510,115,3003,842,2,0,13472
5/17/2020,6,9511,115,2950,849,11,0,13436
5/17/2020,7,9512,115,3074,624,44,0,13369
5/17/2020,8,8938,116,3601,1125,180,0,13960
5/17/2020,9,8859,117,3508,1483,266,0,14233
5/17/2020,10,9155,117,3572,1098,316,0,14258
5/17/2020,11,9178,118,3619,1320,277,0,14512
5/17/2020,12,9162,121,3613,1633,252,0,14781
5/17/2020,13,9197,120,3568,1854,225,0,14964
5/17/2020,14,9233,118,3472,2007,196,0,15026
5/17/2020,15,9252,118,3519,2182,183,0,15254
5/17/2020,16,9254,120,3746,2665,110,0,15895
5/17/2020,17,9255,119,4008,2985,62,0,16429
5/17/2020,18,9255,119,3962,2895,37,0,16268
5/17/2020,19,9254,119,3926,2590,11,0,15900
5/17/2020,20,9251,122,3935,2580,1,0,15889
5/17/2020,21,9256,120,3882,2767,0,0,16025
5/17/2020,22,9258,118,3472,2859,0,0,15707
5/17/2020,23,9259,118,3405,2435,0,0,15217
5/17/2020,24,9256,118,3422,1724,0,0,14520
5/18/2020,1,9260,119,3220,1458,0,0,14057
5/18/2020,2,9262,120,3234,1370,0,0,13986
5/18/2020,3,9260,119,3216,1286,0,0,13881
5/18/2020,4,9262,120,3232,1240,0,0,13854
5/18/2020,5,9257,118,3285,1226,1,0,13887
5/18/2020,6,9261,117,3261,1341,4,0,13984
5/18/2020,7,9261,118,3291,1600,17,0,14287
5/18/2020,8,9252,118,3405,2070,53,0,14898
5/18/2020,9,9253,118,3500,2260,92,0,15223
5/18/2020,10,9251,118,3527,2730,110,0,15736
5/18/2020,11,9249,125,3553,3026,137,0,16090
5/18/2020,12,9244,252,3510,3137,205,0,16348
5/18/2020,13,9248,283,3473,2807,206,0,16017
5/18/2020,14,9254,347,3472,2758,215,0,16046
5/18/2020,15,9255,516,3543,2517,192,0,16023
5/18/2020,16,9265,636,3645,2983,128,0,16657
5/18/2020,17,9305,657,3873,3334,87,0,17256
5/18/2020,18,9313,659,3867,3434,57,0,17330
5/18/2020,19,9313,660,3888,3303,24,0,17188
5/18/2020,20,9309,659,3900,3367,1,0,17236
5/18/2020,21,9308,658,3909,3073,0,2,16950
5/18/2020,22,9313,659,3781,2516,0,0,16269
5/18/2020,23,9315,289,3575,2029,0,0,15208
5/18/2020,24,9308,119,3399,1856,0,1,14683
5/19/2020,1,9320,117,3294,1634,0,4,14369
5/19/2020,2,9322,117,3238,1568,0,4,14249
5/19/2020,3,9324,115,3155,1628,0,5,14227
5/19/2020,4,9325,121,3121,1697,0,9,14273
5/19/2020,5,9315,154,3140,1352,2,24,13987
5/19/2020,6,9315,335,3338,1636,11,29,14664
5/19/2020,7,9317,613,3570,1946,52,28,15526
5/19/2020,8,9314,950,3726,2304,112,26,16432
5/19/2020,9,9310,984,3790,2294,173,26,16577
5/19/2020,10,9312,981,3867,2100,240,26,16526
5/19/2020,11,9309,974,3895,2026,289,26,16519
5/19/2020,12,9307,969,3809,2120,324,26,16555
5/19/2020,13,9305,963,3811,1902,335,26,16342
5/19/2020,14,9307,957,3754,1751,328,26,16123
5/19/2020,15,9304,955,3801,1724,296,26,16106
5/19/2020,16,9301,955,3809,1924,308,26,16323
5/19/2020,17,9257,948,4005,2336,249,26,16821
5/19/2020,18,9250,955,4080,2359,153,26,16823
5/19/2020,19,9254,954,3995,2359,99,26,16687
5/19/2020,20,9253,957,4031,2163,81,27,16512
5/19/2020,21,9247,962,3859,2129,78,26,16301
5/19/2020,22,9247,968,3842,2070,78,27,16232
5/19/2020,23,9254,919,3661,1584,78,21,15517
5/19/2020,24,9256,908,3575,998,78,5,14820
5/20/2020,1,9256,299,3349,1509,78,4,14495
5/20/2020,2,9266,148,3301,1455,1,5,14176
5/20/2020,3,9266,147,3330,1332,0,5,14080
5/20/2020,4,9265,147,3374,1290,0,8,14084
5/20/2020,5,9265,154,3463,1400,57,16,14355
5/20/2020,6,9263,314,3520,1688,82,18,14885
5/20/2020,7,9265,527,3745,1710,132,23,15402
5/20/2020,8,9259,707,3998,1759,204,26,15953
5/20/2020,9,9254,941,4025,1218,329,26,15793
5/20/2020,10,9245,1065,4072,761,325,26,15494
5/20/2020,11,9244,1109,4234,593,207,27,15414
5/20/2020,12,9245,1052,4204,871,416,27,15815
5/20/2020,13,9249,1130,4157,781,422,27,15766
5/20/2020,14,9242,1139,4162,678,417,27,15665
5/20/2020,15,9243,1135,4240,607,399,27,15651
5/20/2020,16,9247,1132,4380,779,368,27,15933
5/20/2020,17,9245,1128,4492,1468,259,28,16620
5/20/2020,18,9245,1132,4359,1405,125,26,16292
5/20/2020,19,9247,1160,4731,1304,26,28,16496
5/20/2020,20,9248,1227,4922,1288,3,28,16716
5/20/2020,21,9246,1141,4849,1533,0,26,16795
5/20/2020,22,9245,1146,4161,1759,0,26,16337
5/20/2020,23,9247,1104,3919,1248,0,17,15535
5/20/2020,24,9248,1108,3810,583,0,12,14761
5/21/2020,1,9251,995,3697,378,0,5,14326
5/21/2020,2,9259,312,3440,1063,0,5,14079
5/21/2020,3,9259,147,3495,1038,0,5,13944
5/21/2020,4,9260,147,3488,1137,0,11,14043
5/21/2020,5,9263,155,3628,1237,1,16,14300
5/21/2020,6,9260,285,3864,978,12,25,14424
5/21/2020,7,9255,518,4102,1077,71,51,15074
5/21/2020,8,9252,712,4430,767,203,53,15417
5/21/2020,9,9251,737,4698,542,329,52,15609
5/21/2020,10,9250,811,4723,321,403,52,15560
5/21/2020,11,9248,828,4531,268,422,52,15349
5/21/2020,12,9248,825,4388,270,430,52,15213
5/21/2020,13,9248,828,4328,303,429,49,15185
5/21/2020,14,9251,820,4099,247,422,51,14890
5/21/2020,15,9245,924,4273,304,406,49,15201
5/21/2020,16,9247,1070,5012,295,346,39,16009
5/21/2020,17,9248,1105,5634,283,246,66,16582
5/21/2020,18,9259,780,5955,201,124,113,16432
5/21/2020,19,9255,622,5948,241,26,152,16244
5/21/2020,20,9253,581,5794,293,3,187,16111
5/21/2020,21,9255,585,5684,343,0,158,16025
5/21/2020,22,9259,592,5240,423,0,151,15665
5/21/2020,23,9260,301,4716,391,0,116,14784
5/21/2020,24,9262,145,4313,335,0,110,14165
5/22/2020,1,9262,146,3978,372,0,102,13860
5/22/2020,2,9264,145,3596,470,0,59,13534
5/22/2020,3,9263,146,3527,467,0,58,13461
5/22/2020,4,9262,145,3646,292,0,64,13409
5/22/2020,5,9263,146,4046,292,3,68,13818
5/22/2020,6,9260,198,4564,177,10,94,14303
5/22/2020,7,9258,364,4935,73,65,122,14817
5/22/2020,8,9257,566,4898,23,181,123,15048
5/22/2020,9,9253,1014,4725,30,293,127,15442
5/22/2020,10,9254,1153,4453,15,358,126,15359
5/22/2020,11,9249,1149,4543,19,381,125,15466
5/22/2020,12,9250,1188,4679,31,368,138,15654
5/22/2020,13,9247,1250,4813,96,325,161,15892
5/22/2020,14,9244,1147,4358,133,299,128,15309
5/22/2020,15,9248,1197,4569,134,293,126,15567
5/22/2020,16,9250,1104,4770,238,229,127,15718
5/22/2020,17,9249,1172,5367,193,160,127,16268
5/22/2020,18,9252,1266,5698,129,70,125,16540
5/22/2020,19,9253,1296,5541,64,19,126,16299
5/22/2020,20,9249,1328,5643,58,4,126,16408
5/22/2020,21,9248,1329,5652,79,0,127,16435
5/22/2020,22,9244,1296,5181,61,0,125,15907
5/22/2020,23,9251,537,5224,53,0,118,15183
5/22/2020,24,9251,355,4663,100,0,111,14480
5/23/2020,1,9254,205,4446,81,0,58,14044
5/23/2020,2,9252,139,4385,30,0,56,13862
5/23/2020,3,9255,121,4156,48,0,56,13636
5/23/2020,4,9257,119,3788,75,0,56,13295
5/23/2020,5,9254,120,3764,77,1,56,13272
5/23/2020,6,9255,119,3634,174,11,56,13249
5/23/2020,7,9251,119,3861,171,68,56,13526
5/23/2020,8,9252,121,4377,70,160,56,14036
5/23/2020,9,9249,122,4942,59,230,56,14658
5/23/2020,10,9237,120,4837,80,288,56,14618
5/23/2020,11,9189,122,5135,122,351,56,14975
5/23/2020,12,9190,141,5150,154,339,56,15030
5/23/2020,13,9192,140,5020,188,378,56,14974
5/23/2020,14,9194,119,5012,266,390,56,15037
5/23/2020,15,9186,145,5232,340,358,56,15317
5/23/2020,16,9185,195,5507,325,320,80,15612
5/23/2020,17,9188,531,5582,353,221,138,16013
5/23/2020,18,9223,441,5229,435,103,87,15518
5/23/2020,19,9232,200,5415,447,32,54,15380
5/23/2020,20,9232,126,5598,404,6,69,15435
5/23/2020,21,9240,241,5935,383,0,134,15933
5/23/2020,22,9247,255,5181,541,0,67,15291
5/23/2020,23,9230,226,4554,783,0,54,14847
5/23/2020,24,9249,121,4407,896,0,54,14727
5/24/2020,1,9257,120,3988,1236,0,17,14618
5/24/2020,2,9259,120,3874,976,0,0,14229
5/24/2020,3,9255,120,3871,1015,0,0,14261
5/24/2020,4,9263,120,3558,1212,0,0,14153
5/24/2020,5,9259,120,3598,1367,2,0,14346
5/24/2020,6,9257,117,3685,1230,14,0,14303
5/24/2020,7,9260,119,3770,1272,61,0,14482
5/24/2020,8,9247,121,4033,1301,184,0,14886
5/24/2020,9,9250,123,4145,1577,273,0,15368
5/24/2020,10,9245,123,4227,1596,340,0,15531
5/24/2020,11,9235,121,4463,1277,312,0,15408
5/24/2020,12,9239,123,4418,1336,316,0,15432
5/24/2020,13,9237,122,4407,1360,334,0,15460
5/24/2020,14,9236,153,4351,1735,377,0,15852
5/24/2020,15,9205,189,4156,1910,371,0,15831
5/24/2020,16,9226,225,4602,1853,296,0,16202
5/24/2020,17,9233,306,5056,2064,212,0,16871
5/24/2020,18,9238,450,5602,1770,107,0,17167
5/24/2020,19,9234,571,5585,1626,31,0,17047
5/24/2020,20,9234,542,5003,1657,4,0,16440
5/24/2020,21,9228,538,4902,1763,0,0,16431
5/24/2020,22,9221,535,4745,1870,0,0,16371
5/24/2020,23,9211,535,4509,1612,0,0,15867
5/24/2020,24,9222,536,4315,1450,0,0,15523
5/25/2020,1,9228,215,3965,1383,0,3,14794
5/25/2020,2,9236,114,3568,1496,0,4,14418
5/25/2020,3,9238,157,3463,1158,0,4,14020
5/25/2020,4,9243,160,3632,1115,0,6,14156
5/25/2020,5,9242,182,3772,807,2,14,14019
5/25/2020,6,9242,236,4108,571,6,20,14183
5/25/2020,7,9238,310,4812,432,46,26,14864
5/25/2020,8,9233,646,5193,544,139,26,15781
5/25/2020,9,9236,988,5688,576,218,26,16732
5/25/2020,10,9233,1374,5679,487,297,27,17097
5/25/2020,11,9228,1366,5811,476,357,27,17265
5/25/2020,12,9225,1494,5684,451,411,27,17292
5/25/2020,13,9227,1767,5776,441,420,28,17659
5/25/2020,14,9232,2243,5895,527,410,29,18336
5/25/2020,15,9230,2219,5997,523,388,44,18401
5/25/2020,16,9226,2299,6094,368,310,81,18378
5/25/2020,17,9226,2789,5925,394,219,99,18652
5/25/2020,18,9225,2487,5746,464,106,76,18104
5/25/2020,19,9222,2386,5927,390,30,78,18033
5/25/2020,20,9209,2294,5998,511,7,76,18095
5/25/2020,21,9212,2169,5591,656,1,77,17706
5/25/2020,22,9212,1804,5217,884,0,76,17193
5/25/2020,23,9211,1240,4795,814,0,61,16121
5/25/2020,24,9219,746,4666,822,0,58,15511
5/26/2020,1,9230,641,4822,688,1,19,15401
5/26/2020,2,9233,659,4771,669,0,5,15337
5/26/2020,3,9238,624,4507,645,0,5,15019
5/26/2020,4,9237,680,4451,587,0,10,14965
5/26/2020,5,9233,933,4455,487,2,15,15125
5/26/2020,6,9227,1388,4291,269,8,19,15202
5/26/2020,7,9228,1612,4492,208,54,36,15630
5/26/2020,8,9221,1726,5125,159,164,66,16461
5/26/2020,9,9216,2203,5425,103,266,81,17294
5/26/2020,10,9214,2614,5283,140,343,84,17678
5/26/2020,11,9212,2779,5311,176,379,82,17939
5/26/2020,12,9213,2887,5302,252,395,86,18135
5/26/2020,13,9218,3151,5161,406,384,91,18411
5/26/2020,14,9213,3406,5225,508,375,84,18811
5/26/2020,15,9209,3427,5347,534,345,80,18942
5/26/2020,16,9204,3526,5431,533,290,62,19046
5/26/2020,17,9206,3802,5398,446,205,79,19136
5/26/2020,18,9207,3741,5409,483,93,79,19012
5/26/2020,19,9205,3970,5454,393,24,78,19124
5/26/2020,20,9204,3936,5344,329,4,78,18895
5/26/2020,21,9204,3763,5264,440,0,74,18745
5/26/2020,22,9207,3168,5140,550,0,78,18143
5/26/2020,23,9212,2441,4986,646,0,64,17349
5/26/2020,24,9215,1913,4792,697,0,68,16685
5/27/2020,1,9222,1376,4622,1009,0,57,16286
5/27/2020,2,9222,1167,4287,1472,0,14,16162
5/27/2020,3,9223,1126,4107,1211,0,4,15671
5/27/2020,4,9226,1287,4137,1040,0,9,15699
5/27/2020,5,9224,1596,4078,838,1,15,15752
5/27/2020,6,9223,1953,4171,791,9,23,16170
5/27/2020,7,9225,2178,4736,1113,68,26,17346
5/27/2020,8,9222,2495,5203,1072,169,26,18187
5/27/2020,9,9219,2681,5302,895,266,26,18389
5/27/2020,10,9215,2944,5183,771,315,27,18455
5/27/2020,11,9210,3156,5076,806,322,65,18635
5/27/2020,12,9207,3165,5150,745,361,78,18706
5/27/2020,13,9205,3177,5180,715,322,80,18679
5/27/2020,14,9206,3414,5247,784,301,81,19033
5/27/2020,15,9201,3591,5151,851,273,87,19154
5/27/2020,16,9199,3419,5259,914,264,89,19144
5/27/2020,17,9199,3362,5365,985,177,91,19179
5/27/2020,18,9202,3535,5452,918,97,89,19293
5/27/2020,19,9201,3617,5269,750,32,90,18959
5/27/2020,20,9202,3354,5271,672,5,87,18591
5/27/2020,21,9203,3218,5263,833,0,37,18554
5/27/2020,22,9198,2750,4858,1151,0,27,17984
5/27/2020,23,9208,1898,4619,1302,0,17,17044
5/27/2020,24,9216,1327,4535,1285,0,8,16371
5/28/2020,1,9218,819,4272,1482,0,4,15795
5/28/2020,2,9217,611,4156,1363,0,4,15351
5/28/2020,3,9216,613,3920,1538,0,5,15292
5/28/2020,4,9219,800,3805,1665,0,6,15495
5/28/2020,5,9212,1087,3877,1254,1,15,15446
5/28/2020,6,9213,1389,4094,1149,7,23,15875
5/28/2020,7,9211,1467,4628,1214,39,45,16604
5/28/2020,8,9205,1521,4902,1633,71,76,17408
5/28/2020,9,9208,1823,5114,1376,156,82,17759
5/28/2020,10,9205,2268,4897,1132,190,81,17773
5/28/2020,11,9201,2895,5082,908,172,82,18340
5/28/2020,12,9195,3114,4985,688,200,82,18264
5/28/2020,13,9064,3132,4901,575,195,82,17949
5/28/2020,14,9025,3259,4603,542,158,82,17669
5/28/2020,15,9110,3190,4708,376,59,83,17526
5/28/2020,16,9200,3009,4738,649,110,82,17788
5/28/2020,17,9202,2616,4779,978,95,82,17752
5/28/2020,18,9197,2046,4687,993,60,83,17066
5/28/2020,19,9194,1787,4617,966,23,83,16670
5/28/2020,20,9189,1744,4617,852,4,82,16488
5/28/2020,21,9179,1570,4597,1526,0,41,16913
5/28/2020,22,9176,980,4711,1728,0,27,16622
5/28/2020,23,9173,299,4540,2193,0,16,16221
5/28/2020,24,9182,203,4375,2029,0,7,15796
5/29/2020,1,9191,205,4010,2245,0,4,15655
5/29/2020,2,9205,206,3700,2208,0,4,15323
5/29/2020,3,9210,215,3687,2203,0,4,15319
5/29/2020,4,9213,381,3750,1930,0,5,15279
5/29/2020,5,9213,651,3713,1678,1,15,15271
5/29/2020,6,9206,894,4098,1192,8,25,15423
5/29/2020,7,9196,973,4729,1201,60,27,16186
5/29/2020,8,9196,978,5151,1403,114,27,16869
5/29/2020,9,9198,1194,5496,1409,134,28,17459
5/29/2020,10,9201,1466,5373,1463,129,27,17659
5/29/2020,11,9204,1302,5150,1859,179,34,17728
5/29/2020,12,9200,1225,4648,1904,210,68,17255
5/29/2020,13,9209,1453,4686,2361,197,82,17988
5/29/2020,14,9211,2139,4998,2257,205,82,18892
5/29/2020,15,9211,2098,5092,1914,142,82,18539
5/29/2020,16,9202,2002,5042,1688,83,82,18099
5/29/2020,17,9191,1947,4761,1255,91,82,17327
5/29/2020,18,9192,1918,4661,867,58,45,16741
5/29/2020,19,9194,1514,4746,820,23,27,16324
5/29/2020,20,9207,1213,5271,725,4,26,16446
5/29/2020,21,9213,1015,5405,630,0,26,16289
5/29/2020,22,9221,919,5044,572,0,27,15783
5/29/2020,23,9220,381,4980,588,0,14,15183
5/29/2020,24,9225,117,4411,554,0,1,14308
5/30/2020,1,9229,117,4095,347,0,0,13788
5/30/2020,2,9236,114,4027,327,0,0,13704
5/30/2020,3,9234,116,3546,578,0,0,13474
5/30/2020,4,9054,116,3606,561,0,0,13337
5/30/2020,5,8948,116,3634,560,1,0,13259
5/30/2020,6,8992,116,3679,616,14,0,13417
5/30/2020,7,9018,118,3621,718,63,0,13538
5/30/2020,8,9213,117,3840,641,126,0,13937
5/30/2020,9,9227,117,3969,915,180,0,14408
5/30/2020,10,9225,116,3853,1391,266,0,14851
5/30/2020,11,9191,116,3861,1567,263,0,14998
5/30/2020,12,9186,117,3897,1707,285,0,15192
5/30/2020,13,9168,116,3951,2165,261,0,15661
5/30/2020,14,9155,116,4057,2153,204,0,15685
5/30/2020,15,9151,117,4165,2190,190,0,15813
5/30/2020,16,9160,118,4463,2031,154,0,15926
5/30/2020,17,9155,119,4587,1828,163,0,15852
5/30/2020,18,9159,126,4784,1710,113,0,15892
5/30/2020,19,9169,121,4496,1847,35,0,15668
5/30/2020,20,9172,120,4594,1530,7,0,15423
5/30/2020,21,9194,119,4693,1470,0,0,15476
5/30/2020,22,9205,117,4339,1190,0,1,14852
5/30/2020,23,9205,118,3934,1187,0,0,14444
5/30/2020,24,9196,119,3814,968,0,0,14097
5/31/2020,1,9039,117,3801,694,0,0,13651
5/31/2020,2,8517,116,3762,1014,0,0,13409
5/31/2020,3,8347,117,3751,984,0,0,13199
5/31/2020,4,8350,117,3765,947,0,0,13179
5/31/2020,5,8350,115,3748,830,2,0,13045
5/31/2020,6,8352,116,3775,783,18,0,13044
5/31/2020,7,8433,116,3972,770,68,0,13359
5/31/2020,8,8800,118,4077,909,166,0,14070
5/31/2020,9,9205,117,3851,425,274,0,13872
5/31/2020,10,9226,116,3940,903,334,0,14519
5/31/2020,11,9223,116,4195,958,297,0,14789
5/31/2020,12,9227,119,4304,1017,312,0,14979
5/31/2020,13,9235,120,4092,908,319,0,14674
5/31/2020,14,9198,118,3955,662,314,0,14247
5/31/2020,15,9237,118,3915,607,319,0,14196
5/31/2020,16,9233,118,4334,739,297,0,14721
5/31/2020,17,9233,119,4767,960,241,0,15320
5/31/2020,18,9241,116,4843,813,104,0,15117
5/31/2020,19,9235,116,5096,824,37,0,15308
5/31/2020,20,9237,118,5327,709,8,0,15399
5/31/2020,21,9234,168,5547,711,0,0,15660
5/31/2020,22,9228,145,5090,902,0,0,15365
5/31/2020,23,9224,117,4391,1007,0,0,14739
5/31/2020,24,9222,115,3827,633,0,0,13797
6/1/2020,1,8952,115,3624,607,0,0,13298
6/1/2020,2,8420,117,3593,989,0,2,13121
6/1/2020,3,8110,176,3632,1205,0,5,13128
6/1/2020,4,7788,277,3704,955,0,12,12736
6/1/2020,5,7949,302,3587,1117,1,14,12970
6/1/2020,6,8530,343,3659,981,16,21,13550
6/1/2020,7,9010,416,3982,715,69,27,14219
6/1/2020,8,9218,537,4287,487,194,27,14750
6/1/2020,9,9220,544,4358,516,316,29,14983
6/1/2020,10,9210,604,4436,814,399,28,15491
6/1/2020,11,9206,623,4320,1099,371,27,15646
6/1/2020,12,9204,678,4286,1509,370,27,16074
6/1/2020,13,9200,715,4036,1426,406,27,15810
6/1/2020,14,9199,723,4102,1172,369,29,15594
6/1/2020,15,9196,773,4248,1349,387,27,15980
6/1/2020,16,9203,909,4452,1335,311,27,16237
6/1/2020,17,9205,873,4733,1460,219,27,16517
6/1/2020,18,9206,835,4982,1843,106,27,16999
6/1/2020,19,9203,855,4864,1866,29,26,16843
6/1/2020,20,9195,862,4881,1777,6,26,16747
6/1/2020,21,9197,912,5320,1778,0,26,17233
6/1/2020,22,9200,683,4468,1765,0,26,16142
6/1/2020,23,9212,268,3931,1716,0,17,15144
6/1/2020,24,9211,141,3757,1297,0,5,14411
6/2/2020,1,9209,141,3528,1391,0,4,14273
6/2/2020,2,9194,132,3472,1265,0,4,14067
6/2/2020,3,9194,232,3442,979,0,5,13852
6/2/2020,4,9193,354,3567,765,0,11,13890
6/2/2020,5,9201,477,3486,830,2,13,14009
6/2/2020,6,9208,506,3481,1844,3,24,15066
6/2/2020,7,9207,535,3740,2582,17,27,16108
6/2/2020,8,9202,543,4162,2250,49,27,16233
6/2/2020,9,9201,657,4453,1692,93,27,16123
6/2/2020,10,9208,748,4386,1450,174,27,15993
6/2/2020,11,9212,807,4524,1323,247,38,16151
6/2/2020,12,9201,962,4603,1207,284,41,16298
6/2/2020,13,9204,1119,4910,1158,281,51,16723
6/2/2020,14,9206,1146,4748,1350,284,52,16786
6/2/2020,15,9203,1106,4884,1473,281,53,17000
6/2/2020,16,9217,1365,5189,1549,228,51,17599
6/2/2020,17,9243,1558,5194,1736,160,54,17945
6/2/2020,18,9435,1592,4859,1526,82,54,17548
6/2/2020,19,9436,1415,4729,1427,25,55,17087
6/2/2020,20,9416,1172,4925,1581,3,55,17152
6/2/2020,21,9585,987,4903,1876,0,46,17397
6/2/2020,22,9794,752,4561,1747,0,33,16887
6/2/2020,23,9868,667,4524,1132,0,25,16216
6/2/2020,24,9880,505,4208,758,0,12,15363
6/3/2020,1,9882,282,3786,727,0,10,14687
6/3/2020,2,9871,132,3610,538,0,10,14161
6/3/2020,3,9732,148,3614,585,0,11,14090
6/3/2020,4,9593,261,3555,325,0,14,13748
6/3/2020,5,9592,364,3630,224,1,20,13831
6/3/2020,6,9593,508,4010,309,5,27,14452
6/3/2020,7,9586,532,4380,641,21,33,15193
6/3/2020,8,9813,562,4439,853,48,34,15749
6/3/2020,9,9923,767,4420,979,100,34,16223
6/3/2020,10,9977,998,4268,1094,167,33,16537
6/3/2020,11,10009,1302,4371,884,197,33,16796
6/3/2020,12,10025,1618,4294,1241,223,33,17434
6/3/2020,13,9888,1899,4593,1192,225,33,17830
6/3/2020,14,9890,2040,4456,970,251,33,17640
6/3/2020,15,10027,2163,4546,779,251,34,17800
6/3/2020,16,10024,2333,4702,767,279,34,18139
6/3/2020,17,10032,2340,4845,986,138,34,18375
6/3/2020,18,10033,2348,4943,824,92,34,18274
6/3/2020,19,10035,2346,4889,617,35,27,17949
6/3/2020,20,10038,2351,4810,392,8,27,17626
6/3/2020,21,10046,2345,4692,480,0,27,17590
6/3/2020,22,10053,2033,4752,455,0,27,17320
6/3/2020,23,10055,1604,4293,381,0,22,16355
6/3/2020,24,10060,640,4281,386,0,7,15374
6/4/2020,1,10077,290,4140,360,0,5,14872
6/4/2020,2,10108,133,3784,541,0,6,14572
6/4/2020,3,10108,135,3450,587,0,5,14285
6/4/2020,4,10133,139,3487,627,0,4,14390
6/4/2020,5,10158,322,3459,454,3,14,14410
6/4/2020,6,10151,698,3693,356,11,23,14932
6/4/2020,7,10145,1052,4131,147,27,27,15529
6/4/2020,8,10143,1189,4678,200,114,28,16352
6/4/2020,9,10146,1352,4929,208,278,28,16941
6/4/2020,10,10144,1706,4705,381,340,27,17303
6/4/2020,11,10137,2098,4571,413,359,28,17606
6/4/2020,12,10141,2465,4322,455,402,27,17812
6/4/2020,13,10144,2780,4261,285,368,27,17865
6/4/2020,14,10128,2880,4393,497,394,27,18319
6/4/2020,15,10090,2988,4430,236,247,27,18018
6/4/2020,16,10086,2992,4608,186,118,27,18017
6/4/2020,17,10087,2993,4791,464,170,24,18529
6/4/2020,18,10087,2990,4823,435,94,14,18443
6/4/2020,19,10075,2997,4789,412,40,14,18327
6/4/2020,20,10069,2673,4652,250,7,14,17665
6/4/2020,21,10077,2375,4841,565,0,17,17875
6/4/2020,22,10083,2331,4599,498,0,27,17538
6/4/2020,23,10080,2111,4138,469,0,23,16821
6/4/2020,24,10090,1182,4141,424,0,9,15846
6/5/2020,1,10091,431,3729,910,0,5,15166
6/5/2020,2,10098,131,3694,808,0,5,14736
6/5/2020,3,10103,130,3747,696,0,5,14681
6/5/2020,4,10106,185,3846,539,0,7,14683
6/5/2020,5,10106,349,3958,292,1,17,14723
6/5/2020,6,10106,734,4260,223,9,23,15355
6/5/2020,7,10105,1176,4621,157,59,27,16145
6/5/2020,8,10102,1330,5139,141,160,27,16899
6/5/2020,9,10095,1663,5302,115,240,27,17442
6/5/2020,10,10093,2189,5124,117,302,27,17852
6/5/2020,11,10096,2497,5355,170,357,27,18502
6/5/2020,12,10090,2883,5161,307,402,27,18870
6/5/2020,13,10079,3018,5075,484,398,27,19081
6/5/2020,14,10067,2961,4693,489,387,31,18628
6/5/2020,15,10062,2955,4838,270,354,31,18510
6/5/2020,16,10074,2815,5052,627,244,29,18841
6/5/2020,17,10066,2790,5281,601,164,30,18932
6/5/2020,18,10077,2669,5209,657,84,29,18725
6/5/2020,19,10082,2310,4974,771,28,28,18193
6/5/2020,20,10085,2045,5408,632,4,27,18201
6/5/2020,21,10086,2006,5697,656,0,27,18472
6/5/2020,22,10096,1699,5111,861,0,27,17794
6/5/2020,23,10102,461,4749,1157,0,16,16485
6/5/2020,24,10110,108,4465,1297,0,2,15982
6/6/2020,1,10110,106,3732,1109,0,0,15057
6/6/2020,2,10113,104,3271,1401,0,0,14889
6/6/2020,3,10118,105,3322,1109,0,0,14654
6/6/2020,4,10112,106,3264,867,0,0,14349
6/6/2020,5,10103,106,3312,580,2,0,14103
6/6/2020,6,10108,105,3497,461,15,0,14186
6/6/2020,7,10108,115,4096,415,69,0,14803
6/6/2020,8,10105,128,4744,279,179,13,15448
6/6/2020,9,10100,112,4948,210,305,39,15714
6/6/2020,10,10105,123,5069,269,379,59,16004
6/6/2020,11,10104,203,5146,399,366,121,16339
6/6/2020,12,10093,261,4968,510,317,79,16228
6/6/2020,13,10099,316,4915,962,260,55,16607
6/6/2020,14,10104,493,4527,1032,255,55,16466
6/6/2020,15,10107,755,4476,1152,207,55,16752
6/6/2020,16,10107,842,4445,1376,278,55,17103
6/6/2020,17,10109,842,4755,1982,163,55,17906
6/6/2020,18,10109,842,4929,1933,97,55,17965
6/6/2020,19,10112,844,5006,1792,36,55,17845
6/6/2020,20,10111,849,4824,1480,8,53,17325
6/6/2020,21,10113,729,4852,836,0,54,16584
6/6/2020,22,10110,411,4488,1093,0,56,16158
6/6/2020,23,10114,197,4397,782,0,55,15545
6/6/2020,24,10033,105,3818,782,0,12,14750
6/7/2020,1,9544,104,3522,956,0,0,14126
6/7/2020,2,9375,105,3382,898,0,0,13760
6/7/2020,3,9265,107,3428,690,0,0,13490
6/7/2020,4,9201,107,3480,523,0,0,13311
6/7/2020,5,8978,106,3424,625,2,0,13135
6/7/2020,6,8982,108,3520,648,12,0,13270
6/7/2020,7,9053,117,3909,431,67,0,13577
6/7/2020,8,9340,142,4547,151,186,0,14366
6/7/2020,9,9641,130,4393,35,275,0,14474
6/7/2020,10,9820,126,4131,193,373,0,14643
6/7/2020,11,9818,110,4375,403,380,0,15086
6/7/2020,12,9813,129,4394,657,337,0,15330
6/7/2020,13,9901,109,4099,781,350,8,15248
6/7/2020,14,9980,109,4073,592,376,15,15145
6/7/2020,15,10122,110,4181,693,373,62,15541
6/7/2020,16,10114,111,4360,916,317,120,15938
6/7/2020,17,10120,231,5419,752,231,139,16892
6/7/2020,18,10122,532,5846,568,126,184,17378
6/7/2020,19,10121,620,5425,410,28,115,16719
6/7/2020,20,10113,474,5245,385,5,54,16276
6/7/2020,21,10116,335,5195,336,0,51,16033
6/7/2020,22,10120,340,5032,317,0,52,15861
6/7/2020,23,10115,343,4654,262,0,60,15434
6/7/2020,24,10047,334,4024,182,0,55,14642
6/8/2020,1,9755,194,3774,434,0,56,14213
6/8/2020,2,9533,103,3626,590,0,19,13871
6/8/2020,3,9532,103,3412,611,0,4,13662
6/8/2020,4,9534,107,3435,611,1,5,13693
6/8/2020,5,9539,129,3567,570,2,12,13819
6/8/2020,6,9682,251,3719,489,11,24,14176
6/8/2020,7,9985,372,4287,324,71,46,15085
6/8/2020,8,10128,527,4422,200,182,72,15531
6/8/2020,9,10130,608,4589,158,285,95,15865
6/8/2020,10,10131,714,4728,188,360,116,16237
6/8/2020,11,10117,837,4779,203,387,90,16413
6/8/2020,12,10114,1009,4605,225,390,87,16430
6/8/2020,13,10110,1226,4587,239,401,84,16647
6/8/2020,14,10111,1490,4520,255,394,75,16845
6/8/2020,15,10110,1957,4701,120,364,82,17334
6/8/2020,16,10111,2297,5016,184,319,126,18053
6/8/2020,17,10108,2483,5483,228,227,140,18669
6/8/2020,18,10111,2469,5479,224,97,114,18494
6/8/2020,19,10115,2403,5402,253,24,85,18282
6/8/2020,20,10120,2365,5141,274,5,145,18050
6/8/2020,21,10122,2097,4943,577,0,109,17848
6/8/2020,22,10129,1461,4654,845,0,92,17181
6/8/2020,23,10129,694,4214,1009,0,76,16122
6/8/2020,24,10124,504,3834,1076,0,114,15652
6/9/2020,1,10133,253,3602,979,0,140,15107
6/9/2020,2,10129,161,3598,516,0,85,14489
6/9/2020,3,10126,164,3604,380,0,116,14390
6/9/2020,4,10124,168,3627,339,0,118,14376
6/9/2020,5,10123,301,3576,373,2,110,14485
6/9/2020,6,10124,544,3718,566,24,125,15101
6/9/2020,7,10118,876,4304,338,64,95,15795
6/9/2020,8,10118,1293,5032,325,147,120,17035
6/9/2020,9,10115,1746,5187,166,216,90,17520
6/9/2020,10,10108,1781,5260,155,309,75,17688
6/9/2020,11,10101,1898,5370,173,339,75,17956
6/9/2020,12,10095,1960,5351,160,370,75,18011
6/9/2020,13,10090,1999,5300,206,368,76,18039
6/9/2020,14,10085,2432,5356,335,375,83,18666
6/9/2020,15,10084,2761,5292,530,337,80,19084
6/9/2020,16,10084,2746,5456,768,298,78,19430
6/9/2020,17,10093,2943,5494,1019,237,79,19865
6/9/2020,18,10103,3051,5547,1351,105,79,20236
6/9/2020,19,10105,2664,5320,1692,38,84,19903
6/9/2020,20,10116,2514,4988,1666,16,82,19382
6/9/2020,21,10123,2392,4594,2197,10,84,19400
6/9/2020,22,10128,1175,4647,2823,10,74,18857
6/9/2020,23,10128,316,4314,2843,10,63,17674
6/9/2020,24,10135,140,3914,2871,10,54,17124
6/10/2020,1,10138,140,3568,2607,10,21,16484
6/10/2020,2,10141,139,3461,2151,10,5,15907
6/10/2020,3,10133,242,3461,1570,10,5,15421
6/10/2020,4,10132,359,3531,1165,10,14,15211
6/10/2020,5,10128,499,3489,1182,12,21,15331
6/10/2020,6,10126,600,3546,1541,21,39,15873
6/10/2020,7,10120,859,3725,2214,60,44,17022
6/10/2020,8,10114,1206,3996,2592,88,45,18041
6/10/2020,9,10108,1399,4073,3204,115,43,18942
6/10/2020,10,10100,1673,4381,3200,187,44,19585
6/10/2020,11,10092,1907,4487,2777,270,43,19576
6/10/2020,12,10081,2149,4569,3108,327,43,20277
6/10/2020,13,10066,2541,4497,3664,331,43,21142
6/10/2020,14,10066,2843,4341,3655,334,34,21273
6/10/2020,15,10067,2785,4559,3067,312,34,20824
6/10/2020,16,10060,2784,4521,2774,245,37,20421
6/10/2020,17,10054,2652,4720,3045,157,58,20686
6/10/2020,18,10057,2611,4956,2981,68,86,20759
6/10/2020,19,10058,2720,5279,2296,27,86,20466
6/10/2020,20,10051,2497,5265,2172,6,83,20074
6/10/2020,21,10050,2286,5088,2557,2,80,20063
6/10/2020,22,10044,1918,4208,2459,2,87,18718
6/10/2020,23,10033,807,4190,2759,2,33,17824
6/10/2020,24,10037,284,3697,3311,2,12,17343
6/11/2020,1,10055,135,3639,2312,2,10,16153
6/11/2020,2,10056,132,3488,1897,2,10,15585
6/11/2020,3,10059,132,3414,1596,2,13,15216
6/11/2020,4,10057,130,3349,1381,2,15,14934
6/11/2020,5,10048,129,3423,1296,3,21,14920
6/11/2020,6,10047,128,3600,1670,9,24,15478
6/11/2020,7,10044,235,3657,1843,72,33,15884
6/11/2020,8,10032,356,3773,2380,128,60,16729
6/11/2020,9,10031,545,3961,2132,209,83,16961
6/11/2020,10,10032,594,4042,2514,259,84,17525
6/11/2020,11,10036,675,4400,2185,310,90,17696
6/11/2020,12,10051,776,4494,1962,342,91,17716
6/11/2020,13,10061,957,4193,2317,362,93,17983
6/11/2020,14,10062,1207,4126,2567,361,94,18417
6/11/2020,15,10074,1361,4248,1695,370,91,17839
6/11/2020,16,10089,1522,4518,2281,329,92,18831
6/11/2020,17,10102,1523,4789,2797,167,92,19470
6/11/2020,18,10113,1511,4786,2827,98,89,19424
6/11/2020,19,10109,1512,4657,2713,39,92,19122
6/11/2020,20,10107,1362,4591,2306,9,92,18467
6/11/2020,21,10113,1058,4409,2280,1,92,17953
6/11/2020,22,10121,495,4133,2521,0,91,17361
6/11/2020,23,10126,246,4115,1569,0,77,16133
6/11/2020,24,10126,156,3864,1194,0,46,15386
6/12/2020,1,10069,131,3749,832,0,9,14790
6/12/2020,2,10017,128,3506,827,0,9,14487
6/12/2020,3,9814,128,3594,691,0,9,14236
6/12/2020,4,9812,185,3614,571,0,14,14196
6/12/2020,5,10034,285,3555,737,1,19,14631
6/12/2020,6,10014,351,3715,735,11,29,14855
6/12/2020,7,10095,358,4221,984,46,31,15735
6/12/2020,8,10090,415,4080,1320,108,30,16043
6/12/2020,9,10091,481,4124,1248,178,30,16152
6/12/2020,10,10082,502,4155,966,216,30,15951
6/12/2020,11,10075,502,4019,1109,330,31,16066
6/12/2020,12,10130,423,4136,1057,366,31,16143
6/12/2020,13,10160,370,4028,1421,363,32,16374
6/12/2020,14,10235,447,4315,1293,353,32,16675
6/12/2020,15,10342,498,4450,1028,347,32,16697
6/12/2020,16,10347,495,4593,1068,279,32,16814
6/12/2020,17,10301,416,4744,1089,214,32,16796
6/12/2020,18,10275,387,4901,1193,117,32,16905
6/12/2020,19,10272,408,4697,1105,34,32,16548
6/12/2020,20,10270,432,4769,1008,7,32,16518
6/12/2020,21,10269,427,4763,896,0,32,16387
6/12/2020,22,10279,294,4801,870,0,32,16276
6/12/2020,23,10268,150,4049,801,0,18,15286
6/12/2020,24,10185,147,3790,560,0,0,14682
6/13/2020,1,9890,124,3598,677,0,0,14289
6/13/2020,2,9603,120,3536,489,0,0,13748
6/13/2020,3,9248,120,3586,667,0,0,13621
6/13/2020,4,9164,118,3528,706,0,0,13516
6/13/2020,5,9322,119,3568,533,2,0,13544
6/13/2020,6,9336,112,3590,545,21,0,13604
6/13/2020,7,9554,111,3872,676,70,0,14283
6/13/2020,8,10222,112,3919,721,173,0,15147
6/13/2020,9,10489,112,3704,559,271,0,15135
6/13/2020,10,10664,112,3640,345,157,0,14918
6/13/2020,11,10667,108,3648,279,347,0,15049
6/13/2020,12,10672,110,3750,315,415,0,15262
6/13/2020,13,10626,198,3746,337,400,2,15309
6/13/2020,14,10616,263,3739,353,383,0,15354
6/13/2020,15,10641,333,3722,296,211,0,15203
6/13/2020,16,10674,334,3946,257,217,0,15428
6/13/2020,17,10678,338,4038,804,254,0,16112
6/13/2020,18,10678,336,4455,446,138,0,16053
6/13/2020,19,10680,335,4470,727,41,0,16253
6/13/2020,20,10673,335,4515,463,9,0,15995
6/13/2020,21,10660,200,4208,891,1,0,15960
6/13/2020,22,10666,110,4026,866,1,0,15669
6/13/2020,23,10700,111,3585,772,1,0,15169
6/13/2020,24,10746,111,3415,620,1,0,14893
6/14/2020,1,10758,110,3294,679,1,1,14843
6/14/2020,2,10626,109,3294,426,1,0,14456
6/14/2020,3,10244,108,3300,573,1,0,14226
6/14/2020,4,10166,109,3336,642,2,0,14255
6/14/2020,5,10169,107,3284,643,3,0,14206
6/14/2020,6,9737,106,3265,593,15,0,13716
6/14/2020,7,9615,107,3286,507,73,0,13588
6/14/2020,8,9557,107,3412,813,201,0,14090
6/14/2020,9,9804,107,3603,727,324,0,14565
6/14/2020,10,10075,107,3778,678,400,0,15038
6/14/2020,11,10354,108,3731,918,412,0,15523
6/14/2020,12,10712,108,3718,680,389,0,15607
6/14/2020,13,10770,108,3807,526,380,0,15591
6/14/2020,14,10769,108,3811,538,379,0,15605
6/14/2020,15,10780,109,3821,664,390,0,15764
6/14/2020,16,10769,109,4057,832,345,0,16112
6/14/2020,17,10764,108,4136,1116,257,0,16381
6/14/2020,18,10770,108,4584,1118,133,0,16713
6/14/2020,19,10770,107,4607,864,42,0,16390
6/14/2020,20,10779,108,4594,712,11,0,16204
6/14/2020,21,10774,108,4558,975,1,0,16416
6/14/2020,22,10758,108,4155,898,1,0,15920
6/14/2020,23,10754,108,3779,911,1,0,15553
6/14/2020,24,10782,107,3615,1006,1,0,15511
6/15/2020,1,10781,108,3430,862,1,0,15182
6/15/2020,2,10777,108,3366,717,1,4,14973
6/15/2020,3,10777,108,3305,499,1,4,14694
6/15/2020,4,10773,111,3354,537,1,4,14780
6/15/2020,5,10506,141,3226,807,4,11,14695
6/15/2020,6,10484,229,3349,1286,16,20,15384
6/15/2020,7,10705,303,3975,1194,72,25,16274
6/15/2020,8,10774,361,4092,940,194,25,16386
6/15/2020,9,10788,469,4219,773,317,26,16592
6/15/2020,10,10802,561,4254,344,310,26,16297
6/15/2020,11,10824,678,4371,335,217,27,16452
6/15/2020,12,10800,987,4359,372,344,26,16888
6/15/2020,13,10796,1234,4302,363,301,26,17022
6/15/2020,14,10786,1268,4476,383,313,26,17252
6/15/2020,15,10771,1339,4418,351,179,26,17084
6/15/2020,16,10536,1343,4472,399,259,26,17035
6/15/2020,17,10538,1342,4715,894,254,27,17770
6/15/2020,18,10758,1344,4832,835,130,27,17926
6/15/2020,19,10755,1344,5076,617,39,27,17858
6/15/2020,20,10777,1222,4805,605,7,27,17443
6/15/2020,21,10790,1006,4756,735,0,27,17314
6/15/2020,22,10813,521,4471,933,0,27,16765
6/15/2020,23,10836,170,4061,1052,0,15,16134
6/15/2020,24,10842,132,3471,1086,0,8,15539
6/16/2020,1,10849,137,3327,818,0,6,15137
6/16/2020,2,10845,150,3162,1274,0,6,15437
6/16/2020,3,10852,161,3187,1154,0,6,15360
6/16/2020,4,10857,167,3331,933,0,6,15294
6/16/2020,5,10864,167,3169,813,1,10,15024
6/16/2020,6,10865,211,3331,630,13,14,15064
6/16/2020,7,10865,298,3690,451,70,25,15399
6/16/2020,8,10865,396,4001,320,185,26,15793
6/16/2020,9,10860,588,4013,264,287,26,16038
6/16/2020,10,10857,791,3995,192,383,26,16244
6/16/2020,11,10839,1128,4243,134,412,26,16782
6/16/2020,12,10819,1103,4322,197,429,26,16896
6/16/2020,13,10807,1175,4341,248,430,26,17027
6/16/2020,14,10783,1223,4416,285,426,26,17159
6/16/2020,15,10783,1223,4445,270,402,26,17149
6/16/2020,16,10780,1240,4762,381,338,27,17528
6/16/2020,17,10782,1200,5011,407,237,26,17663
6/16/2020,18,10785,1106,5022,438,126,26,17503
6/16/2020,19,10793,1120,5352,366,34,26,17691
6/16/2020,20,10818,1018,5403,307,9,27,17582
6/16/2020,21,10875,1049,5429,394,0,27,17774
6/16/2020,22,11001,926,5091,411,0,27,17456
6/16/2020,23,11007,773,4243,437,0,18,16478
6/16/2020,24,11017,277,3983,434,0,10,15721
6/17/2020,1,11046,135,3476,442,0,5,15104
6/17/2020,2,11102,136,3255,388,0,5,14886
6/17/2020,3,11066,135,3232,330,0,5,14768
6/17/2020,4,10840,135,3279,528,1,5,14788
6/17/2020,5,10847,138,3500,517,2,13,15017
6/17/2020,6,10982,188,3416,415,15,19,15035
6/17/2020,7,11128,218,3895,233,65,25,15564
6/17/2020,8,11111,328,4304,103,186,26,16058
6/17/2020,9,11110,594,4711,53,303,26,16797
6/17/2020,10,11107,808,4603,58,388,26,16990
6/17/2020,11,11111,1247,4458,46,420,26,17308
6/17/2020,12,11115,1398,4386,104,428,26,17457
6/17/2020,13,11120,1577,4336,156,432,27,17648
6/17/2020,14,11134,1749,4616,249,429,26,18203
6/17/2020,15,11136,1935,4644,368,412,26,18521
6/17/2020,16,11132,2037,4770,378,348,26,18691
6/17/2020,17,11127,2205,5533,361,235,27,19488
6/17/2020,18,11127,2208,5774,291,122,27,19549
6/17/2020,19,11127,2357,5737,181,33,27,19462
6/17/2020,20,11122,2704,5722,193,9,26,19776
6/17/2020,21,11114,2083,5646,336,0,27,19206
6/17/2020,22,11101,1689,5000,369,0,26,18185
6/17/2020,23,11096,780,5040,370,0,15,17301
6/17/2020,24,11097,307,4378,435,0,8,16225
6/18/2020,1,11113,142,3767,456,0,7,15485
6/18/2020,2,11120,136,3496,383,0,6,15141
6/18/2020,3,11116,138,3445,271,0,6,14976
6/18/2020,4,11140,137,3374,81,0,6,14738
6/18/2020,5,10913,140,3373,96,2,7,14531
6/18/2020,6,10866,195,3682,260,10,22,15035
6/18/2020,7,11019,330,4213,217,68,26,15873
6/18/2020,8,11083,509,5105,88,177,26,16988
6/18/2020,9,11133,827,5247,62,291,27,17587
6/18/2020,10,11211,1177,4958,109,372,26,17853
6/18/2020,11,11155,1335,5235,149,409,29,18312
6/18/2020,12,11144,1630,5601,184,416,29,19004
6/18/2020,13,11117,2294,5397,304,414,33,19559
6/18/2020,14,11107,2533,5002,450,409,42,19543
6/18/2020,15,11093,2404,4834,488,394,44,19257
6/18/2020,16,11082,2601,5125,546,333,30,19717
6/18/2020,17,11081,2698,5483,645,241,29,20177
6/18/2020,18,11078,2824,5434,606,126,30,20098
6/18/2020,19,11032,2948,5365,399,39,30,19813
6/18/2020,20,10682,2902,5265,241,9,30,19129
6/18/2020,21,10671,2842,5233,239,0,30,19015
6/18/2020,22,10677,2572,5076,337,0,40,18702
6/18/2020,23,10683,1798,4897,348,0,34,17760
6/18/2020,24,10693,1177,4647,385,0,25,16927
6/19/2020,1,10696,786,4145,462,0,25,16114
6/19/2020,2,10685,539,3787,474,0,24,15509
6/19/2020,3,10647,591,3618,256,0,23,15135
6/19/2020,4,10615,744,3794,335,1,23,15512
6/19/2020,5,10591,886,3480,153,2,27,15139
6/19/2020,6,10589,1079,3713,172,7,41,15601
6/19/2020,7,10581,1327,4156,171,51,45,16331
6/19/2020,8,10584,1406,4829,167,161,49,17196
6/19/2020,9,10573,1693,5217,119,291,50,17943
6/19/2020,10,10575,2113,5200,81,369,65,18403
6/19/2020,11,10587,2708,5103,76,354,66,18894
6/19/2020,12,10591,3127,5258,143,360,66,19545
6/19/2020,13,10604,3372,5302,268,367,66,19979
6/19/2020,14,10629,3321,5212,560,334,61,20117
6/19/2020,15,10652,3041,5294,534,316,62,19899
6/19/2020,16,10656,3544,5329,328,267,61,20185
6/19/2020,17,10650,3721,5458,219,196,60,20304
6/19/2020,18,10641,3482,6015,123,96,62,20419
6/19/2020,19,10630,3277,5921,77,23,62,19990
6/19/2020,20,10606,2808,5660,61,6,66,19207
6/19/2020,21,10574,2575,5579,65,0,65,18858
6/19/2020,22,10564,2202,5236,107,0,68,18177
6/19/2020,23,10552,1577,5059,191,0,53,17432
6/19/2020,24,10548,911,5008,206,0,42,16715
6/20/2020,1,10572,497,4539,266,0,42,15916
6/20/2020,2,10581,439,4339,252,0,42,15653
6/20/2020,3,10600,422,4028,172,0,43,15265
6/20/2020,4,10620,398,3774,103,0,33,14928
6/20/2020,5,10638,371,3736,88,2,33,14868
6/20/2020,6,10651,416,3573,47,9,32,14728
6/20/2020,7,10667,662,3628,20,17,22,15016
6/20/2020,8,10659,939,4232,38,106,17,15991
6/20/2020,9,10657,1325,5068,41,258,16,17365
6/20/2020,10,10650,1995,5271,48,325,14,18303
6/20/2020,11,10646,2629,5135,56,361,21,18848
6/20/2020,12,10633,3009,5081,120,369,13,19225
6/20/2020,13,10605,2771,5132,189,368,12,19077
6/20/2020,14,10600,2933,5299,233,382,15,19462
6/20/2020,15,10590,2623,5283,198,385,15,19094
6/20/2020,16,10652,2745,5503,208,319,3,19430
6/20/2020,17,10785,2839,5757,208,238,2,19829
6/20/2020,18,10828,3020,5896,226,124,2,20096
6/20/2020,19,10795,2964,5721,263,37,3,19783
6/20/2020,20,10780,2755,5286,302,6,3,19132
6/20/2020,21,10214,2655,5343,447,0,3,18662
6/20/2020,22,10120,2540,5143,637,0,5,18445
6/20/2020,23,10195,1718,4808,883,0,6,17610
6/20/2020,24,10198,885,4625,1166,0,19,16893
6/21/2020,1,10214,550,4177,1432,0,17,16390
6/21/2020,2,10218,201,4011,1432,0,13,15875
6/21/2020,3,10218,126,3767,1380,0,18,15509
6/21/2020,4,10207,132,3400,1292,0,20,15051
6/21/2020,5,10193,229,3459,987,3,23,14894
6/21/2020,6,10180,487,3556,915,7,25,15170
6/21/2020,7,10176,701,3933,695,61,36,15602
6/21/2020,8,10160,924,4856,499,162,40,16641
6/21/2020,9,10148,1284,5324,482,264,40,17542
6/21/2020,10,10145,1644,5241,533,357,40,17960
6/21/2020,11,10155,2040,5112,496,386,39,18228
6/21/2020,12,10164,2610,5132,557,357,39,18859
6/21/2020,13,10172,3165,5104,693,365,39,19538
6/21/2020,14,10179,2777,5062,821,346,38,19223
6/21/2020,15,10144,2756,5144,668,328,40,19080
6/21/2020,16,10151,3130,5286,553,285,40,19445
6/21/2020,17,10159,3345,5296,657,205,40,19702
6/21/2020,18,10156,2944,5426,718,117,39,19400
6/21/2020,19,10157,2565,5244,556,40,38,18600
6/21/2020,20,10150,2594,5398,468,7,39,18656
6/21/2020,21,10088,2824,5377,395,0,40,18724
6/21/2020,22,10091,2813,5136,585,0,38,18663
6/21/2020,23,10079,2454,4845,515,0,41,17934
6/21/2020,24,10072,2031,4613,635,0,40,17391
6/22/2020,1,10050,1148,4379,726,0,46,16349
6/22/2020,2,10085,959,4198,542,0,50,15834
6/22/2020,3,10121,973,4182,471,0,49,15796
6/22/2020,4,10143,1060,4146,401,0,50,15800
6/22/2020,5,10148,1303,3862,336,1,49,15699
6/22/2020,6,10160,1755,3959,362,7,58,16301
6/22/2020,7,10158,2234,4206,222,51,67,16938
6/22/2020,8,10149,2712,4641,112,134,67,17815
6/22/2020,9,10139,3020,4937,84,235,68,18483
6/22/2020,10,10134,3668,4950,121,242,66,19181
6/22/2020,11,10131,4595,5146,107,269,66,20314
6/22/2020,12,10126,5173,5116,89,329,66,20899
6/22/2020,13,10105,5150,5278,110,325,66,21034
6/22/2020,14,10120,4479,5179,125,268,65,20236
6/22/2020,15,10142,4394,5362,233,268,65,20464
6/22/2020,16,9888,4717,5243,273,211,67,20399
6/22/2020,17,9900,4598,5257,277,203,67,20302
6/22/2020,18,9909,4423,5256,375,94,66,20123
6/22/2020,19,9903,4147,5451,303,46,68,19918
6/22/2020,20,9892,4073,5305,322,9,68,19669
6/22/2020,21,9891,3847,5477,449,0,67,19731
6/22/2020,22,9884,3441,5010,570,0,67,18972
6/22/2020,23,9890,2532,4860,747,0,61,18090
6/22/2020,24,10065,1558,4789,945,0,52,17409
6/23/2020,1,10108,930,4612,887,0,47,16584
6/23/2020,2,10125,772,4322,953,0,46,16218
6/23/2020,3,10133,829,3889,1038,0,47,15936
6/23/2020,4,10145,1047,3726,1026,0,47,15991
6/23/2020,5,10203,1260,3532,1031,1,55,16082
6/23/2020,6,10356,1447,3964,943,10,61,16781
6/23/2020,7,10458,1597,4106,1019,59,66,17305
6/23/2020,8,10443,1692,4525,917,119,67,17763
6/23/2020,9,10440,2164,5028,988,160,68,18848
6/23/2020,10,10453,2506,5045,1340,144,67,19555
6/23/2020,11,10453,2448,5107,1600,179,67,19854
6/23/2020,12,10461,2462,5186,1531,199,68,19907
6/23/2020,13,10419,2383,4713,1783,270,69,19637
6/23/2020,14,10453,2338,4639,2033,211,69,19743
6/23/2020,15,10454,2361,4731,2076,184,69,19875
6/23/2020,16,10448,2365,4966,2476,146,69,20470
6/23/2020,17,10446,2168,4529,2799,144,69,20155
6/23/2020,18,10444,2119,4534,2707,87,70,19961
6/23/2020,19,10413,2016,4188,2869,21,69,19576
6/23/2020,20,10364,1921,4237,3025,4,70,19621
6/23/2020,21,10351,1920,4088,2770,0,66,19195
6/23/2020,22,10369,1229,3858,2717,0,62,18235
6/23/2020,23,10354,589,3685,2309,0,63,17000
6/23/2020,24,10374,183,3354,2400,0,51,16362
6/24/2020,1,10462,137,3109,2273,0,48,16029
6/24/2020,2,10576,136,3162,2300,0,49,16223
6/24/2020,3,10565,135,3085,2122,0,48,15955
6/24/2020,4,10568,156,3108,1970,0,49,15851
6/24/2020,5,10533,179,3134,2159,1,57,16063
6/24/2020,6,10548,303,3103,2095,8,67,16124
6/24/2020,7,10557,502,3228,2046,39,70,16442
6/24/2020,8,10564,770,3410,2224,108,70,17146
6/24/2020,9,10575,856,3410,2296,172,70,17379
6/24/2020,10,10578,842,3439,2310,206,71,17446
6/24/2020,11,10582,910,3551,2271,218,71,17603
6/24/2020,12,10599,1004,3570,2223,233,72,17701
6/24/2020,13,10520,1109,3634,2164,231,71,17729
6/24/2020,14,10502,1292,3854,2108,228,70,18054
6/24/2020,15,10534,1428,3911,2112,245,70,18300
6/24/2020,16,10638,1458,4154,1296,253,71,17870
6/24/2020,17,10688,976,4159,1859,126,72,17880
6/24/2020,18,10699,1017,4595,1437,69,70,17887
6/24/2020,19,10728,1018,4551,1318,31,70,17716
6/24/2020,20,10734,1022,4533,1115,4,69,17477
6/24/2020,21,10730,1016,4443,1032,0,64,17285
6/24/2020,22,10733,556,4424,1125,0,61,16899
6/24/2020,23,10735,225,3914,1221,0,59,16154
6/24/2020,24,10738,120,3534,1127,0,55,15574
6/25/2020,1,10738,127,3188,836,0,55,14944
6/25/2020,2,10755,130,3158,777,0,56,14876
6/25/2020,3,10756,129,3100,770,0,54,14809
6/25/2020,4,10765,129,3134,696,0,54,14778
6/25/2020,5,10771,142,3019,485,0,55,14472
6/25/2020,6,10776,187,3312,495,6,66,14842
6/25/2020,7,10777,274,3807,423,45,71,15397
6/25/2020,8,10773,302,4333,352,151,70,15981
6/25/2020,9,10777,623,4597,322,242,70,16631
6/25/2020,10,10799,1054,4453,522,309,71,17208
6/25/2020,11,10807,1436,3898,794,325,65,17325
6/25/2020,12,10799,1608,3883,881,317,42,17530
6/25/2020,13,10657,1677,4146,1076,351,43,17950
6/25/2020,14,10047,2072,4445,1241,344,44,18193
6/25/2020,15,10052,1983,4392,1269,358,42,18096
6/25/2020,16,10059,2149,4404,687,278,35,17612
6/25/2020,17,10055,2120,4488,542,111,36,17352
6/25/2020,18,10058,2121,4550,534,69,37,17369
6/25/2020,19,10057,2027,4995,662,37,27,17805
6/25/2020,20,10065,1798,5143,641,11,26,17684
6/25/2020,21,10072,1780,5181,738,0,26,17797
6/25/2020,22,10088,1599,5014,847,0,26,17574
6/25/2020,23,10086,976,4527,988,0,17,16594
6/25/2020,24,10087,607,4052,950,0,12,15708
6/26/2020,1,10086,280,3820,1070,0,10,15266
6/26/2020,2,10080,139,3378,1259,0,9,14865
6/26/2020,3,10086,145,3241,1204,0,9,14685
6/26/2020,4,10244,218,3187,1036,0,8,14693
6/26/2020,5,10378,469,3303,912,2,10,15074
6/26/2020,6,10507,732,3537,758,15,18,15567
6/26/2020,7,10506,952,4032,639,62,25,16216
6/26/2020,8,10500,1041,4727,461,174,26,16929
6/26/2020,9,10493,1243,5102,459,292,26,17615
6/26/2020,10,10506,1511,5127,570,368,26,18108
6/26/2020,11,10619,1885,4998,716,390,26,18634
6/26/2020,12,10713,2124,4963,872,355,26,19053
6/26/2020,13,10710,2286,4862,1137,360,26,19381
6/26/2020,14,10707,2270,4777,1650,313,26,19743
6/26/2020,15,10720,2338,4914,1701,328,26,20027
6/26/2020,16,10718,2451,4629,1735,314,26,19873
6/26/2020,17,10720,2425,4713,1892,242,26,20018
6/26/2020,18,10724,2495,5375,1580,121,26,20321
6/26/2020,19,10727,3124,5635,1314,38,27,20865
6/26/2020,20,10729,2676,5404,1368,9,26,20212
6/26/2020,21,10729,2111,4995,1484,0,26,19345
6/26/2020,22,10727,1569,4834,1501,0,26,18657
6/26/2020,23,10735,943,4212,1584,0,10,17484
6/26/2020,24,10771,735,3962,1262,0,0,16730
6/27/2020,1,10806,163,3542,1510,0,0,16021
6/27/2020,2,10819,133,3287,1477,0,0,15716
6/27/2020,3,10819,132,3261,1360,0,0,15572
6/27/2020,4,10815,131,3348,1146,0,0,15440
6/27/2020,5,10796,206,3371,1098,0,0,15471
6/27/2020,6,10767,372,3174,917,4,0,15234
6/27/2020,7,10771,672,3615,774,26,0,15858
6/27/2020,8,10773,899,3895,688,93,0,16348
6/27/2020,9,10773,1037,4360,723,154,0,17047
6/27/2020,10,10770,1163,5121,726,154,0,17934
6/27/2020,11,10767,1408,5230,885,189,0,18479
6/27/2020,12,10820,1491,4964,1274,250,2,18801
6/27/2020,13,10917,1735,4341,1584,212,0,18789
6/27/2020,14,11010,1803,4359,1392,249,0,18813
6/27/2020,15,11061,1972,4712,1627,280,0,19652
6/27/2020,16,11052,2113,5043,1584,275,0,20067
6/27/2020,17,11009,2116,5293,1616,214,0,20248
6/27/2020,18,11015,2108,5407,1490,100,0,20120
6/27/2020,19,11023,2069,5626,1072,34,0,19824
6/27/2020,20,11029,2150,5389,966,19,0,19553
6/27/2020,21,11048,1721,5232,1140,0,0,19141
6/27/2020,22,11044,1348,4837,1201,0,0,18430
6/27/2020,23,11049,709,4288,1181,0,3,17230
6/27/2020,24,11046,220,4183,1050,0,3,16502
6/28/2020,1,11073,133,3933,748,0,0,15887
6/28/2020,2,11231,133,3546,591,0,0,15501
6/28/2020,3,11241,134,3169,562,0,0,15106
6/28/2020,4,11244,142,3087,338,0,0,14811
6/28/2020,5,11093,218,3155,482,1,0,14949
6/28/2020,6,11150,466,3279,401,7,0,15303
6/28/2020,7,11153,667,3600,211,52,0,15683
6/28/2020,8,11142,742,3827,115,140,0,15966
6/28/2020,9,11140,757,4390,105,247,0,16639
6/28/2020,10,11221,836,5088,86,339,0,17570
6/28/2020,11,11427,1068,5105,104,364,0,18068
6/28/2020,12,11422,1386,5255,172,332,1,18568
6/28/2020,13,11415,1552,5196,299,351,1,18814
6/28/2020,14,11363,1775,5167,434,365,0,19104
6/28/2020,15,11403,1836,4740,491,350,0,18820
6/28/2020,16,11411,1983,5167,549,324,0,19434
6/28/2020,17,11422,2104,5216,573,244,0,19559
6/28/2020,18,11505,2233,5513,480,126,0,19857
6/28/2020,19,11349,2328,5571,362,39,0,19649
6/28/2020,20,10747,2490,5526,270,8,0,19041
6/28/2020,21,10746,1974,5331,295,0,0,18346
6/28/2020,22,10742,1867,5249,312,0,0,18170
6/28/2020,23,10754,1285,4919,409,0,0,17367
6/28/2020,24,10755,960,4641,427,0,0,16783
6/29/2020,1,10752,611,4315,336,0,0,16014
6/29/2020,2,10755,636,4002,272,0,5,15670
6/29/2020,3,10749,746,3735,124,0,8,15362
6/29/2020,4,10753,1008,3767,139,0,10,15677
6/29/2020,5,10852,1486,3684,82,1,10,16115
6/29/2020,6,10865,1888,3751,183,7,18,16712
6/29/2020,7,10862,2091,4249,152,56,26,17436
6/29/2020,8,10855,2205,4789,56,174,26,18105
6/29/2020,9,10853,2857,5184,25,290,26,19235
6/29/2020,10,10854,3060,5380,33,364,26,19717
6/29/2020,11,10855,3499,5365,59,389,26,20193
6/29/2020,12,10852,3676,5226,86,349,26,20215
6/29/2020,13,10845,3920,5256,189,348,26,20584
6/29/2020,14,10835,3926,5253,249,337,26,20626
6/29/2020,15,10800,4143,5259,329,335,26,20892
6/29/2020,16,10865,3993,5476,372,337,26,21069
6/29/2020,17,10921,4494,5735,343,197,26,21716
6/29/2020,18,10956,4603,5762,276,122,26,21745
6/29/2020,19,10956,4625,5466,204,38,26,21315
6/29/2020,20,10952,4378,5209,242,7,26,20814
6/29/2020,21,10951,3624,5038,311,1,26,19951
6/29/2020,22,10949,2856,5385,335,1,26,19552
6/29/2020,23,10968,2114,5182,372,1,13,18650
6/29/2020,24,11136,1667,4604,513,1,8,17929
6/30/2020,1,11245,848,4255,697,1,8,17054
6/30/2020,2,11257,524,3932,699,1,8,16421
6/30/2020,3,11259,589,3855,697,1,8,16409
6/30/2020,4,11261,691,3609,684,1,9,16255
6/30/2020,5,11255,697,3489,695,2,12,16150
6/30/2020,6,11250,938,3565,555,6,19,16333
6/30/2020,7,11034,1204,4264,374,54,26,16956
6/30/2020,8,11184,1497,5142,343,169,26,18361
6/30/2020,9,11228,1949,5279,291,251,26,19024
6/30/2020,10,11223,2545,5330,242,332,26,19698
6/30/2020,11,11169,2694,5372,314,345,26,19920
6/30/2020,12,11089,2871,5261,368,346,26,19961
6/30/2020,13,11096,3069,5123,509,408,26,20231
6/30/2020,14,11136,3079,5021,693,398,26,20353
6/30/2020,15,11313,2991,5189,627,338,26,20484
6/30/2020,16,11346,3595,5239,509,302,26,21017
6/30/2020,17,11503,3677,5563,466,210,26,21445
6/30/2020,18,11517,3533,5740,399,111,26,21326
6/30/2020,19,11522,3395,5812,362,38,26,21155
6/30/2020,20,11472,3213,5250,335,8,26,20304
6/30/2020,21,11469,2807,5191,369,0,26,19862
6/30/2020,22,11620,2011,5189,430,0,26,19276
6/30/2020,23,11660,1144,5121,507,0,11,18443
6/30/2020,24,11662,532,4953,470,0,0,17617
7/1/2020,1,11657,188,4413,411,0,0,16669
7/1/2020,2,11658,135,3978,314,0,0,16085
7/1/2020,3,11708,194,3600,217,0,0,15719
7/1/2020,4,11719,459,3589,151,0,0,15918
7/1/2020,5,11645,679,3674,150,1,0,16149
7/1/2020,6,11449,757,3718,172,6,0,16102
7/1/2020,7,11392,774,4131,131,60,0,16488
7/1/2020,8,11821,901,4827,31,153,0,17733
7/1/2020,9,11914,1239,5093,8,260,0,18514
7/1/2020,10,11956,1560,5041,37,315,0,18909
7/1/2020,11,12012,1755,5195,101,324,0,19387
7/1/2020,12,12007,2232,5239,150,308,0,19936
7/1/2020,13,11875,2501,5313,273,314,0,20276
7/1/2020,14,11871,2653,5509,452,359,0,20844
7/1/2020,15,11997,2537,5071,538,348,1,20492
7/1/2020,16,11995,2246,5363,540,289,3,20436
7/1/2020,17,12041,2222,5581,585,237,0,20666
7/1/2020,18,12050,2223,5789,580,131,0,20773
7/1/2020,19,12052,2026,5833,582,39,2,20534
7/1/2020,20,12055,1988,5743,522,8,5,20321
7/1/2020,21,12061,1914,5430,596,0,2,20003
7/1/2020,22,12059,1933,5231,608,0,2,19833
7/1/2020,23,12058,1205,5019,537,0,10,18829
7/1/2020,24,12048,411,4534,547,0,12,17552
7/2/2020,1,12069,236,4093,634,0,16,17048
7/2/2020,2,12076,238,3768,440,0,26,16548
7/2/2020,3,12081,257,3718,277,0,17,16350
7/2/2020,4,12094,344,3681,427,0,23,16569
7/2/2020,5,12114,575,3698,568,1,32,16988
7/2/2020,6,12124,884,3486,371,5,40,16910
7/2/2020,7,12122,1139,3754,497,55,50,17617
7/2/2020,8,12112,1438,4605,385,149,54,18743
7/2/2020,9,12101,2106,5227,224,248,57,19963
7/2/2020,10,12100,2518,5100,259,340,57,20374
7/2/2020,11,12094,2724,5026,282,388,54,20568
7/2/2020,12,12099,3634,5336,330,375,51,21825
7/2/2020,13,12135,3866,5339,407,332,56,22135
7/2/2020,14,12134,3708,5464,546,303,54,22209
7/2/2020,15,12134,3694,5529,713,255,53,22378
7/2/2020,16,12127,3798,5652,741,222,51,22591
7/2/2020,17,12116,3914,5844,687,125,49,22735
7/2/2020,18,12127,3738,5835,534,101,41,22376
7/2/2020,19,12137,3763,5718,427,35,39,22119
7/2/2020,20,12140,3733,5414,389,7,27,21710
7/2/2020,21,12148,3625,5315,445,0,26,21559
7/2/2020,22,12152,3060,4775,556,0,26,20569
7/2/2020,23,12166,2164,4599,610,0,16,19555
7/2/2020,24,12177,1404,4325,768,0,7,18681
7/3/2020,1,12176,588,4213,812,0,6,17795
7/3/2020,2,12166,389,3786,791,0,6,17138
7/3/2020,3,12166,390,3395,725,0,7,16683
7/3/2020,4,12161,400,3431,533,0,7,16532
7/3/2020,5,12159,484,3371,495,2,11,16522
7/3/2020,6,12157,891,3450,581,8,18,17105
7/3/2020,7,12151,1295,4197,379,45,25,18092
7/3/2020,8,12150,1730,4738,157,115,26,18916
7/3/2020,9,12149,2147,4874,125,181,26,19502
7/3/2020,10,12149,2749,5194,141,255,26,20514
7/3/2020,11,12147,3119,5306,335,286,26,21219
7/3/2020,12,12137,3270,5407,490,278,26,21608
7/3/2020,13,12143,3565,5519,498,275,27,22027
7/3/2020,14,12140,3583,5620,472,268,26,22109
7/3/2020,15,12145,3705,5811,448,230,26,22365
7/3/2020,16,12152,3632,5727,449,197,25,22182
7/3/2020,17,12155,4133,5875,481,159,25,22828
7/3/2020,18,12158,4026,5830,582,123,26,22745
7/3/2020,19,12154,4028,5762,574,38,29,22585
7/3/2020,20,12162,3289,5467,623,8,35,21584
7/3/2020,21,12170,2980,5052,658,0,36,20896
7/3/2020,22,12075,2610,4306,698,0,34,19723
7/3/2020,23,11689,1782,4486,897,0,26,18880
7/3/2020,24,11677,859,4715,899,0,17,18167
7/4/2020,1,11694,440,4777,738,0,21,17670
7/4/2020,2,11696,374,4282,686,0,19,17057
7/4/2020,3,11693,335,3888,770,0,17,16703
7/4/2020,4,11694,298,3365,747,0,6,16110
7/4/2020,5,11689,531,3308,342,1,0,15871
7/4/2020,6,11690,766,3349,289,5,0,16099
7/4/2020,7,11690,896,3634,477,53,0,16750
7/4/2020,8,11688,1052,4428,302,169,0,17639
7/4/2020,9,11690,1156,5010,155,292,0,18303
7/4/2020,10,11670,1683,5274,166,375,2,19170
7/4/2020,11,11651,2097,5279,174,413,1,19615
7/4/2020,12,11651,2246,5219,226,424,0,19766
7/4/2020,13,11662,2246,5283,220,404,0,19815
7/4/2020,14,11669,2255,5322,317,413,0,19976
7/4/2020,15,11678,2266,5648,457,405,0,20454
7/4/2020,16,11672,2234,5563,489,341,0,20299
7/4/2020,17,11656,2593,5770,433,240,0,20692
7/4/2020,18,11654,2853,5675,356,109,0,20647
7/4/2020,19,11658,2978,5686,315,41,0,20678
7/4/2020,20,11670,2932,5233,302,8,0,20145
7/4/2020,21,11649,2085,5101,449,1,0,19285
7/4/2020,22,11664,1749,5024,508,0,0,18945
7/4/2020,23,11682,1181,4639,531,0,0,18033
7/4/2020,24,11666,775,4072,487,0,0,17000
7/5/2020,1,11608,590,3773,308,0,0,16279
7/5/2020,2,11433,597,3777,369,0,0,16176
7/5/2020,3,11409,604,3505,133,0,0,15651
7/5/2020,4,11179,687,3288,94,0,0,15248
7/5/2020,5,11175,918,3413,59,1,0,15566
7/5/2020,6,11108,1145,3125,44,7,0,15429
7/5/2020,7,10874,1253,3305,23,38,0,15493
7/5/2020,8,10626,1423,3908,6,128,0,16091
7/5/2020,9,10547,1728,4399,5,259,0,16938
7/5/2020,10,10914,2071,4792,11,361,0,18149
7/5/2020,11,11325,2269,4557,25,374,0,18550
7/5/2020,12,11343,2561,4641,45,399,0,18989
7/5/2020,13,11344,2739,4915,94,411,0,19503
7/5/2020,14,11359,3123,4738,178,412,0,19810
7/5/2020,15,11366,3220,4806,211,375,0,19978
7/5/2020,16,11359,3277,5342,228,322,0,20528
7/5/2020,17,11380,3585,5739,200,239,0,21143
7/5/2020,18,11389,3835,5665,214,122,0,21225
7/5/2020,19,11396,3733,5641,124,39,0,20933
7/5/2020,20,11395,3424,5580,76,8,0,20483
7/5/2020,21,11392,3227,5336,105,0,0,20060
7/5/2020,22,11389,3020,5049,115,0,0,19573
7/5/2020,23,11391,2614,4744,217,0,0,18966
7/5/2020,24,11383,1943,4624,294,0,0,18244
7/6/2020,1,11345,1593,4467,337,0,3,17745
7/6/2020,2,11342,1462,3919,266,0,8,16997
7/6/2020,3,11348,1429,3641,234,0,9,16661
7/6/2020,4,11366,1508,3368,210,0,10,16462
7/6/2020,5,11377,1624,3385,136,2,15,16539
7/6/2020,6,11386,1854,3795,275,13,21,17344
7/6/2020,7,11391,2282,4472,227,66,27,18465
7/6/2020,8,11386,2931,4768,138,166,27,19416
7/6/2020,9,11385,3462,4868,70,280,39,20104
7/6/2020,10,11386,3819,5035,58,362,39,20699
7/6/2020,11,11380,4506,5021,68,403,37,21415
7/6/2020,12,11365,5089,5099,79,401,37,22070
7/6/2020,13,11368,5230,5195,126,411,33,22363
7/6/2020,14,11369,4920,5099,219,324,29,21960
7/6/2020,15,11363,5013,5121,213,359,27,22096
7/6/2020,16,11357,5127,5414,205,278,45,22426
7/6/2020,17,11470,5480,5489,193,200,45,22877
7/6/2020,18,11472,5521,5577,200,115,42,22927
7/6/2020,19,11462,5491,5377,195,38,43,22606
7/6/2020,20,11458,4780,5280,254,8,42,21822
7/6/2020,21,11449,3761,5114,371,0,34,20729
7/6/2020,22,11441,3178,4798,547,0,26,19990
7/6/2020,23,11432,2509,4482,648,0,12,19083
7/6/2020,24,11439,1989,4120,727,0,8,18283
7/7/2020,1,11449,1891,3830,807,0,8,17985
7/7/2020,2,11462,1785,3449,890,0,8,17594
7/7/2020,3,11464,1698,3122,867,0,8,17159
7/7/2020,4,11464,1775,3094,375,0,8,16716
7/7/2020,5,11466,1937,3115,223,2,10,16753
7/7/2020,6,11468,2180,3214,248,6,20,17136
7/7/2020,7,11309,2387,3752,441,44,27,17960
7/7/2020,8,11388,2833,4341,435,138,27,19162
7/7/2020,9,11415,3239,4383,348,229,27,19641
7/7/2020,10,11384,3280,4678,376,311,27,20056
7/7/2020,11,11375,3658,5091,376,389,29,20918
7/7/2020,12,11374,4711,5042,341,407,30,21905
7/7/2020,13,11389,5023,5127,345,388,41,22313
7/7/2020,14,11401,5233,5136,312,372,36,22490
7/7/2020,15,11410,5279,5223,315,287,27,22541
7/7/2020,16,11416,5388,5244,411,246,27,22732
7/7/2020,17,11413,5325,5460,747,170,27,23142
7/7/2020,18,11407,4852,5611,776,108,26,22780
7/7/2020,19,11398,5299,5513,779,33,26,23048
7/7/2020,20,11404,5259,5336,919,6,26,22950
7/7/2020,21,11405,4941,5390,850,0,26,22612
7/7/2020,22,11412,4522,5124,758,0,27,21843
7/7/2020,23,11416,3096,4711,1161,0,13,20397
7/7/2020,24,11414,2381,3962,1108,0,9,18874
7/8/2020,1,11407,2274,3621,993,0,9,18304
7/8/2020,2,11377,2268,3759,756,0,9,18169
7/8/2020,3,11349,2295,3993,566,0,15,18218
7/8/2020,4,11323,2397,4013,347,0,29,18109
7/8/2020,5,11323,2689,3638,217,1,37,17905
7/8/2020,6,11337,3002,3571,170,9,45,18134
7/8/2020,7,11355,3553,4248,113,43,62,19374
7/8/2020,8,11365,3893,4515,91,146,66,20076
7/8/2020,9,11378,4213,4796,79,258,66,20790
7/8/2020,10,11380,4412,4840,109,349,64,21154
7/8/2020,11,11382,4925,4937,144,383,66,21837
7/8/2020,12,11374,5461,5081,169,365,65,22515
7/8/2020,13,11228,5767,5006,291,355,66,22713
7/8/2020,14,11210,5840,5012,436,347,65,22910
7/8/2020,15,11199,5021,5018,543,309,65,22155
7/8/2020,16,11187,4649,5279,561,256,66,21998
7/8/2020,17,11180,5686,5387,357,152,65,22827
7/8/2020,18,11174,6292,5254,179,115,60,23074
7/8/2020,19,11176,6068,5205,123,30,63,22665
7/8/2020,20,11184,5896,5104,114,7,53,22358
7/8/2020,21,11188,5180,5049,204,0,48,21669
7/8/2020,22,11187,4395,4940,202,0,50,20774
7/8/2020,23,11188,3077,4538,211,0,49,19063
7/8/2020,24,11187,2361,4493,188,0,45,18274
7/9/2020,1,11199,2241,4286,159,0,43,17928
7/9/2020,2,11205,2229,4104,183,0,34,17755
7/9/2020,3,11211,2233,4042,114,0,31,17631
7/9/2020,4,11218,2331,3927,89,0,33,17598
7/9/2020,5,11220,2530,3649,155,1,33,17588
7/9/2020,6,11218,2824,3704,98,7,38,17889
7/9/2020,7,11205,3254,4074,113,41,41,18728
7/9/2020,8,11187,3783,4292,215,152,41,19670
7/9/2020,9,10457,4340,4760,248,266,34,20105
7/9/2020,10,10389,5276,5006,315,352,21,21359
7/9/2020,11,10377,5718,5016,316,398,14,21839
7/9/2020,12,10368,6259,5079,397,409,20,22532
7/9/2020,13,10355,6387,5176,457,399,14,22788
7/9/2020,14,10337,6448,5333,375,387,14,22894
7/9/2020,15,10339,6860,5411,351,342,17,23320
7/9/2020,16,10364,7060,5415,314,282,40,23475
7/9/2020,17,10375,6688,5753,389,217,33,23455
7/9/2020,18,10375,6736,5898,184,121,33,23347
7/9/2020,19,10385,6828,5514,195,37,19,22978
7/9/2020,20,10360,6165,5301,388,7,15,22236
7/9/2020,21,10356,5650,5228,549,0,13,21796
7/9/2020,22,10354,4810,5164,588,0,15,20931
7/9/2020,23,10334,3958,5079,677,0,14,20062
7/9/2020,24,10318,3169,4982,747,0,9,19225
7/10/2020,1,10317,2922,4712,1041,0,7,18999
7/10/2020,2,10333,2428,4469,1135,0,8,18373
7/10/2020,3,10338,2426,4474,914,0,11,18163
7/10/2020,4,10346,2655,4320,845,0,13,18179
7/10/2020,5,10356,2942,3685,867,1,23,17874
7/10/2020,6,10343,3306,3679,509,5,39,17881
7/10/2020,7,10311,3463,4108,579,41,49,18551
7/10/2020,8,10284,3688,4938,517,156,51,19634
7/10/2020,9,10271,4463,5069,497,255,52,20607
7/10/2020,10,10295,5322,5190,509,339,49,21704
7/10/2020,11,10331,6094,5355,567,394,47,22788
7/10/2020,12,10343,6662,5307,748,396,32,23488
7/10/2020,13,10345,6522,5412,619,374,32,23304
7/10/2020,14,10332,6287,5510,697,317,37,23180
7/10/2020,15,10316,6228,5623,954,286,27,23434
7/10/2020,16,10311,6109,5703,653,228,26,23030
7/10/2020,17,10295,6202,5601,690,160,26,22974
7/10/2020,18,10276,5321,5176,1034,79,27,21913
7/10/2020,19,10257,4867,5400,758,28,26,21336
7/10/2020,20,10253,4936,5334,543,6,26,21098
7/10/2020,21,10259,4977,5071,461,0,26,20794
7/10/2020,22,10267,4066,5209,329,0,27,19898
7/10/2020,23,10253,3612,5000,370,0,17,19252
7/10/2020,24,10250,2871,4646,586,0,11,18364
7/11/2020,1,10243,2095,4023,699,0,0,17060
7/11/2020,2,10237,1873,3877,818,0,0,16805
7/11/2020,3,10222,1686,3746,908,0,0,16562
7/11/2020,4,10218,1650,3679,1101,0,0,16648
7/11/2020,5,10217,1426,3475,1515,0,0,16633
7/11/2020,6,10223,1428,3349,1724,2,0,16726
7/11/2020,7,10231,1523,3415,1826,18,0,17013
7/11/2020,8,10236,1738,3497,1828,35,0,17334
7/11/2020,9,10230,1946,3984,1824,59,0,18043
7/11/2020,10,10227,2037,4372,1680,103,0,18419
7/11/2020,11,10228,2115,4712,1733,116,0,18904
7/11/2020,12,10226,2139,4774,1905,137,0,19181
7/11/2020,13,10246,2178,4835,2348,127,0,19734
7/11/2020,14,10329,2241,5078,2504,149,0,20301
7/11/2020,15,10472,2217,4542,2446,153,0,19830
7/11/2020,16,10575,2112,4470,2086,116,0,19359
7/11/2020,17,10582,2018,4437,1776,152,0,18965
7/11/2020,18,10593,2029,4569,1775,90,0,19056
7/11/2020,19,10650,2099,4701,1561,72,0,19083
7/11/2020,20,10711,2192,4830,1368,62,0,19163
7/11/2020,21,10775,2286,4965,1178,53,0,19257
7/11/2020,22,10806,2086,4890,1090,48,0,18920
7/11/2020,23,10857,1408,4736,1112,48,0,18161
7/11/2020,24,10929,1355,4524,822,48,0,17678
7/12/2020,1,11001,1358,4127,518,48,0,17052
7/12/2020,2,11050,1354,4075,683,48,0,17210
7/12/2020,3,11083,1353,3802,877,48,0,17163
7/12/2020,4,11101,1351,3793,870,48,0,17163
7/12/2020,5,11122,1334,3557,644,8,0,16665
7/12/2020,6,11129,1330,3515,528,7,0,16509
7/12/2020,7,11136,1296,3747,422,49,0,16650
7/12/2020,8,11130,1448,3715,268,143,0,16704
7/12/2020,9,11128,1651,4027,331,217,0,17354
7/12/2020,10,11116,1669,4500,356,277,0,17918
7/12/2020,11,11109,1896,4687,401,307,0,18400
7/12/2020,12,11112,2089,4945,461,316,0,18923
7/12/2020,13,11129,2196,5118,627,311,0,19381
7/12/2020,14,11137,2053,5059,870,257,0,19376
7/12/2020,15,11202,2023,4703,1072,194,1,19195
7/12/2020,16,11219,2022,4340,1043,177,0,18801
7/12/2020,17,11213,2020,4408,859,126,0,18626
7/12/2020,18,11216,1664,4749,950,90,0,18669
7/12/2020,19,11223,1420,4348,401,32,0,17424
7/12/2020,20,11249,1401,4456,472,5,0,17583
7/12/2020,21,11275,1401,4610,670,0,0,17956
7/12/2020,22,11296,1397,4316,733,0,0,17742
7/12/2020,23,11321,1236,3907,672,0,0,17136
7/12/2020,24,11334,1204,3484,481,0,0,16503
7/13/2020,1,11347,1203,3286,386,0,0,16222
7/13/2020,2,11357,1206,3261,346,0,1,16171
7/13/2020,3,11366,1204,3223,336,0,7,16136
7/13/2020,4,11371,1275,3187,392,0,7,16232
7/13/2020,5,11375,1374,3253,360,1,11,16374
7/13/2020,6,11444,1387,3350,265,5,16,16467
7/13/2020,7,11413,1433,3763,389,45,26,17069
7/13/2020,8,11394,1440,4488,427,120,26,17895
7/13/2020,9,11407,1568,4723,479,186,16,18379
7/13/2020,10,11417,1840,4746,589,240,0,18832
7/13/2020,11,11412,1986,4655,672,278,1,19004
7/13/2020,12,11412,2162,4864,634,265,8,19345
7/13/2020,13,11410,2586,4585,670,278,21,19550
7/13/2020,14,11403,2764,4649,748,279,26,19869
7/13/2020,15,11428,2778,4484,597,237,26,19550
7/13/2020,16,11456,2831,4528,541,178,27,19561
7/13/2020,17,11465,2779,4946,585,151,27,19953
7/13/2020,18,11480,2772,4760,492,98,26,19628
7/13/2020,19,11488,2738,4735,336,41,26,19364
7/13/2020,20,11486,2385,4859,219,10,26,18985
7/13/2020,21,11423,2294,4991,228,0,26,18962
7/13/2020,22,11122,2008,4810,236,0,26,18202
7/13/2020,23,11057,1472,4465,240,0,19,17253
7/13/2020,24,11042,1237,3904,173,0,12,16368
7/14/2020,1,11047,1210,3541,189,0,8,15995
7/14/2020,2,11034,1213,3208,197,0,7,15659
7/14/2020,3,11031,1219,3263,156,0,8,15677
7/14/2020,4,11009,1304,3330,166,0,7,15816
7/14/2020,5,10998,1526,3203,150,2,14,15893
7/14/2020,6,11010,1769,3313,136,5,23,16256
7/14/2020,7,11020,1900,3939,76,51,26,17012
7/14/2020,8,11030,2141,4009,39,144,26,17389
7/14/2020,9,11042,2394,4066,43,238,26,17809
7/14/2020,10,11060,2712,4118,78,307,26,18301
7/14/2020,11,11060,3029,4482,91,322,26,19010
7/14/2020,12,11063,3049,4597,109,302,26,19146
7/14/2020,13,11043,3088,4579,175,344,26,19255
7/14/2020,14,11162,3139,4834,231,315,26,19707
7/14/2020,15,11183,3241,4491,270,329,26,19540
7/14/2020,16,11183,3341,4945,239,265,26,19999
7/14/2020,17,11279,3724,5329,227,204,26,20789
7/14/2020,18,11320,4001,5197,237,97,26,20878
7/14/2020,19,11323,3586,5002,251,41,26,20229
7/14/2020,20,11348,2988,5025,235,10,26,19632
7/14/2020,21,11370,2895,4901,286,0,26,19478
7/14/2020,22,11391,2333,4563,438,0,26,18751
7/14/2020,23,11395,1832,3954,628,0,14,17823
7/14/2020,24,11434,1480,3632,666,0,9,17221
7/15/2020,1,11438,1427,3307,853,0,7,17032
7/15/2020,2,11447,1400,3084,800,0,8,16739
7/15/2020,3,11447,1421,3145,756,0,8,16777
7/15/2020,4,11457,1411,2981,755,0,6,16610
7/15/2020,5,11466,1402,3090,596,2,11,16567
7/15/2020,6,11452,1458,3136,565,2,22,16635
7/15/2020,7,11438,1595,3510,576,44,27,17190
7/15/2020,8,11425,1793,4411,493,148,27,18297
7/15/2020,9,11419,2247,4506,487,251,27,18937
7/15/2020,10,11423,2610,4573,531,329,27,19493
7/15/2020,11,11414,3074,4765,603,369,28,20253
7/15/2020,12,11424,2970,4902,602,372,27,20297
7/15/2020,13,11326,3020,4798,582,383,33,20142
7/15/2020,14,11313,3324,4660,614,400,65,20376
7/15/2020,15,11321,3254,4979,671,374,87,20686
7/15/2020,16,11301,3506,5166,747,320,85,21125
7/15/2020,17,11408,3890,5349,857,213,84,21801
7/15/2020,18,11589,3644,5321,875,118,80,21627
7/15/2020,19,11600,3453,5181,951,37,38,21260
7/15/2020,20,11587,3127,4633,1087,8,28,20470
7/15/2020,21,11576,2913,4389,1245,0,28,20151
7/15/2020,22,11559,2424,4577,1187,0,27,19774
7/15/2020,23,11582,1478,4711,1355,0,14,19140
7/15/2020,24,11603,1206,3972,1274,0,10,18065
7/16/2020,1,11611,1209,3388,1246,0,11,17465
7/16/2020,2,11666,1211,3378,1056,0,10,17321
7/16/2020,3,11782,1293,3062,1196,0,11,17344
7/16/2020,4,11765,1509,2927,1074,0,11,17286
7/16/2020,5,11713,1760,3006,1007,0,12,17498
7/16/2020,6,11693,1843,3181,758,3,21,17499
7/16/2020,7,11684,1947,3775,546,25,27,18004
7/16/2020,8,11683,2456,4157,347,80,30,18753
7/16/2020,9,11670,2629,4486,338,120,60,19303
7/16/2020,10,11681,2700,4164,651,164,84,19444
7/16/2020,11,11694,2730,4356,662,136,90,19668
7/16/2020,12,11720,2914,4480,419,120,127,19780
7/16/2020,13,11732,2964,4729,336,90,148,19999
7/16/2020,14,11736,2981,4604,411,140,191,20063
7/16/2020,15,11778,2957,4479,588,171,210,20183
7/16/2020,16,11780,2933,4785,563,166,174,20401
7/16/2020,17,11773,2923,5022,792,109,123,20742
7/16/2020,18,11771,2893,4971,859,61,30,20585
7/16/2020,19,11755,2556,4797,808,36,26,19978
7/16/2020,20,11751,2546,4748,731,4,26,19806
7/16/2020,21,11761,2241,4565,705,0,27,19299
7/16/2020,22,11780,1772,4121,717,0,26,18416
7/16/2020,23,11778,1675,3794,630,0,17,17894
7/16/2020,24,11776,1405,3557,598,0,8,17344
7/17/2020,1,11748,1283,3326,612,0,7,16976
7/17/2020,2,11719,1282,2863,508,0,7,16379
7/17/2020,3,11733,1329,2870,340,0,7,16279
7/17/2020,4,11737,1417,2889,522,0,7,16572
7/17/2020,5,11603,1652,3161,556,1,11,16984
7/17/2020,6,11134,2074,3056,257,5,19,16545
7/17/2020,7,11219,2250,3563,299,40,27,17398
7/17/2020,8,11580,2410,3947,241,140,27,18345
7/17/2020,9,11767,2675,4387,235,250,27,19341
7/17/2020,10,11779,2982,4651,242,344,27,20025
7/17/2020,11,11781,3116,4773,292,399,27,20388
7/17/2020,12,11760,3127,4805,435,414,27,20568
7/17/2020,13,11724,3195,4712,650,416,27,20724
7/17/2020,14,11708,3197,4964,812,395,27,21103
7/17/2020,15,11693,3393,5140,880,377,27,21510
7/17/2020,16,11677,3741,5113,950,330,26,21837
7/17/2020,17,11689,4100,5241,939,248,26,22243
7/17/2020,18,11701,4308,5303,880,130,26,22348
7/17/2020,19,11710,4294,5240,792,32,27,22095
7/17/2020,20,11723,3948,4991,786,7,27,21482
7/17/2020,21,11738,3299,5031,943,0,26,21037
7/17/2020,22,11752,2856,4507,979,0,26,20120
7/17/2020,23,11449,2085,4561,977,0,19,19091
7/17/2020,24,11425,1641,4336,998,0,13,18413
7/18/2020,1,11441,1487,3902,864,0,1,17695
7/18/2020,2,11442,1485,3406,801,0,0,17134
7/18/2020,3,11435,1490,2946,672,0,0,16543
7/18/2020,4,11445,1497,2963,580,0,9,16494
7/18/2020,5,11434,1556,3030,580,2,5,16607
7/18/2020,6,11413,1787,3175,358,6,1,16740
7/18/2020,7,11400,2021,3383,130,32,0,16966
7/18/2020,8,11395,2151,3926,181,158,1,17812
7/18/2020,9,11393,2216,4672,294,272,2,18849
7/18/2020,10,11395,2785,4811,689,359,23,20062
7/18/2020,11,11403,2912,4714,1102,399,52,20582
7/18/2020,12,11401,2934,4523,1609,395,52,20914
7/18/2020,13,11375,3025,4370,2035,387,52,21244
7/18/2020,14,11354,3015,4562,1887,379,53,21250
7/18/2020,15,11398,3048,5005,1604,363,55,21473
7/18/2020,16,11405,3655,5209,1455,294,83,22101
7/18/2020,17,11395,3513,5288,1556,199,147,22098
7/18/2020,18,11373,3569,5339,1530,109,149,22069
7/18/2020,19,11370,3663,5186,1381,40,149,21789
7/18/2020,20,11357,3210,4891,1531,7,88,21084
7/18/2020,21,11321,2971,4909,1876,0,59,21136
7/18/2020,22,11347,2813,4827,1899,0,53,20939
7/18/2020,23,11339,2228,4762,2037,0,11,20377
7/18/2020,24,11343,1085,4405,2030,0,3,18866
7/19/2020,1,11358,889,3635,2106,0,2,17990
7/19/2020,2,11371,889,3236,2091,0,0,17587
7/19/2020,3,11387,895,2982,1887,0,0,17151
7/19/2020,4,11411,969,2899,1938,0,0,17217
7/19/2020,5,11424,1236,2854,1682,1,0,17197
7/19/2020,6,11427,1447,3127,1034,3,0,17038
7/19/2020,7,11420,1544,3461,1651,37,0,18113
7/19/2020,8,11417,1581,3951,1666,136,0,18751
7/19/2020,9,11402,1719,3979,2568,227,3,19898
7/19/2020,10,11366,1868,4708,2901,273,21,21137
7/19/2020,11,11341,3110,5286,2064,278,65,22144
7/19/2020,12,11332,2901,4878,1707,184,117,21119
7/19/2020,13,11349,2645,4141,1389,83,95,19702
7/19/2020,14,11358,2614,4024,1118,124,56,19294
7/19/2020,15,11352,2475,4125,1193,146,56,19347
7/19/2020,16,11395,2451,4080,1400,112,57,19495
7/19/2020,17,11413,2453,4224,1707,71,57,19925
7/19/2020,18,11418,2292,4312,1492,50,57,19621
7/19/2020,19,11413,2044,4174,1316,22,58,19027
7/19/2020,20,11413,1832,4088,1453,5,58,18849
7/19/2020,21,11412,1721,4068,2160,0,58,19419
7/19/2020,22,11426,1519,3785,2483,0,56,19269
7/19/2020,23,11420,1289,3559,2521,0,14,18803
7/19/2020,24,11423,1261,3257,2304,0,0,18245
7/20/2020,1,11434,1102,3002,2143,0,0,17681
7/20/2020,2,11438,1065,2980,1849,0,0,17332
7/20/2020,3,11433,1080,2990,1567,0,6,17076
7/20/2020,4,11435,1163,3021,1734,0,7,17360
7/20/2020,5,11469,1378,2970,1387,0,11,17215
7/20/2020,6,11468,1738,3194,1197,3,18,17618
7/20/2020,7,11473,2161,3897,1115,44,29,18719
7/20/2020,8,11476,2714,4698,1008,150,49,20095
7/20/2020,9,11472,3225,4828,755,255,85,20620
7/20/2020,10,11477,3254,4861,703,346,119,20760
7/20/2020,11,11477,3278,4864,830,355,96,20900
7/20/2020,12,11475,3432,4912,1122,287,101,21329
7/20/2020,13,11476,3491,4418,1439,315,80,21219
7/20/2020,14,11482,3446,4489,1696,290,80,21483
7/20/2020,15,11478,3442,4657,1695,293,80,21645
7/20/2020,16,11463,3445,4577,1576,233,80,21374
7/20/2020,17,11490,3485,5078,1279,189,80,21601
7/20/2020,18,11509,3576,5227,1007,104,83,21506
7/20/2020,19,11520,3634,5124,709,32,81,21100
7/20/2020,20,11533,3335,4789,558,7,85,20307
7/20/2020,21,11538,3009,4869,382,0,80,19878
7/20/2020,22,11546,3008,4318,435,0,40,19347
7/20/2020,23,11555,2056,4249,527,0,18,18405
7/20/2020,24,11569,1320,3923,575,0,9,17396
7/21/2020,1,11574,1195,3314,503,0,8,16594
7/21/2020,2,11575,1201,3087,419,0,8,16290
7/21/2020,3,11570,1206,3266,367,0,8,16417
7/21/2020,4,11561,1273,3097,292,0,11,16234
7/21/2020,5,11564,1502,3058,201,1,11,16337
7/21/2020,6,11568,1826,3067,119,5,20,16605
7/21/2020,7,11562,2033,3523,96,35,29,17278
7/21/2020,8,11564,2317,3626,59,115,48,17729
7/21/2020,9,11565,2564,3752,33,195,74,18183
7/21/2020,10,11560,2863,3679,27,198,77,18404
7/21/2020,11,11538,3096,3736,2,172,76,18620
7/21/2020,12,11529,3198,3730,2,67,77,18603
7/21/2020,13,11528,3221,3986,21,267,76,19099
7/21/2020,14,11525,3127,4346,55,266,84,19403
7/21/2020,15,11533,3124,4465,54,245,76,19497
7/21/2020,16,11537,3274,4765,76,248,77,19977
7/21/2020,17,11556,3441,5298,74,168,77,20614
7/21/2020,18,11575,3570,5380,34,105,77,20741
7/21/2020,19,11574,3478,5092,61,38,85,20328
7/21/2020,20,11569,3049,4716,154,7,87,19582
7/21/2020,21,11562,2762,4865,186,0,90,19465
7/21/2020,22,11556,2541,4496,225,0,91,18909
7/21/2020,23,11541,2064,4250,225,0,40,18120
7/21/2020,24,11533,1379,4114,240,0,17,17283
7/22/2020,1,11547,1058,3848,229,0,16,16698
7/22/2020,2,11517,1021,3604,242,0,15,16399
7/22/2020,3,11522,1024,3400,244,0,15,16205
7/22/2020,4,11562,1101,3118,256,0,15,16052
7/22/2020,5,11584,1313,3088,235,1,17,16238
7/22/2020,6,11593,1577,3224,408,3,24,16829
7/22/2020,7,11592,1707,3661,622,14,33,17629
7/22/2020,8,11581,1907,3951,733,55,54,18281
7/22/2020,9,11569,2136,4191,880,104,84,18964
7/22/2020,10,11571,2366,4001,1113,146,85,19282
7/22/2020,11,11573,2451,4120,1177,180,84,19585
7/22/2020,12,11579,2549,4564,1266,182,98,20238
7/22/2020,13,11417,2528,4687,1575,169,89,20465
7/22/2020,14,11384,2499,4825,1675,170,83,20636
7/22/2020,15,11474,2456,4899,1499,160,84,20572
7/22/2020,16,11470,2467,4745,1490,175,83,20430
7/22/2020,17,11465,2479,5120,1264,126,84,20538
7/22/2020,18,11459,2802,5204,875,71,116,20527
7/22/2020,19,11488,3110,5091,668,29,196,20582
7/22/2020,20,11508,2849,5005,776,7,205,20350
7/22/2020,21,11523,2930,4775,666,0,208,20102
7/22/2020,22,11548,2824,4665,623,0,213,19873
7/22/2020,23,11588,2113,4422,478,0,186,18787
7/22/2020,24,11607,1346,4271,525,0,153,17902
7/23/2020,1,11598,1008,3582,480,0,75,16743
7/23/2020,2,11579,1006,3520,359,0,27,16491
7/23/2020,3,11563,1011,3201,308,0,17,16100
7/23/2020,4,11554,1084,3063,264,0,18,15983
7/23/2020,5,11544,1284,3243,198,2,20,16291
7/23/2020,6,11531,1571,3703,194,4,27,17030
7/23/2020,7,11517,1807,3951,171,26,33,17505
7/23/2020,8,11486,1954,4402,163,85,56,18146
7/23/2020,9,11469,2417,4483,166,144,76,18755
7/23/2020,10,11462,2826,4488,140,211,83,19210
7/23/2020,11,11482,2877,4277,148,262,78,19124
7/23/2020,12,11473,2932,4237,181,313,75,19211
7/23/2020,13,11490,2998,4173,436,349,78,19524
7/23/2020,14,11506,3049,4519,667,276,77,20094
7/23/2020,15,11504,3218,4695,742,265,76,20500
7/23/2020,16,11516,3330,4991,938,250,78,21103
7/23/2020,17,11532,3286,5002,1123,168,97,21208
7/23/2020,18,11542,3123,4968,1092,112,81,20918
7/23/2020,19,11536,3148,5196,844,32,79,20835
7/23/2020,20,11537,3003,5097,700,7,81,20425
7/23/2020,21,11534,2841,4993,577,0,82,20027
7/23/2020,22,11533,2151,4575,565,0,77,18901
7/23/2020,23,11535,1669,4168,701,0,70,18143
7/23/2020,24,11538,1116,3490,786,0,23,16953
7/24/2020,1,11543,967,3216,751,0,12,16489
7/24/2020,2,11539,967,3102,686,0,12,16306
7/24/2020,3,11531,971,3127,363,0,12,16004
7/24/2020,4,11540,1049,3184,579,0,12,16364
7/24/2020,5,11544,1303,3328,526,0,12,16713
7/24/2020,6,11559,1549,3327,511,3,18,16967
7/24/2020,7,11564,1708,3435,350,32,27,17116
7/24/2020,8,11557,1957,4023,187,120,32,17876
7/24/2020,9,11548,2420,4258,98,243,57,18624
7/24/2020,10,11520,2734,4404,75,333,77,19143
7/24/2020,11,11490,3031,4245,106,339,79,19290
7/24/2020,12,11462,3178,4381,188,353,78,19640
7/24/2020,13,11386,3305,4436,279,410,78,19894
7/24/2020,14,11356,3394,4808,294,405,80,20337
7/24/2020,15,11192,3493,4945,349,370,78,20427
7/24/2020,16,11335,3823,5006,343,337,107,20951
7/24/2020,17,11408,4366,5132,337,239,165,21647
7/24/2020,18,11416,4493,5156,286,122,167,21640
7/24/2020,19,11419,4196,5018,200,33,167,21033
7/24/2020,20,11430,3575,4948,191,6,174,20324
7/24/2020,21,11436,3178,4669,247,0,165,19695
7/24/2020,22,11448,3066,4105,239,0,131,18989
7/24/2020,23,11453,2459,3988,240,0,69,18209
7/24/2020,24,11457,1793,3980,227,0,61,17518
7/25/2020,1,11479,1248,3545,238,0,7,16517
7/25/2020,2,11472,1157,3397,227,0,0,16253
7/25/2020,3,11454,1085,3086,159,0,1,15785
7/25/2020,4,11188,974,3196,191,0,0,15549
7/25/2020,5,10993,1053,3255,183,1,2,15487
7/25/2020,6,10836,1249,3307,149,6,2,15549
7/25/2020,7,10914,1497,3530,176,48,7,16172
7/25/2020,8,11209,1649,3857,117,149,11,16992
7/25/2020,9,11433,1967,3972,87,243,27,17729
7/25/2020,10,11425,2103,4050,107,338,61,18084
7/25/2020,11,11408,2445,4137,150,377,119,18636
7/25/2020,12,11395,2656,4332,227,399,172,19181
7/25/2020,13,11408,2714,4599,370,403,157,19651
7/25/2020,14,11423,2940,4623,529,396,151,20062
7/25/2020,15,11442,2664,4811,505,369,135,19926
7/25/2020,16,11433,3164,4892,502,315,165,20471
7/25/2020,17,11406,3709,4917,571,213,195,21011
7/25/2020,18,11408,3650,5144,590,105,177,21074
7/25/2020,19,11417,3332,5020,578,41,128,20516
7/25/2020,20,11432,2681,4841,676,6,126,19762
7/25/2020,21,11436,2677,4704,756,0,141,19714
7/25/2020,22,11432,2261,4428,1020,0,140,19281
7/25/2020,23,11422,1556,4128,1214,0,63,18383
7/25/2020,24,11411,1175,3507,1415,0,8,17516
7/26/2020,1,11400,813,3147,1143,0,0,16503
7/26/2020,2,11396,769,3104,1047,0,0,16316
7/26/2020,3,11395,770,3064,1174,0,0,16403
7/26/2020,4,11399,769,3121,1287,0,0,16576
7/26/2020,5,11387,774,3130,1164,1,0,16456
7/26/2020,6,11372,788,3090,1086,4,2,16342
7/26/2020,7,11375,855,3167,1056,39,2,16494
7/26/2020,8,11384,1067,3368,1062,139,0,17020
7/26/2020,9,11401,1413,3946,1234,256,2,18252
7/26/2020,10,11393,2007,4285,1321,340,28,19374
7/26/2020,11,11369,2351,4328,1590,385,64,20087
7/26/2020,12,11356,2845,4698,1660,404,152,21115
7/26/2020,13,11357,3240,4818,1677,418,193,21703
7/26/2020,14,11280,3191,4846,1991,404,168,21880
7/26/2020,15,11340,2902,5007,2163,384,100,21896
7/26/2020,16,11359,3049,5174,2084,317,110,22093
7/26/2020,17,11368,3872,5343,2001,229,188,23001
7/26/2020,18,11396,4015,5431,1799,116,195,22952
7/26/2020,19,11414,3394,5377,1645,30,173,22033
7/26/2020,20,11413,3024,5188,1842,5,175,21647
7/26/2020,21,11409,2480,5101,2258,0,157,21405
7/26/2020,22,11423,2258,4700,2400,0,135,20916
7/26/2020,23,11456,1776,4279,2560,0,56,20127
7/26/2020,24,11490,1300,4078,2582,0,10,19460
7/27/2020,1,11521,1183,3852,2545,0,10,19111
7/27/2020,2,11537,1156,3228,2550,0,11,18482
7/27/2020,3,11547,1160,3132,2469,0,10,18318
7/27/2020,4,11573,1266,3176,2447,0,11,18473
7/27/2020,5,11593,1657,3209,2233,2,12,18706
7/27/2020,6,11610,2044,3369,1933,3,20,18979
7/27/2020,7,11614,2907,4015,1705,27,35,20303
7/27/2020,8,11640,3666,4001,1637,120,45,21109
7/27/2020,9,11699,4115,3915,1534,170,77,21510
7/27/2020,10,11702,4017,4264,1478,216,115,21792
7/27/2020,11,11731,3854,4711,1600,226,160,22282
7/27/2020,12,11767,4398,4666,1737,258,199,23025
7/27/2020,13,11776,4314,4821,1913,223,215,23262
7/27/2020,14,11783,4393,5079,1782,263,217,23517
7/27/2020,15,11766,5222,5075,1353,179,227,23822
7/27/2020,16,11779,5361,5021,1270,193,195,23819
7/27/2020,17,11796,4962,5180,1474,152,149,23713
7/27/2020,18,11874,4580,5297,1559,58,122,23490
7/27/2020,19,11912,4409,5154,1427,20,188,23110
7/27/2020,20,11922,4121,5023,1351,2,203,22622
7/27/2020,21,11931,4357,5148,1129,0,230,22795
7/27/2020,22,11925,3790,4631,947,0,168,21461
7/27/2020,23,11943,3021,4242,1020,0,81,20307
7/27/2020,24,11957,2337,3657,950,0,19,18920
7/28/2020,1,11962,1342,3790,961,0,10,18065
7/28/2020,2,11947,1020,3442,1099,0,9,17517
7/28/2020,3,11945,1024,3293,904,0,9,17175
7/28/2020,4,12008,1033,3243,731,0,10,17025
7/28/2020,5,12018,1136,3414,699,1,15,17283
7/28/2020,6,12011,1296,3609,711,2,18,17647
7/28/2020,7,12004,1711,3747,634,33,26,18155
7/28/2020,8,12003,2071,3969,402,138,45,18628
7/28/2020,9,12013,2244,4166,303,242,88,19056
7/28/2020,10,12033,2598,4513,337,321,121,19923
7/28/2020,11,12039,2832,4488,619,340,132,20450
7/28/2020,12,12027,2704,4360,1112,349,146,20698
7/28/2020,13,12019,2549,3929,1587,332,182,20598
7/28/2020,14,11990,2547,3927,1863,335,148,20810
7/28/2020,15,11986,2543,3793,1797,322,101,20542
7/28/2020,16,11998,2586,4107,1395,257,99,20442
7/28/2020,17,11987,2607,4386,1759,168,95,21002
7/28/2020,18,11994,2578,4710,1731,79,106,21198
7/28/2020,19,11989,2526,4815,1408,23,90,20851
7/28/2020,20,11990,2533,4821,1225,3,93,20665
7/28/2020,21,11992,2517,4708,1206,0,106,20529
7/28/2020,22,11999,1928,4778,1148,0,168,20021
7/28/2020,23,12015,1122,4154,1275,0,100,18666
7/28/2020,24,12025,799,3671,1097,0,21,17613
7/29/2020,1,12026,774,3253,904,0,10,16967
7/29/2020,2,12027,767,3232,503,0,10,16539
7/29/2020,3,12016,770,3210,875,0,10,16881
7/29/2020,4,12036,775,3613,642,0,10,17076
7/29/2020,5,12036,848,3298,571,1,26,16780
7/29/2020,6,12048,1108,2950,562,3,34,16705
7/29/2020,7,12025,1421,3163,541,25,45,17220
7/29/2020,8,12010,1773,3515,478,57,47,17880
7/29/2020,9,12006,1980,4298,461,115,49,18909
7/29/2020,10,12017,2541,4224,691,194,48,19715
7/29/2020,11,12022,2332,4355,829,308,48,19894
7/29/2020,12,12023,2806,4506,847,334,50,20566
7/29/2020,13,12000,3214,4358,969,305,53,20899
7/29/2020,14,11989,2812,4377,1214,370,86,20848
7/29/2020,15,11982,2616,4844,1212,314,100,21068
7/29/2020,16,11977,2710,4891,1158,301,109,21146
7/29/2020,17,11975,2999,5078,762,218,147,21179
7/29/2020,18,11979,3167,5107,574,88,206,21121
7/29/2020,19,11982,2749,4988,642,27,182,20570
7/29/2020,20,11979,2476,5077,305,5,140,19982
7/29/2020,21,11980,2652,5071,244,0,138,20085
7/29/2020,22,11988,2483,4377,240,0,114,19202
7/29/2020,23,11990,2236,4119,197,0,76,18618
7/29/2020,24,12005,1208,4037,205,0,65,17520
7/30/2020,1,12001,1020,3396,233,0,59,16709
7/30/2020,2,11868,967,2980,265,0,15,16095
7/30/2020,3,11688,799,3126,391,0,5,16009
7/30/2020,4,11687,872,2935,410,0,6,15910
7/30/2020,5,11695,1117,2952,360,2,10,16136
7/30/2020,6,11686,1344,3061,345,3,19,16458
7/30/2020,7,11686,1474,3328,315,42,26,16871
7/30/2020,8,11717,1613,3769,232,152,25,17508
7/30/2020,9,11976,1665,4042,171,255,26,18135
7/30/2020,10,11985,1867,4346,176,317,26,18717
7/30/2020,11,11996,2090,4282,201,339,26,18934
7/30/2020,12,12017,2217,4297,225,313,26,19095
7/30/2020,13,12028,2272,4337,308,298,26,19269
7/30/2020,14,12020,2485,4265,375,273,26,19444
7/30/2020,15,12019,2586,4465,410,258,28,19766
7/30/2020,16,12037,2649,4984,425,225,52,20372
7/30/2020,17,12026,2933,5019,486,202,80,20746
7/30/2020,18,12024,2911,4980,465,101,81,20562
7/30/2020,19,12013,2482,4970,444,26,80,20015
7/30/2020,20,12008,1910,4833,365,3,81,19200
7/30/2020,21,12008,2037,4668,389,0,104,19206
7/30/2020,22,11592,1869,4345,536,0,154,18496
7/30/2020,23,11180,1630,3964,842,0,126,17742
7/30/2020,24,11157,1240,3452,1121,0,80,17050
7/31/2020,1,11177,1027,3185,968,0,62,16419
7/31/2020,2,11199,1005,3044,755,0,22,16025
7/31/2020,3,11201,981,2947,846,0,7,15982
7/31/2020,4,11206,1061,2977,603,0,7,15854
7/31/2020,5,11210,1316,2947,485,1,9,15968
7/31/2020,6,11232,1564,3011,587,2,14,16410
7/31/2020,7,11243,1854,3166,507,38,26,16834
7/31/2020,8,11246,2185,3900,379,150,26,17886
7/31/2020,9,11230,2551,4205,237,278,27,18528
7/31/2020,10,11203,2813,4416,170,364,50,19016
7/31/2020,11,11184,3230,4607,199,361,79,19660
7/31/2020,12,11174,3418,4538,295,365,84,19874
7/31/2020,13,11164,3358,4573,434,342,82,19953
7/31/2020,14,11162,3045,4539,578,340,81,19745
7/31/2020,15,11157,2939,4512,712,328,82,19730
7/31/2020,16,11132,3014,4676,786,295,81,19984
7/31/2020,17,11127,3486,4693,770,214,91,20381
7/31/2020,18,11124,3492,4768,701,131,83,20299
7/31/2020,19,11147,3313,4698,591,29,81,19859
7/31/2020,20,11183,2868,4602,628,4,82,19367
7/31/2020,21,11210,2655,4617,672,0,82,19236
7/31/2020,22,11218,2544,4382,651,0,82,18877
7/31/2020,23,11229,2179,4021,679,0,32,18140
7/31/2020,24,11238,1403,3537,678,0,6,16862
8/1/2020,1,11241,516,3778,612,0,0,16147
8/1/2020,2,11249,372,3436,632,0,0,15689
8/1/2020,3,11218,373,2987,532,0,0,15110
8/1/2020,4,11184,376,3032,368,0,0,14960
8/1/2020,5,11168,453,3137,337,0,0,15095
8/1/2020,6,10951,723,3134,260,2,0,15070
8/1/2020,7,10770,942,3135,445,49,0,15341
8/1/2020,8,10755,1017,3533,339,156,0,15800
8/1/2020,9,10762,1269,4155,283,260,0,16729
8/1/2020,10,10753,1613,4009,420,354,0,17149
8/1/2020,11,10754,2052,4097,449,362,0,17714
8/1/2020,12,10743,2374,4299,444,353,0,18213
8/1/2020,13,10724,2179,4404,383,298,1,17989
8/1/2020,14,10723,2651,4566,334,240,8,18522
8/1/2020,15,10728,2685,4456,321,210,35,18435
8/1/2020,16,10722,2348,4641,333,172,54,18270
8/1/2020,17,10716,1899,4619,405,132,54,17825
8/1/2020,18,10731,1877,4880,338,65,54,17945
8/1/2020,19,10750,2003,4915,373,23,53,18117
8/1/2020,20,10758,2283,4746,430,1,53,18271
8/1/2020,21,10750,2605,4339,400,0,54,18148
8/1/2020,22,10728,2633,4210,378,0,55,18004
8/1/2020,23,10717,2466,3990,436,0,12,17621
8/1/2020,24,10716,1813,3905,531,0,0,16965
8/2/2020,1,10720,1142,3861,549,0,0,16272
8/2/2020,2,10709,308,3713,616,0,0,15346
8/2/2020,3,10705,187,3439,728,0,0,15059
8/2/2020,4,10695,189,3123,880,0,0,14887
8/2/2020,5,10677,191,2976,862,0,0,14706
8/2/2020,6,10700,264,2984,991,2,0,14941
8/2/2020,7,10709,431,3018,1315,4,0,15477
8/2/2020,8,10688,727,3103,1373,32,0,15923
8/2/2020,9,10675,815,3617,1529,53,1,16690
8/2/2020,10,10683,815,3819,1793,116,8,17234
8/2/2020,11,10687,882,3725,2223,140,0,17657
8/2/2020,12,10670,989,4119,2356,179,0,18313
8/2/2020,13,10638,975,4182,2495,186,0,18476
8/2/2020,14,10613,1008,3812,2668,191,0,18292
8/2/2020,15,10601,1071,3853,3102,171,0,18798
8/2/2020,16,10609,1207,3913,3311,158,0,19198
8/2/2020,17,10602,1201,3884,3233,125,0,19045
8/2/2020,18,10588,1240,3824,2886,72,0,18610
8/2/2020,19,10591,1070,3833,2168,24,0,17686
8/2/2020,20,10625,920,3982,2016,2,0,17545
8/2/2020,21,10634,834,4668,1711,0,0,17847
8/2/2020,22,10651,501,4303,1696,0,0,17151
8/2/2020,23,10654,365,3887,1421,0,0,16327
8/2/2020,24,10639,237,3962,1146,0,0,15984
8/3/2020,1,10644,190,3639,902,0,0,15375
8/3/2020,2,10655,190,3270,782,0,0,14897
8/3/2020,3,10659,201,3087,643,0,0,14590
8/3/2020,4,10670,208,3078,479,0,0,14435
8/3/2020,5,10711,329,3198,455,1,0,14694
8/3/2020,6,10762,684,3085,364,2,0,14897
8/3/2020,7,10803,944,3118,213,32,0,15110
8/3/2020,8,10828,1038,3180,129,73,0,15248
8/3/2020,9,10830,1080,3252,388,218,0,15768
8/3/2020,10,10842,1264,3635,508,305,0,16554
8/3/2020,11,10832,1503,4022,629,324,0,17310
8/3/2020,12,10819,1612,4217,674,334,0,17656
8/3/2020,13,10772,1577,4303,646,328,0,17626
8/3/2020,14,10758,1944,4523,544,324,0,18093
8/3/2020,15,10748,1789,4447,531,314,0,17829
8/3/2020,16,10719,1658,4522,567,270,0,17736
8/3/2020,17,10713,1532,4566,438,165,0,17414
8/3/2020,18,10712,1596,4713,357,77,0,17455
8/3/2020,19,10727,1482,4710,345,31,0,17295
8/3/2020,20,10751,1518,4627,321,3,0,17220
8/3/2020,21,10765,1463,4535,329,0,0,17092
8/3/2020,22,10786,1518,4146,410,0,0,16860
8/3/2020,23,10804,1229,3722,538,0,0,16293
8/3/2020,24,10812,406,3618,628,0,0,15464
8/4/2020,1,10808,189,3330,498,0,9,14834
8/4/2020,2,10799,189,3235,501,0,10,14734
8/4/2020,3,10795,216,3413,611,0,11,15046
8/4/2020,4,10971,347,3180,556,0,11,15065
8/4/2020,5,10956,711,3218,504,0,10,15399
8/4/2020,6,10925,924,3356,478,2,17,15702
8/4/2020,7,10909,1110,3595,503,8,27,16152
8/4/2020,8,10901,1377,3860,442,33,28,16641
8/4/2020,9,10908,1754,4023,440,76,27,17228
8/4/2020,10,10805,1931,4095,469,138,27,17465
8/4/2020,11,10978,1840,4077,492,141,26,17554
8/4/2020,12,11139,2112,4198,604,162,26,18241
8/4/2020,13,11144,1938,4152,1159,126,35,18554
8/4/2020,14,11142,1628,4110,1355,156,71,18462
8/4/2020,15,11117,1474,4218,1497,169,83,18558
8/4/2020,16,11084,1456,4194,1762,140,82,18718
8/4/2020,17,11086,1466,4131,2067,105,84,18939
8/4/2020,18,11105,1461,4090,1723,68,83,18530
8/4/2020,19,11125,1225,4088,1499,24,80,18041
8/4/2020,20,11133,575,4912,1151,2,87,17860
8/4/2020,21,11131,571,5040,807,0,154,17703
8/4/2020,22,11131,407,4589,723,0,122,16972
8/4/2020,23,11118,200,3845,636,0,26,15825
8/4/2020,24,11113,177,3408,581,0,10,15289
8/5/2020,1,11104,178,3044,525,0,11,14862
8/5/2020,2,11100,177,3123,494,0,11,14905
8/5/2020,3,11107,188,2913,355,0,11,14574
8/5/2020,4,11167,189,2897,349,0,10,14612
8/5/2020,5,11198,189,2919,389,0,10,14705
8/5/2020,6,11238,278,3064,296,3,18,14897
8/5/2020,7,11252,355,3220,452,36,26,15341
8/5/2020,8,11269,505,3511,921,133,26,16365
8/5/2020,9,11271,839,3203,1021,243,27,16604
8/5/2020,10,11276,1022,3136,1061,315,26,16836
8/5/2020,11,11283,1138,3169,986,285,26,16887
8/5/2020,12,11278,1251,3253,1123,331,26,17262
8/5/2020,13,11121,1557,3344,817,315,26,17180
8/5/2020,14,11175,1607,3648,571,298,26,17325
8/5/2020,15,11265,1663,3815,442,159,26,17370
8/5/2020,16,11242,1569,3924,402,146,26,17309
8/5/2020,17,11241,1541,4028,385,141,26,17362
8/5/2020,18,11246,1165,4112,512,97,27,17159
8/5/2020,19,11247,969,4065,519,24,27,16851
8/5/2020,20,11263,625,4306,484,1,26,16705
8/5/2020,21,11264,659,4517,450,0,26,16916
8/5/2020,22,11266,465,4519,407,0,26,16683
8/5/2020,23,11282,374,3653,388,0,16,15713
8/5/2020,24,11285,372,3201,282,0,9,15149
8/6/2020,1,10889,378,3139,351,0,7,14764
8/6/2020,2,10703,376,3126,307,0,6,14518
8/6/2020,3,10701,453,3085,265,0,6,14510
8/6/2020,4,10495,474,3272,233,0,6,14480
8/6/2020,5,10527,607,3381,150,2,10,14677
8/6/2020,6,10749,734,3192,169,4,19,14867
8/6/2020,7,10822,798,3416,186,41,12,15275
8/6/2020,8,11232,837,3451,104,113,20,15757
8/6/2020,9,11280,1037,3470,89,265,26,16167
8/6/2020,10,8199,1228,3536,77,372,26,13438
8/6/2020,11,8193,1335,3817,70,341,26,13782
8/6/2020,12,8181,1432,3784,86,351,26,13860
8/6/2020,13,8195,1634,3624,117,346,26,13942
8/6/2020,14,11273,1728,3704,72,205,26,17008
8/6/2020,15,8203,1730,3848,122,176,27,14106
8/6/2020,16,8195,1453,4074,169,227,26,14144
8/6/2020,17,8183,1241,4883,227,229,31,14794
8/6/2020,18,8181,1544,4913,177,120,37,14972
8/6/2020,19,8185,1376,4920,126,24,26,14657
8/6/2020,20,8185,1256,4821,69,4,26,14361
8/6/2020,21,8186,1383,4649,91,0,26,14335
8/6/2020,22,11263,868,3882,127,0,26,16166
8/6/2020,23,11263,292,3892,108,0,16,15571
8/6/2020,24,11273,187,3454,152,0,12,15078
8/7/2020,1,11208,192,3046,137,0,9,14592
8/7/2020,2,10740,192,3177,163,0,8,14280
8/7/2020,3,10644,266,3226,135,0,8,14279
8/7/2020,4,10627,299,3140,144,0,8,14218
8/7/2020,5,10423,477,3321,172,1,11,14405
8/7/2020,6,10684,756,3384,236,4,18,15082
8/7/2020,7,11001,833,3542,281,42,26,15725
8/7/2020,8,11145,922,3972,170,142,27,16378
8/7/2020,9,11145,1399,3988,98,251,26,16907
8/7/2020,10,11139,1403,4148,120,343,26,17179
8/7/2020,11,11130,1682,4091,179,404,30,17516
8/7/2020,12,11124,1576,4126,187,410,28,17451
8/7/2020,13,11118,1655,3995,243,417,27,17455
8/7/2020,14,11107,1740,4124,298,388,26,17683
8/7/2020,15,11094,1756,4305,307,376,26,17864
8/7/2020,16,11057,1950,4526,250,304,25,18112
8/7/2020,17,11126,2422,4783,225,240,26,18822
8/7/2020,18,11182,2177,5217,204,117,26,18923
8/7/2020,19,11202,1515,5150,128,29,26,18050
8/7/2020,20,11223,1376,4798,105,2,26,17530
8/7/2020,21,11225,1454,4579,104,0,26,17388
8/7/2020,22,11222,1417,3938,102,0,26,16705
8/7/2020,23,11206,437,3916,116,0,11,15686
8/7/2020,24,11193,278,3668,160,0,2,15301
8/8/2020,1,11177,210,3559,139,0,0,15085
8/8/2020,2,11156,208,3262,150,0,0,14776
8/8/2020,3,10900,189,3182,170,0,0,14441
8/8/2020,4,10398,191,3669,210,0,0,14468
8/8/2020,5,10333,313,3747,165,1,0,14559
8/8/2020,6,10304,441,3629,190,4,0,14568
8/8/2020,7,10384,589,3542,205,41,0,14761
8/8/2020,8,10668,647,3712,155,151,2,15335
8/8/2020,9,10954,847,3820,85,275,13,15994
8/8/2020,10,11064,1381,3608,86,352,13,16504
8/8/2020,11,11032,1634,4150,130,372,18,17336
8/8/2020,12,10989,1884,4279,222,373,30,17777
8/8/2020,13,10955,2108,4269,267,331,31,17961
8/8/2020,14,10961,2180,4287,365,376,32,18201
8/8/2020,15,11036,2202,4278,431,347,33,18327
8/8/2020,16,11034,2163,4290,687,276,33,18483
8/8/2020,17,11030,2154,4727,667,209,33,18820
8/8/2020,18,11044,2041,4884,786,109,27,18891
8/8/2020,19,11081,1942,4833,744,32,21,18653
8/8/2020,20,11102,1701,4775,1020,3,23,18624
8/8/2020,21,11113,1333,4243,1164,0,23,17876
8/8/2020,22,11119,933,4084,1074,0,24,17234
8/8/2020,23,11119,359,3758,1496,0,24,16756
8/8/2020,24,11117,184,3113,1327,0,20,15761
8/9/2020,1,10716,184,3103,1271,0,25,15299
8/9/2020,2,10690,187,3036,1464,0,22,15399
8/9/2020,3,10678,189,2907,1508,0,22,15304
8/9/2020,4,10659,267,2884,1123,0,23,14956
8/9/2020,5,10654,419,2886,897,0,26,14882
8/9/2020,6,10642,557,2868,873,4,24,14968
8/9/2020,7,10636,668,2943,1150,32,22,15451
8/9/2020,8,10626,920,3152,937,79,24,15738
8/9/2020,9,10618,1213,3135,978,134,24,16102
8/9/2020,10,10617,1641,3642,971,163,23,17057
8/9/2020,11,10592,1971,4162,863,164,22,17774
8/9/2020,12,10592,2535,4143,717,177,24,18188
8/9/2020,13,10578,2369,4491,796,201,23,18458
8/9/2020,14,10580,2559,4442,911,272,21,18785
8/9/2020,15,10584,2786,4511,1071,327,20,19299
8/9/2020,16,10587,3014,4575,1148,253,24,19601
8/9/2020,17,10592,3457,5060,1044,180,15,20348
8/9/2020,18,10591,3633,5236,1008,97,1,20566
8/9/2020,19,10591,3624,4943,944,25,1,20128
8/9/2020,20,10596,3697,4852,910,0,2,20057
8/9/2020,21,10619,3072,4671,1039,0,9,19410
8/9/2020,22,10649,2612,3971,1250,0,30,18512
8/9/2020,23,10659,1919,3759,1516,0,35,17888
8/9/2020,24,10677,1628,3387,1607,0,37,17336
8/10/2020,1,10679,1563,3019,1574,0,36,16871
8/10/2020,2,10681,1568,2713,1415,0,40,16417
8/10/2020,3,10663,1577,2704,1141,0,34,16119
8/10/2020,4,10662,1736,2772,1117,0,35,16322
8/10/2020,5,10647,2106,2803,900,1,36,16493
8/10/2020,6,10636,2659,2903,766,3,42,17009
8/10/2020,7,10626,3206,3128,399,15,60,17434
8/10/2020,8,10616,3267,3384,844,113,101,18325
8/10/2020,9,10605,3502,3728,846,194,151,19026
8/10/2020,10,10614,4512,4074,677,307,159,20343
8/10/2020,11,10624,4799,4391,616,385,203,21018
8/10/2020,12,10616,5012,4506,699,388,207,21428
8/10/2020,13,10612,5136,4736,961,399,195,22039
8/10/2020,14,10613,4929,4801,1222,401,154,22120
8/10/2020,15,10620,4760,4890,1579,358,82,22289
8/10/2020,16,10619,4635,5082,1639,301,89,22365
8/10/2020,17,10618,4691,5226,1510,211,105,22361
8/10/2020,18,10616,5027,5304,1263,98,117,22425
8/10/2020,19,10620,5248,5239,1040,23,197,22367
8/10/2020,20,10620,5077,5149,1146,1,202,22195
8/10/2020,21,10620,4289,4772,1611,0,139,21431
8/10/2020,22,10611,3467,4213,1778,0,83,20152
8/10/2020,23,10265,2775,3273,1941,0,30,18284
8/10/2020,24,10199,2536,3040,1554,0,9,17338
8/11/2020,1,10208,2534,2955,1265,0,9,16971
8/11/2020,2,10256,2523,2803,1535,0,11,17128
8/11/2020,3,10266,2523,2763,1872,0,10,17434
8/11/2020,4,9784,2691,2968,2091,0,9,17543
8/11/2020,5,9393,2815,3193,1920,1,16,17338
8/11/2020,6,9390,3085,3181,1796,3,25,17480
8/11/2020,7,9366,3327,3382,1593,31,31,17730
8/11/2020,8,9367,3827,3670,1313,101,33,18311
8/11/2020,9,9361,4357,3621,1170,193,40,18742
8/11/2020,10,9361,5132,3948,953,281,28,19703
8/11/2020,11,9346,5724,4186,936,276,30,20498
8/11/2020,12,9339,5494,4532,1019,253,42,20679
8/11/2020,13,9340,5293,4567,1128,283,76,20687
8/11/2020,14,9340,5624,4715,1156,283,119,21237
8/11/2020,15,9335,5701,4716,1238,304,124,21418
8/11/2020,16,9333,5691,4868,1205,239,125,21461
8/11/2020,17,9326,5446,4951,1183,146,100,21152
8/11/2020,18,9336,5033,5086,972,70,95,20592
8/11/2020,19,9351,5101,4716,674,23,97,19962
8/11/2020,20,9371,4956,4609,519,0,88,19543
8/11/2020,21,9388,4631,4511,556,0,83,19169
8/11/2020,22,9399,3729,3747,653,0,79,17607
8/11/2020,23,9404,3092,3462,627,0,30,16615
8/11/2020,24,9407,3072,3028,523,0,12,16042
8/12/2020,1,9401,3126,2834,436,1,10,15808
8/12/2020,2,9389,3018,2717,370,0,11,15505
8/12/2020,3,9131,3018,2694,313,0,10,15166
8/12/2020,4,9065,3034,2584,240,0,10,14933
8/12/2020,5,8883,3221,2707,273,2,12,15098
8/12/2020,6,8767,3390,3191,350,5,19,15722
8/12/2020,7,9134,3630,3343,311,41,27,16486
8/12/2020,8,9324,3726,3722,169,153,27,17121
8/12/2020,9,9338,3880,3890,81,272,44,17505
8/12/2020,10,9349,3971,4143,71,329,77,17940
8/12/2020,11,9349,4497,4253,61,393,80,18633
8/12/2020,12,9354,5452,4223,89,395,81,19594
8/12/2020,13,9351,5680,4521,112,411,81,20156
8/12/2020,14,9342,6045,4656,141,390,79,20653
8/12/2020,15,9327,5728,4859,172,362,82,20530
8/12/2020,16,9340,6314,4981,169,332,82,21218
8/12/2020,17,9338,6268,5053,147,234,92,21132
8/12/2020,18,9327,6092,5127,159,113,82,20900
8/12/2020,19,9323,5884,5174,125,24,85,20615
8/12/2020,20,9324,5328,5159,86,2,83,19982
8/12/2020,21,9318,5192,5019,95,0,83,19707
8/12/2020,22,9314,4203,4472,77,0,83,18149
8/12/2020,23,9312,3342,3880,57,0,76,16667
8/12/2020,24,9302,2812,3680,75,0,26,15895
8/13/2020,1,9483,2585,3387,84,0,9,15548
8/13/2020,2,9567,2506,3354,95,0,9,15531
8/13/2020,3,9666,2497,2948,111,0,9,15231
8/13/2020,4,9677,2614,3073,101,0,9,15474
8/13/2020,5,9660,2834,3154,118,1,17,15784
8/13/2020,6,9679,2999,3396,281,3,22,16380
8/13/2020,7,9706,3209,3394,360,34,26,16729
8/13/2020,8,9709,3362,3734,352,134,26,17317
8/13/2020,9,9702,3636,3868,126,267,26,17625
8/13/2020,10,9693,4126,3847,117,356,26,18165
8/13/2020,11,9689,4079,4221,241,410,26,18666
8/13/2020,12,9676,4318,4341,367,419,26,19147
8/13/2020,13,9658,4703,4347,495,398,30,19631
8/13/2020,14,9642,5079,4357,509,373,54,20014
8/13/2020,15,9662,5401,4728,508,340,78,20717
8/13/2020,16,9643,5224,4706,585,293,86,20537
8/13/2020,17,9636,5152,5037,612,233,86,20756
8/13/2020,18,9634,5007,5116,576,106,82,20521
8/13/2020,19,9644,5290,5014,537,22,81,20588
8/13/2020,20,9669,5097,4641,638,2,79,20126
8/13/2020,21,9683,4882,4306,796,0,92,19759
8/13/2020,22,9680,4351,3830,961,0,114,18936
8/13/2020,23,9703,3354,3638,1213,0,119,18027
8/13/2020,24,9719,2664,3419,1410,0,70,17282
8/14/2020,1,9730,2213,3176,1682,0,25,16826
8/14/2020,2,9725,2133,2643,1540,0,10,16051
8/14/2020,3,9719,2136,2576,1340,0,9,15780
8/14/2020,4,9715,2143,2620,1590,0,10,16078
8/14/2020,5,9713,2148,2645,1407,1,16,15930
8/14/2020,6,9708,2182,2769,1587,2,35,16283
8/14/2020,7,9698,2264,3076,1602,40,33,16713
8/14/2020,8,9690,2696,3991,1340,141,30,17888
8/14/2020,9,9672,3300,4370,1069,260,27,18698
8/14/2020,10,9657,3317,4357,1193,356,33,18913
8/14/2020,11,9654,3547,3809,1433,387,35,18865
8/14/2020,12,9663,3657,3911,1527,409,27,19194
8/14/2020,13,9664,3998,3947,1596,378,26,19609
8/14/2020,14,9683,4254,4279,1541,371,26,20154
8/14/2020,15,9648,4648,4080,1693,363,50,20482
8/14/2020,16,9634,4332,4423,1800,278,80,20547
8/14/2020,17,9628,4648,4460,1616,193,80,20625
8/14/2020,18,9634,4984,4494,1296,89,80,20577
8/14/2020,19,9634,5291,4254,956,17,97,20249
8/14/2020,20,9637,4254,4431,1034,1,83,19440
8/14/2020,21,9644,3707,4284,1576,0,73,19284
8/14/2020,22,9652,2624,3936,1857,0,35,18104
8/14/2020,23,9653,1956,3846,1866,0,7,17328
8/14/2020,24,9660,1347,3291,2206,0,0,16504
8/15/2020,1,9668,1185,2913,2206,0,0,15972
8/15/2020,2,9687,1176,2724,1754,0,0,15341
8/15/2020,3,9693,1177,2682,2008,0,0,15560
8/15/2020,4,9701,1174,2701,1890,0,0,15466
8/15/2020,5,9714,1175,2734,1792,1,0,15416
8/15/2020,6,9707,1254,2686,1232,2,0,14881
8/15/2020,7,9699,1493,2727,1235,34,0,15188
8/15/2020,8,9675,1755,2983,1021,143,0,15577
8/15/2020,9,9661,2085,3310,744,247,0,16047
8/15/2020,10,9646,2607,3698,437,326,0,16714
8/15/2020,11,9637,3164,3701,337,367,0,17206
8/15/2020,12,9623,3067,4057,248,405,0,17400
8/15/2020,13,9614,3602,4073,260,361,0,17910
8/15/2020,14,9616,3853,4177,263,343,0,18252
8/15/2020,15,9298,4229,4344,194,337,4,18406
8/15/2020,16,8821,4857,4777,191,276,5,18927
8/15/2020,17,8822,4681,5008,251,187,6,18955
8/15/2020,18,8833,4318,4967,205,90,0,18413
8/15/2020,19,8840,4116,4806,219,20,0,18001
8/15/2020,20,8842,4037,4462,389,0,0,17730
8/15/2020,21,8849,3839,3942,709,0,0,17339
8/15/2020,22,8873,3319,3648,1011,0,0,16851
8/15/2020,23,8882,2684,3453,1333,0,0,16352
8/15/2020,24,8859,1661,3121,1618,0,0,15259
8/16/2020,1,8847,1083,3024,1830,0,0,14784
8/16/2020,2,8836,1033,3103,1782,0,0,14754
8/16/2020,3,8842,1123,3088,1678,0,0,14731
8/16/2020,4,8857,1160,3042,1693,0,0,14752
8/16/2020,5,9001,1107,2567,1806,1,0,14482
8/16/2020,6,9052,1331,2518,1455,2,0,14358
8/16/2020,7,9047,1663,2723,1132,26,1,14592
8/16/2020,8,9019,2027,3040,1177,93,0,15356
8/16/2020,9,9013,2436,3299,936,143,0,15827
8/16/2020,10,9004,2941,3509,866,153,0,16473
8/16/2020,11,9045,2955,3714,934,119,0,16767
8/16/2020,12,9212,2872,3940,567,171,0,16762
8/16/2020,13,9289,2614,4025,575,147,0,16650
8/16/2020,14,9294,2568,3779,835,167,0,16643
8/16/2020,15,9308,2359,3756,686,219,0,16328
8/16/2020,16,9315,2305,4419,482,211,0,16732
8/16/2020,17,9312,2894,4567,459,123,0,17355
8/16/2020,18,9299,3008,4576,441,61,0,17385
8/16/2020,19,9299,2816,4619,309,15,0,17058
8/16/2020,20,9294,2664,4583,241,0,0,16782
8/16/2020,21,9353,2596,4377,274,0,0,16600
8/16/2020,22,9525,2083,3935,346,0,0,15889
8/16/2020,23,9526,1812,3639,213,0,0,15190
8/16/2020,24,9543,1376,3465,180,0,0,14564
8/17/2020,1,9546,1319,3370,182,0,0,14417
8/17/2020,2,9559,1214,2980,184,0,5,13942
8/17/2020,3,9560,1186,2842,187,0,8,13783
8/17/2020,4,9569,1214,2781,167,0,7,13738
8/17/2020,5,9574,1408,2905,186,1,10,14084
8/17/2020,6,9572,1678,2752,294,2,21,14319
8/17/2020,7,9569,1973,3008,286,30,34,14900
8/17/2020,8,9567,2089,3315,403,126,37,15537
8/17/2020,9,9592,2568,3740,235,220,37,16392
8/17/2020,10,9620,2875,3693,213,326,37,16764
8/17/2020,11,9619,2822,3867,265,362,36,16971
8/17/2020,12,9616,3244,4222,415,300,33,17830
8/17/2020,13,9609,3395,4187,776,284,36,18287
8/17/2020,14,9609,3345,4195,918,186,29,18282
8/17/2020,15,9609,2869,4137,932,172,26,17745
8/17/2020,16,9598,3153,4422,929,109,26,18237
8/17/2020,17,9592,3354,4566,798,84,26,18420
8/17/2020,18,9665,3578,4556,576,63,26,18464
8/17/2020,19,9807,3061,4423,704,15,26,18036
8/17/2020,20,9789,2552,4621,467,1,26,17456
8/17/2020,21,9788,1910,4471,480,0,26,16675
8/17/2020,22,9775,1763,3945,540,0,26,16049
8/17/2020,23,9960,869,3514,538,0,17,14898
8/17/2020,24,10003,273,3133,513,0,14,13936
8/18/2020,1,10053,238,3111,556,0,10,13968
8/18/2020,2,10185,199,2873,497,0,11,13765
8/18/2020,3,10187,194,2754,391,0,10,13536
8/18/2020,4,10194,312,2707,642,0,10,13865
8/18/2020,5,10237,577,2727,486,2,12,14041
8/18/2020,6,10232,933,2881,650,2,21,14719
8/18/2020,7,10242,1057,3081,755,37,27,15199
8/18/2020,8,10252,1479,3467,706,141,28,16073
8/18/2020,9,10252,1628,3483,748,260,34,16405
8/18/2020,10,10271,1745,3185,854,345,32,16432
8/18/2020,11,10286,1889,2995,772,390,28,16360
8/18/2020,12,10292,1971,3648,981,336,26,17254
8/18/2020,13,10264,1948,3543,1100,327,26,17208
8/18/2020,14,10302,1929,3387,1171,308,26,17123
8/18/2020,15,10325,1849,3336,1314,263,26,17113
8/18/2020,16,10338,1797,3578,1242,197,26,17178
8/18/2020,17,10341,1795,4081,1234,158,26,17635
8/18/2020,18,10337,1673,4331,1109,99,26,17575
8/18/2020,19,10338,1775,4176,883,20,26,17218
8/18/2020,20,10352,1451,4427,735,1,26,16992
8/18/2020,21,10366,1363,4114,689,0,26,16558
8/18/2020,22,10380,987,3919,738,0,26,16050
8/18/2020,23,10386,281,3548,630,0,16,14861
8/18/2020,24,10464,185,3362,464,0,10,14485
8/19/2020,1,10574,185,3046,352,0,11,14168
8/19/2020,2,10601,184,2658,271,0,9,13723
8/19/2020,3,10464,184,2546,227,0,9,13430
8/19/2020,4,10304,188,2728,318,0,10,13548
8/19/2020,5,10295,310,2848,322,1,10,13786
8/19/2020,6,10353,598,3244,308,2,25,14530
8/19/2020,7,10580,933,3112,200,32,28,14885
8/19/2020,8,10572,1115,3468,149,146,27,15477
8/19/2020,9,10561,1223,3697,110,273,26,15890
8/19/2020,10,10556,1508,3563,139,350,30,16146
8/19/2020,11,10559,1780,3629,167,381,31,16547
8/19/2020,12,10581,1783,3572,229,361,35,16561
8/19/2020,13,10459,1792,3675,178,319,32,16455
8/19/2020,14,10441,1869,3672,165,290,28,16465
8/19/2020,15,10445,1867,3624,143,287,27,16393
8/19/2020,16,10570,1850,3724,79,162,27,16412
8/19/2020,17,10647,1662,4117,158,195,28,16807
8/19/2020,18,10655,1507,4065,147,91,33,16498
8/19/2020,19,10654,1498,4121,115,20,27,16435
8/19/2020,20,10628,1173,4022,77,0,26,15926
8/19/2020,21,10595,1056,4031,103,0,26,15811
8/19/2020,22,10603,869,3663,143,0,26,15304
8/19/2020,23,10609,395,3455,252,0,14,14725
8/19/2020,24,10630,186,3414,265,0,11,14506
8/20/2020,1,10623,184,2848,298,0,11,13964
8/20/2020,2,10609,184,2594,344,0,10,13741
8/20/2020,3,10608,188,2548,277,0,11,13632
8/20/2020,4,10641,188,2561,302,0,11,13703
8/20/2020,5,10659,233,2583,361,2,12,13850
8/20/2020,6,10669,321,2758,313,2,23,14086
8/20/2020,7,10632,408,3016,791,40,27,14914
8/20/2020,8,10590,473,3633,951,128,27,15802
8/20/2020,9,10560,631,3775,828,240,28,16062
8/20/2020,10,10526,950,3601,1181,326,27,16611
8/20/2020,11,10493,1232,3271,1306,358,28,16688
8/20/2020,12,10483,1295,3549,1324,353,28,17032
8/20/2020,13,10496,1344,3597,1447,331,27,17242
8/20/2020,14,10450,1347,3591,1345,351,27,17111
8/20/2020,15,10481,1400,3672,1397,346,27,17323
8/20/2020,16,10486,1436,3795,1509,296,27,17549
8/20/2020,17,10496,1413,4068,1571,209,26,17783
8/20/2020,18,10508,1230,4354,1541,89,26,17748
8/20/2020,19,10502,1209,4252,1437,18,26,17444
8/20/2020,20,10487,1048,4067,1438,0,26,17066
8/20/2020,21,10479,798,3794,1446,0,30,16547
8/20/2020,22,10492,660,3509,1600,0,28,16289
8/20/2020,23,10521,258,3159,1778,0,14,15730
8/20/2020,24,10543,185,2905,1693,0,10,15336
8/21/2020,1,10545,188,2693,1204,0,10,14640
8/21/2020,2,10571,191,2642,900,0,10,14314
8/21/2020,3,10580,232,2663,834,0,11,14320
8/21/2020,4,10588,266,2789,865,0,10,14518
8/21/2020,5,10585,406,2755,738,0,10,14494
8/21/2020,6,10581,578,2674,660,1,15,14509
8/21/2020,7,10596,698,3015,745,23,26,15103
8/21/2020,8,10596,950,3681,592,111,26,15956
8/21/2020,9,10606,1548,3642,340,144,26,16306
8/21/2020,10,10595,1754,3573,243,208,26,16399
8/21/2020,11,10604,2054,3915,191,286,26,17076
8/21/2020,12,10615,2172,4026,254,312,26,17405
8/21/2020,13,10607,2354,4283,401,312,26,17983
8/21/2020,14,10599,2427,4303,538,286,25,18178
8/21/2020,15,10589,2601,4252,585,336,26,18389
8/21/2020,16,10582,3111,4435,568,254,26,18976
8/21/2020,17,10588,3482,4592,515,192,27,19396
8/21/2020,18,10601,3359,4753,469,87,26,19295
8/21/2020,19,10618,3218,4798,364,19,26,19043
8/21/2020,20,10629,2934,4855,304,0,26,18748
8/21/2020,21,10641,2811,4581,335,0,26,18394
8/21/2020,22,10654,2014,4139,410,0,26,17243
8/21/2020,23,10657,1325,3756,555,0,14,16307
8/21/2020,24,10653,388,3358,579,0,1,14979
8/22/2020,1,10636,175,3399,481,0,0,14691
8/22/2020,2,10623,175,3257,438,0,0,14493
8/22/2020,3,10613,178,3229,304,0,0,14324
8/22/2020,4,10613,181,3258,138,0,0,14190
8/22/2020,5,10605,263,3370,122,0,0,14360
8/22/2020,6,10615,532,2966,134,2,0,14249
8/22/2020,7,10621,804,2877,90,31,0,14423
8/22/2020,8,10620,1027,3209,66,120,0,15042
8/22/2020,9,10624,1438,3514,65,241,0,15882
8/22/2020,10,10631,2127,3548,107,339,0,16752
8/22/2020,11,10631,2604,3788,88,394,0,17505
8/22/2020,12,10621,2830,3913,145,404,0,17913
8/22/2020,13,10612,2883,4151,187,370,0,18203
8/22/2020,14,10589,3080,4186,199,357,0,18411
8/22/2020,15,10561,3207,4411,220,371,0,18770
8/22/2020,16,10551,3576,4632,243,290,0,19292
8/22/2020,17,10549,3910,4741,260,178,0,19638
8/22/2020,18,10552,3820,4865,241,88,0,19566
8/22/2020,19,10543,3668,4681,170,15,0,19077
8/22/2020,20,10546,3550,4640,125,0,0,18861
8/22/2020,21,10558,3381,4237,107,0,0,18283
8/22/2020,22,10566,2899,3872,157,0,0,17494
8/22/2020,23,10570,2111,3479,225,0,0,16385
8/22/2020,24,10568,1229,2990,274,0,0,15061
8/23/2020,1,10554,480,2882,359,0,0,14275
8/23/2020,2,10558,371,2851,447,0,0,14227
8/23/2020,3,10546,448,2837,586,0,0,14417
8/23/2020,4,10540,615,2816,740,0,0,14711
8/23/2020,5,10543,750,2694,731,1,0,14719
8/23/2020,6,10534,834,2706,788,3,0,14865
8/23/2020,7,10537,982,2828,340,26,0,14713
8/23/2020,8,10553,1302,3115,435,127,0,15532
8/23/2020,9,10559,1989,3342,290,246,0,16426
8/23/2020,10,10559,2576,3849,229,350,0,17563
8/23/2020,11,10465,3091,3996,241,378,0,18171
8/23/2020,12,10382,3485,4065,290,405,0,18627
8/23/2020,13,10331,4072,4160,315,377,0,19255
8/23/2020,14,10306,4222,4509,376,346,5,19764
8/23/2020,15,10287,3991,4534,369,377,27,19585
8/23/2020,16,10290,4043,4660,358,296,55,19702
8/23/2020,17,10304,4255,4867,378,203,68,20075
8/23/2020,18,10262,4240,4648,310,93,60,19613
8/23/2020,19,10257,4346,4436,262,14,54,19369
8/23/2020,20,10258,4300,4478,259,0,55,19350
8/23/2020,21,10254,4173,4207,385,0,11,19030
8/23/2020,22,10259,3402,3888,570,0,0,18119
8/23/2020,23,10269,2774,3267,606,0,0,16916
8/23/2020,24,10274,2684,2804,257,0,0,16019
8/24/2020,1,10263,2052,2821,391,0,3,15530
8/24/2020,2,10259,1981,2764,614,0,8,15626
8/24/2020,3,10254,1983,2997,657,0,8,15899
8/24/2020,4,10240,1990,2933,568,0,8,15739
8/24/2020,5,10228,2020,2813,493,0,12,15566
8/24/2020,6,10302,2365,3035,572,2,19,16295
8/24/2020,7,10319,2945,2758,471,23,25,16541
8/24/2020,8,10320,3346,3003,503,115,26,17313
8/24/2020,9,10313,3612,3648,342,233,26,18174
8/24/2020,10,10316,4418,3705,399,327,26,19191
8/24/2020,11,10314,4682,3739,626,389,25,19775
8/24/2020,12,10301,5070,3879,937,387,26,20600
8/24/2020,13,10282,5002,4025,1266,298,25,20898
8/24/2020,14,10280,4854,4461,1631,333,20,21579
8/24/2020,15,10286,4916,4838,1716,343,0,22099
8/24/2020,16,10281,5277,5041,1641,272,4,22516
8/24/2020,17,10275,5716,5161,1289,175,23,22639
8/24/2020,18,10270,5487,4875,1262,82,26,22002
8/24/2020,19,10277,5369,4453,1220,16,26,21361
8/24/2020,20,10284,5151,4274,1399,0,26,21134
8/24/2020,21,10291,4802,4160,1502,0,26,20781
8/24/2020,22,10287,3822,3973,1444,0,26,19552
8/24/2020,23,10287,2808,3697,1377,0,20,18189
8/24/2020,24,10276,2236,3321,1389,0,12,17234
8/25/2020,1,10300,1622,3253,1308,0,9,16492
8/25/2020,2,10322,1728,3194,1178,0,9,16431
8/25/2020,3,10337,1504,3173,1011,0,9,16034
8/25/2020,4,10348,1570,3123,959,0,9,16009
8/25/2020,5,10362,1384,2888,1043,0,12,15689
8/25/2020,6,10363,1616,2894,1037,3,19,15932
8/25/2020,7,10366,2063,3470,802,16,25,16742
8/25/2020,8,10354,2738,3760,705,88,25,17670
8/25/2020,9,10366,2929,3750,902,191,25,18163
8/25/2020,10,10375,3088,3797,983,238,26,18507
8/25/2020,11,10386,3493,3830,952,331,25,19017
8/25/2020,12,10408,3638,3868,986,351,25,19276
8/25/2020,13,10334,3495,4192,1011,363,26,19421
8/25/2020,14,9659,3935,4303,1128,364,26,19415
8/25/2020,15,9669,3764,4194,1311,318,25,19281
8/25/2020,16,9667,3904,4192,1414,288,25,19490
8/25/2020,17,9663,4165,4490,1369,184,29,19900
8/25/2020,18,9657,3641,4780,1250,90,30,19448
8/25/2020,19,9657,3464,4455,981,14,26,18597
8/25/2020,20,9653,3354,4513,665,0,27,18212
8/25/2020,21,9656,3493,3927,648,0,27,17751
8/25/2020,22,9662,2550,3383,564,0,27,16186
8/25/2020,23,9682,1883,3178,467,0,17,15227
8/25/2020,24,9773,1274,2996,502,0,9,14554
8/26/2020,1,9772,1055,2922,401,0,7,14157
8/26/2020,2,9771,1015,3026,342,0,7,14161
8/26/2020,3,9765,1023,2729,378,0,7,13902
8/26/2020,4,9774,1092,2903,387,0,7,14163
8/26/2020,5,9791,1314,3029,372,1,10,14517
8/26/2020,6,9794,1689,3161,394,3,21,15062
8/26/2020,7,9798,1704,2922,379,35,26,14864
8/26/2020,8,9794,1882,3188,423,124,27,15438
8/26/2020,9,9803,1895,3190,426,205,27,15546
8/26/2020,10,9807,2066,3318,481,238,27,15937
8/26/2020,11,9810,2557,3366,360,282,27,16402
8/26/2020,12,9810,2172,3273,470,315,26,16066
8/26/2020,13,9802,1931,3606,571,297,26,16233
8/26/2020,14,9777,1955,3521,586,291,27,16157
8/26/2020,15,9762,2080,3606,479,232,27,16186
8/26/2020,16,9757,2239,3954,363,173,27,16513
8/26/2020,17,9747,2269,4399,300,118,27,16860
8/26/2020,18,9750,2347,4430,300,34,27,16888
8/26/2020,19,9753,2235,4439,397,6,27,16857
8/26/2020,20,9756,2208,4366,617,0,26,16973
8/26/2020,21,9761,1911,4065,864,0,26,16627
8/26/2020,22,9770,1300,3777,1015,0,26,15888
8/26/2020,23,9768,717,3231,1486,0,13,15215
8/26/2020,24,9768,281,3185,1741,0,10,14985
8/27/2020,1,9770,188,3256,1853,0,10,15077
8/27/2020,2,9776,202,3165,1768,0,10,14921
8/27/2020,3,9786,195,2763,1766,0,10,14520
8/27/2020,4,9792,195,2583,1885,0,10,14465
8/27/2020,5,9797,225,2554,2364,0,12,14952
8/27/2020,6,9793,408,2761,2765,2,21,15750
8/27/2020,7,9791,785,3218,2750,6,28,16578
8/27/2020,8,9771,1508,3129,2477,44,26,16955
8/27/2020,9,9747,2226,3183,2040,105,26,17327
8/27/2020,10,9738,2944,3806,2234,170,26,18918
8/27/2020,11,9721,3251,3763,2131,222,27,19115
8/27/2020,12,9735,3791,3734,1887,232,29,19408
8/27/2020,13,9750,3856,3706,2117,209,31,19669
8/27/2020,14,9767,3499,3912,2482,169,27,19856
8/27/2020,15,9783,3607,3862,2343,98,27,19720
8/27/2020,16,9797,3695,3519,2007,89,27,19134
8/27/2020,17,9821,3422,4282,1491,83,27,19126
8/27/2020,18,9830,3452,4660,1143,49,26,19160
8/27/2020,19,9839,3324,4518,945,10,26,18662
8/27/2020,20,9844,3475,4235,702,0,26,18282
8/27/2020,21,9867,2890,4238,573,0,26,17594
8/27/2020,22,10046,2102,3681,465,0,26,16320
8/27/2020,23,10059,1589,3479,326,0,14,15467
8/27/2020,24,10221,1264,3360,210,0,10,15065
8/28/2020,1,10192,1263,3069,225,0,10,14759
8/28/2020,2,10189,1197,2862,203,0,10,14461
8/28/2020,3,10346,1197,2641,174,0,10,14368
8/28/2020,4,10194,1203,2676,145,0,10,14228
8/28/2020,5,10150,1206,2917,157,0,12,14442
8/28/2020,6,10167,1460,3174,208,0,21,15030
8/28/2020,7,10342,1616,3076,173,12,27,15246
8/28/2020,8,10357,1636,3256,125,50,27,15451
8/28/2020,9,10370,1923,3339,65,110,27,15834
8/28/2020,10,10384,2389,3132,63,171,28,16167
8/28/2020,11,10392,2608,3588,66,239,27,16920
8/28/2020,12,10408,2625,3549,77,230,27,16916
8/28/2020,13,10404,2788,3950,59,188,27,17416
8/28/2020,14,10399,2858,3945,44,167,26,17439
8/28/2020,15,10397,2899,3680,83,142,27,17228
8/28/2020,16,10524,2855,3673,196,134,27,17409
8/28/2020,17,10526,2499,3617,570,69,32,17313
8/28/2020,18,10519,2314,3766,397,28,34,17058
8/28/2020,19,10505,1785,3655,830,6,28,16809
8/28/2020,20,10476,1426,3635,1498,0,27,17062
8/28/2020,21,10476,1210,3562,1815,0,27,17090
8/28/2020,22,10486,686,3873,1730,0,27,16802
8/28/2020,23,10504,313,3428,2028,0,16,16289
8/28/2020,24,10508,206,2913,2348,0,2,15977
8/29/2020,1,10492,207,2925,2326,0,0,15950
8/29/2020,2,10490,206,2998,2170,0,0,15864
8/29/2020,3,10491,205,2737,2317,0,0,15750
8/29/2020,4,10492,205,2802,2146,0,0,15645
8/29/2020,5,10478,205,2718,2243,0,0,15644
8/29/2020,6,10470,204,2703,2378,1,0,15756
8/29/2020,7,10467,204,2778,1964,7,0,15420
8/29/2020,8,10463,204,2842,2243,44,0,15796
8/29/2020,9,10461,204,3071,2862,67,0,16665
8/29/2020,10,10456,204,3255,3246,119,0,17280
8/29/2020,11,10456,203,3475,3347,189,0,17670
8/29/2020,12,10462,204,3383,3579,207,0,17835
8/29/2020,13,10466,281,3173,3597,216,0,17733
8/29/2020,14,10452,361,3396,3014,234,0,17457
8/29/2020,15,10448,435,3507,2285,222,0,16897
8/29/2020,16,10449,481,3511,2454,186,0,17081
8/29/2020,17,10461,542,3762,2639,141,0,17545
8/29/2020,18,10491,628,4267,2404,59,0,17849
8/29/2020,19,10550,632,4004,2358,10,0,17554
8/29/2020,20,10588,632,3446,2223,0,0,16889
8/29/2020,21,10603,498,3031,2167,0,0,16299
8/29/2020,22,10621,409,3004,1941,0,0,15975
8/29/2020,23,10624,407,2826,1612,0,0,15469
8/29/2020,24,10627,218,2662,1097,0,0,14604
8/30/2020,1,10632,186,2664,683,0,0,14165
8/30/2020,2,10564,204,2683,496,0,0,13947
8/30/2020,3,10347,205,2656,504,0,0,13712
8/30/2020,4,10138,205,2667,270,0,0,13280
8/30/2020,5,10080,204,2666,340,1,0,13291
8/30/2020,6,9860,209,2694,520,2,0,13285
8/30/2020,7,9785,210,3099,745,28,0,13867
8/30/2020,8,9782,259,3256,774,130,0,14201
8/30/2020,9,9846,305,3361,709,245,0,14466
8/30/2020,10,10168,459,3632,558,309,0,15126
8/30/2020,11,10381,791,3386,406,318,0,15282
8/30/2020,12,10384,966,3654,322,306,0,15632
8/30/2020,13,10376,1183,3921,228,290,1,15999
8/30/2020,14,10367,1183,4119,211,253,0,16133
8/30/2020,15,10594,1129,3988,222,235,0,16168
8/30/2020,16,10672,1255,3952,195,228,0,16302
8/30/2020,17,10667,1271,3966,195,165,0,16264
8/30/2020,18,10667,1381,3911,146,67,0,16172
8/30/2020,19,10666,1435,4134,80,11,0,16326
8/30/2020,20,10660,1284,3848,105,0,0,15897
8/30/2020,21,10673,751,3928,113,0,0,15465
8/30/2020,22,10677,442,3903,147,0,0,15169
8/30/2020,23,10637,402,3305,171,0,0,14515
8/30/2020,24,10674,384,2732,176,0,2,13968
8/31/2020,1,10683,211,2762,299,0,10,13965
8/31/2020,2,10607,206,2631,383,0,10,13837
8/31/2020,3,10386,204,2792,637,0,10,14029
8/31/2020,4,10399,204,2761,716,0,9,14089
8/31/2020,5,10409,207,2929,799,0,11,14355
8/31/2020,6,10660,293,2783,897,2,19,14654
8/31/2020,7,10726,315,2892,1074,31,26,15064
8/31/2020,8,10713,609,3237,959,144,26,15688
8/31/2020,9,10709,1053,3257,771,271,26,16087
8/31/2020,10,10725,1227,3048,943,368,25,16336
8/31/2020,11,10723,1494,3155,817,401,27,16617
8/31/2020,12,10719,1529,3454,973,397,26,17098
8/31/2020,13,10721,1410,3302,935,387,26,16781
8/31/2020,14,10698,1567,3529,779,408,26,17007
8/31/2020,15,10672,1813,3575,895,315,26,17296
8/31/2020,16,10656,1870,3723,1015,243,26,17533
8/31/2020,17,10619,2006,3933,1026,153,26,17763
8/31/2020,18,10595,1522,4302,1043,64,26,17552
8/31/2020,19,10585,1367,4157,1036,8,26,17179
8/31/2020,20,10579,1263,3784,1426,0,26,17078
8/31/2020,21,10577,902,3686,1238,0,26,16429
8/31/2020,22,10569,452,3620,1345,0,26,16012
8/31/2020,23,10575,397,3508,1304,0,22,15806
8/31/2020,24,10576,353,2889,1364,0,12,15194
9/1/2020,1,10576,210,2572,1211,0,9,14578
9/1/2020,2,10566,218,2512,1213,0,9,14518
9/1/2020,3,10559,333,2705,1185,0,9,14791
9/1/2020,4,10564,721,2552,806,0,10,14653
9/1/2020,5,10569,966,2600,468,0,14,14617
9/1/2020,6,10567,1042,2705,668,2,21,15005
9/1/2020,7,10566,1187,2985,684,11,26,15459
9/1/2020,8,10565,1553,3534,750,66,26,16494
9/1/2020,9,10562,1858,3773,591,141,26,16951
9/1/2020,10,10563,2249,3706,600,218,26,17362
9/1/2020,11,10557,2566,3854,674,245,26,17922
9/1/2020,12,10550,2950,3918,755,255,26,18454
9/1/2020,13,10553,3120,4211,849,264,26,19023
9/1/2020,14,10557,3324,4215,1011,227,26,19360
9/1/2020,15,10573,3458,4127,909,196,26,19289
9/1/2020,16,10588,3729,4279,785,130,26,19537
9/1/2020,17,10596,3825,4511,699,77,26,19734
9/1/2020,18,10593,3558,4393,738,34,27,19343
9/1/2020,19,10584,3185,4244,930,4,27,18974
9/1/2020,20,10574,3015,4365,1060,0,27,19041
9/1/2020,21,10573,2901,3813,1181,0,27,18495
9/1/2020,22,10534,1902,3885,957,0,27,17305
9/1/2020,23,10534,1607,3604,857,0,21,16623
9/1/2020,24,10528,824,3368,1171,0,11,15902
9/2/2020,1,10528,409,3291,1513,0,10,15751
9/2/2020,2,10524,253,3153,1622,0,11,15563
9/2/2020,3,10503,197,2668,1695,0,11,15074
9/2/2020,4,10528,201,2755,1752,0,13,15249
9/2/2020,5,10541,280,2664,2180,0,20,15685
9/2/2020,6,10542,515,2685,2138,1,57,15938
9/2/2020,7,10536,787,3027,2287,8,64,16709
9/2/2020,8,10467,936,3622,2605,29,66,17725
9/2/2020,9,10447,1293,3804,2383,74,66,18067
9/2/2020,10,10444,2030,3881,2354,105,65,18879
9/2/2020,11,10433,2491,3573,2492,134,66,19189
9/2/2020,12,10433,2702,3683,2334,120,66,19338
9/2/2020,13,10490,2828,3635,2373,181,68,19575
9/2/2020,14,10490,3238,4000,2075,206,66,20075
9/2/2020,15,10473,3065,4155,1969,183,66,19911
9/2/2020,16,10456,3045,4277,1904,126,64,19872
9/2/2020,17,10446,3022,4369,2049,81,60,20027
9/2/2020,18,10444,2763,3964,1783,40,65,19059
9/2/2020,19,10459,2416,3835,1695,6,34,18445
9/2/2020,20,10461,2105,4304,1569,0,26,18465
9/2/2020,21,10460,1952,3967,1467,0,27,17873
9/2/2020,22,10436,1581,3676,1248,0,26,16967
9/2/2020,23,10383,584,3558,1028,0,16,15569
9/2/2020,24,10360,425,3603,659,0,10,15057
9/3/2020,1,10361,324,3385,503,0,6,14579
9/3/2020,2,10363,224,2979,415,0,6,13987
9/3/2020,3,10359,193,2818,448,0,6,13824
9/3/2020,4,10366,199,2735,448,0,12,13760
9/3/2020,5,10375,322,2824,647,1,26,14195
9/3/2020,6,10379,466,2816,729,2,43,14435
9/3/2020,7,10377,746,3029,854,15,52,15073
9/3/2020,8,10373,1186,3105,1039,68,53,15824
9/3/2020,9,10377,1402,3114,1252,144,58,16347
9/3/2020,10,10364,1494,3662,1707,213,59,17499
9/3/2020,11,10354,1634,3317,2443,229,60,18037
9/3/2020,12,10345,1817,3588,2584,257,61,18652
9/3/2020,13,10340,1935,3652,3037,259,62,19285
9/3/2020,14,10117,1979,3817,3577,252,59,19801
9/3/2020,15,10003,2093,3900,3753,263,59,20071
9/3/2020,16,10001,2107,4049,3656,219,55,20087
9/3/2020,17,10001,2104,4208,3547,127,62,20049
9/3/2020,18,9992,2104,4276,3319,48,60,19799
9/3/2020,19,9988,1979,4219,3176,5,58,19425
9/3/2020,20,9972,1226,4391,3379,0,59,19027
9/3/2020,21,9968,874,3734,3459,0,59,18094
9/3/2020,22,9967,652,3826,3000,0,57,17502
9/3/2020,23,9975,256,3440,2758,0,44,16473
9/3/2020,24,9972,194,3284,2449,0,42,15941
9/4/2020,1,9985,190,2821,2049,0,48,15093
9/4/2020,2,9989,170,2920,1076,0,52,14207
9/4/2020,3,9993,191,2907,975,0,50,14116
9/4/2020,4,9997,195,2944,832,0,42,14010
9/4/2020,5,10003,194,2936,1036,0,47,14216
9/4/2020,6,9946,197,3125,1602,3,52,14925
9/4/2020,7,9948,214,3585,1534,18,63,15362
9/4/2020,8,9952,291,3657,1358,101,66,15425
9/4/2020,9,9960,358,3736,1473,199,63,15789
9/4/2020,10,9946,705,3433,1768,268,56,16176
9/4/2020,11,9901,1077,3246,1891,287,51,16453
9/4/2020,12,9887,1269,3519,2009,285,49,17018
9/4/2020,13,9882,1377,3663,1680,281,51,16934
9/4/2020,14,9887,1597,3725,1528,244,47,17028
9/4/2020,15,9918,1676,3722,1598,239,40,17193
9/4/2020,16,9779,1724,3836,1859,185,31,17414
9/4/2020,17,9673,1516,4030,1755,126,33,17133
9/4/2020,18,9497,1245,4272,1579,58,25,16676
9/4/2020,19,9495,1221,4198,1376,7,26,16323
9/4/2020,20,9382,1220,4154,1471,0,27,16254
9/4/2020,21,9350,1237,3511,1436,0,26,15560
9/4/2020,22,9314,590,3242,1508,0,26,14680
9/4/2020,23,9325,335,3116,1579,0,11,14366
9/4/2020,24,9331,203,3131,1555,0,1,14221
9/5/2020,1,9329,197,2927,1575,0,0,14028
9/5/2020,2,9328,195,2767,1544,0,0,13834
9/5/2020,3,9318,198,2798,1343,0,0,13657
9/5/2020,4,9313,198,2889,1540,0,0,13940
9/5/2020,5,9302,198,3045,1247,0,0,13792
9/5/2020,6,9284,197,3018,1267,1,0,13767
9/5/2020,7,9275,198,2993,1050,19,0,13535
9/5/2020,8,9276,197,3162,964,127,0,13726
9/5/2020,9,9284,240,3835,765,213,0,14337
9/5/2020,10,9288,343,4067,620,233,0,14551
9/5/2020,11,9302,467,4041,834,227,0,14871
9/5/2020,12,9300,542,3402,1093,209,0,14546
9/5/2020,13,9306,724,3458,1113,194,0,14795
9/5/2020,14,9253,814,3458,954,178,6,14663
9/5/2020,15,9291,820,3434,1030,193,2,14770
9/5/2020,16,9294,826,3709,891,171,0,14891
9/5/2020,17,9295,758,3792,989,107,0,14941
9/5/2020,18,9281,734,3828,849,40,0,14732
9/5/2020,19,9283,556,3821,904,6,0,14570
9/5/2020,20,9284,303,4011,927,0,0,14525
9/5/2020,21,9293,270,4423,587,0,0,14573
9/5/2020,22,9310,581,4323,308,0,0,14522
9/5/2020,23,9327,532,3550,301,0,0,13710
9/5/2020,24,9346,337,3236,281,0,0,13200
9/6/2020,1,9352,246,3133,256,0,0,12987
9/6/2020,2,9355,247,3175,202,0,0,12979
9/6/2020,3,9350,248,3060,131,0,0,12789
9/6/2020,4,9340,241,3085,119,0,0,12785
9/6/2020,5,9333,212,3009,270,0,0,12824
9/6/2020,6,9338,199,2972,342,5,0,12856
9/6/2020,7,9344,199,2977,100,14,0,12634
9/6/2020,8,9352,198,3023,232,145,0,12950
9/6/2020,9,9356,197,3227,177,259,0,13216
9/6/2020,10,9350,196,3367,393,347,0,13653
9/6/2020,11,9358,195,3348,586,380,0,13867
9/6/2020,12,9370,194,3526,732,396,2,14220
9/6/2020,13,9376,193,3542,861,387,3,14362
9/6/2020,14,9372,199,3592,935,342,0,14440
9/6/2020,15,9377,264,3606,1271,322,0,14840
9/6/2020,16,9378,462,4180,1605,267,5,15897
9/6/2020,17,9371,681,4210,1875,137,2,16276
9/6/2020,18,9220,832,4233,2000,68,0,16353
9/6/2020,19,8848,868,4247,2350,6,0,16319
9/6/2020,20,8843,762,3991,2893,0,0,16489
9/6/2020,21,8826,733,3398,2977,0,1,15935
9/6/2020,22,8819,732,3349,2591,0,3,15494
9/6/2020,23,8811,494,3153,2841,0,0,15299
9/6/2020,24,8810,288,3150,2963,0,0,15211
9/7/2020,1,8817,199,3002,2945,0,6,14969
9/7/2020,2,8824,208,3100,2554,0,32,14718
9/7/2020,3,8826,199,2980,2673,0,49,14727
9/7/2020,4,8841,195,2891,2759,0,47,14733
9/7/2020,5,8854,196,2936,2273,0,47,14306
9/7/2020,6,8847,193,3039,2330,1,47,14457
9/7/2020,7,8838,195,2973,1563,2,47,13618
9/7/2020,8,8832,262,3088,2599,15,47,14843
9/7/2020,9,8824,405,3268,3621,58,53,16229
9/7/2020,10,8806,543,3368,3344,121,49,16231
9/7/2020,11,8810,757,3281,3027,159,47,16081
9/7/2020,12,8808,1199,3536,2752,161,47,16503
9/7/2020,13,8803,1476,3761,2763,87,47,16937
9/7/2020,14,8800,1619,3936,2727,78,47,17207
9/7/2020,15,8796,1674,3951,2741,81,47,17290
9/7/2020,16,8813,1677,4063,2322,103,47,17025
9/7/2020,17,8826,1637,4347,1790,64,47,16711
9/7/2020,18,8853,1658,4150,1413,21,47,16142
9/7/2020,19,8871,1582,3834,1019,4,47,15357
9/7/2020,20,8879,1587,4112,806,0,47,15431
9/7/2020,21,8889,1597,4096,674,0,47,15303
9/7/2020,22,8895,1100,4262,620,0,47,14924
9/7/2020,23,8902,993,3997,646,0,47,14585
9/7/2020,24,8901,532,3847,613,0,47,13940
9/8/2020,1,8905,271,3450,704,0,47,13377
9/8/2020,2,8914,219,3029,868,0,48,13078
9/8/2020,3,8904,294,3187,913,0,49,13347
9/8/2020,4,8906,503,3241,769,0,58,13477
9/8/2020,5,8895,796,3171,737,0,62,13661
9/8/2020,6,8891,1121,3405,611,2,50,14080
9/8/2020,7,8890,1473,3626,821,9,54,14873
9/8/2020,8,8886,1574,3762,878,53,61,15214
9/8/2020,9,8883,1918,3950,639,106,61,15557
9/8/2020,10,8884,2346,3912,661,103,63,15969
9/8/2020,11,8895,2268,3953,691,130,56,15993
9/8/2020,12,8898,2249,3913,680,171,49,15960
9/8/2020,13,8898,2337,4015,886,197,49,16382
9/8/2020,14,8901,2353,3988,939,194,47,16422
9/8/2020,15,8899,2496,3913,984,149,47,16488
9/8/2020,16,8902,2675,3782,1109,143,47,16658
9/8/2020,17,8891,2659,3974,1156,80,54,16814
9/8/2020,18,8883,2654,3979,1109,19,53,16697
9/8/2020,19,8880,2658,3966,963,3,47,16517
9/8/2020,20,8870,2526,4138,769,0,47,16350
9/8/2020,21,8866,2363,3819,712,0,47,15807
9/8/2020,22,8849,1629,3935,559,0,47,15019
9/8/2020,23,8864,1320,3843,477,0,47,14551
9/8/2020,24,8870,687,3779,464,0,47,13847
9/9/2020,1,8874,616,3696,398,0,47,13631
9/9/2020,2,8869,606,3535,345,0,47,13402
9/9/2020,3,8863,632,3589,298,0,47,13429
9/9/2020,4,8866,754,3390,303,0,47,13360
9/9/2020,5,8855,1081,3157,380,0,47,13520
9/9/2020,6,8851,1480,3213,476,2,55,14077
9/9/2020,7,8859,1764,3393,409,10,53,14488
9/9/2020,8,8855,1942,3753,522,41,7,15120
9/9/2020,9,8864,2321,3948,344,83,8,15568
9/9/2020,10,8870,2593,3863,259,110,0,15695
9/9/2020,11,8875,2751,3759,351,203,7,15946
9/9/2020,12,8873,2553,3527,304,227,9,15493
9/9/2020,13,8870,2458,4038,176,227,0,15769
9/9/2020,14,8875,2518,3938,144,234,4,15713
9/9/2020,15,8880,2813,3847,144,228,7,15919
9/9/2020,16,8880,3045,3931,246,177,0,16279
9/9/2020,17,8873,3260,4140,298,81,0,16652
9/9/2020,18,8877,3076,4115,295,24,0,16387
9/9/2020,19,8873,2895,4451,259,0,0,16478
9/9/2020,20,8867,2701,4374,307,0,0,16249
9/9/2020,21,8858,1896,4458,279,0,0,15491
9/9/2020,22,8869,1340,4097,228,0,10,14544
9/9/2020,23,8869,1176,3950,202,0,11,14208
9/9/2020,24,8862,813,3731,196,0,4,13606
9/10/2020,1,8865,463,3659,192,0,0,13179
9/10/2020,2,8862,413,3651,179,0,0,13105
9/10/2020,3,8850,509,3460,271,0,2,13092
9/10/2020,4,8850,799,3092,414,0,65,13220
9/10/2020,5,8850,1150,2991,485,0,70,13546
9/10/2020,6,8852,1453,3306,644,3,85,14343
9/10/2020,7,8851,1783,3675,704,4,112,15129
9/10/2020,8,8853,2018,3936,715,31,119,15672
9/10/2020,9,8859,2445,3896,601,87,131,16019
9/10/2020,10,8853,2315,3857,565,124,95,15809
9/10/2020,11,8850,2637,3928,628,122,83,16248
9/10/2020,12,8852,2484,4063,595,149,70,16213
9/10/2020,13,8856,2463,4305,710,141,52,16527
9/10/2020,14,8858,2520,4292,692,161,70,16593
9/10/2020,15,8863,2727,4280,655,119,54,16698
9/10/2020,16,8864,2811,4336,771,70,50,16902
9/10/2020,17,8860,2719,4390,909,34,0,16912
9/10/2020,18,8867,2311,4288,912,16,0,16394
9/10/2020,19,8869,2171,4137,871,2,0,16050
9/10/2020,20,8845,2013,4007,928,0,0,15793
9/10/2020,21,8848,1846,3785,1008,0,0,15487
9/10/2020,22,8852,1753,3546,1049,0,0,15200
9/10/2020,23,8850,1067,3421,897,0,0,14235
9/10/2020,24,8845,393,3749,638,0,76,13701
9/11/2020,1,8841,224,3656,697,0,73,13491
9/11/2020,2,8837,226,3323,707,0,72,13165
9/11/2020,3,8834,234,3431,834,0,72,13405
9/11/2020,4,8849,316,3320,990,0,80,13555
9/11/2020,5,8854,533,3061,1097,0,83,13628
9/11/2020,6,8850,819,3178,1091,2,84,14024
9/11/2020,7,8855,1057,3436,1228,6,75,14657
9/11/2020,8,8849,1046,3825,1061,49,69,14899
9/11/2020,9,8829,1192,3910,1090,148,19,15188
9/11/2020,10,8827,1250,3971,965,264,0,15277
9/11/2020,11,8819,1713,4102,550,313,5,15502
9/11/2020,12,8830,1546,3933,323,334,8,14974
9/11/2020,13,8831,1433,3798,244,382,18,14706
9/11/2020,14,8825,1503,3656,201,365,11,14561
9/11/2020,15,8829,1058,3847,185,333,3,14255
9/11/2020,16,8829,934,4199,250,275,0,14487
9/11/2020,17,8827,824,4527,322,191,0,14691
9/11/2020,18,8829,867,4770,323,69,8,14866
9/11/2020,19,8830,795,4507,384,5,3,14524
9/11/2020,20,8833,646,4443,593,0,0,14515
9/11/2020,21,8841,487,4274,851,0,0,14453
9/11/2020,22,8845,395,3880,1148,0,0,14268
9/11/2020,23,8850,230,3466,1380,0,0,13926
9/11/2020,24,8848,200,3334,1150,0,0,13532
9/12/2020,1,8850,199,3241,1027,0,0,13317
9/12/2020,2,8852,199,3247,1007,0,0,13305
9/12/2020,3,8857,199,3075,1484,0,0,13615
9/12/2020,4,8860,199,3046,1415,0,0,13520
9/12/2020,5,8859,203,3223,1518,0,0,13803
9/12/2020,6,8857,204,3197,1431,2,1,13692
9/12/2020,7,8854,253,3130,1669,27,1,13934
9/12/2020,8,8848,289,3281,1278,118,6,13820
9/12/2020,9,8845,374,3176,1245,236,1,13877
9/12/2020,10,8839,624,3230,1157,304,1,14155
9/12/2020,11,8826,797,3474,867,350,4,14318
9/12/2020,12,8830,814,3682,617,361,0,14304
9/12/2020,13,8819,812,3636,535,362,0,14164
9/12/2020,14,8831,847,3751,497,283,0,14209
9/12/2020,15,8837,905,3927,661,219,0,14549
9/12/2020,16,8838,1070,4171,756,163,0,14998
9/12/2020,17,8836,1195,4302,896,87,0,15316
9/12/2020,18,8835,1198,4152,1205,25,0,15415
9/12/2020,19,8835,1193,4333,1134,2,2,15499
9/12/2020,20,8838,1130,4072,1556,0,2,15598
9/12/2020,21,8840,1005,3758,1724,0,0,15327
9/12/2020,22,8839,537,3345,2052,0,0,14773
9/12/2020,23,8840,233,3037,2079,0,0,14189
9/12/2020,24,8834,198,3114,2011,0,0,14157
9/13/2020,1,8841,197,3096,2081,0,0,14215
9/13/2020,2,8841,196,3115,1878,0,0,14030
9/13/2020,3,8835,196,3163,1615,0,0,13809
9/13/2020,4,8828,196,3161,1533,0,0,13718
9/13/2020,5,8832,196,3093,1674,0,0,13795
9/13/2020,6,8825,196,3230,1801,0,0,14052
9/13/2020,7,8829,196,3437,2012,1,0,14475
9/13/2020,8,8826,197,3408,2294,6,0,14731
9/13/2020,9,8811,271,3383,2506,21,0,14992
9/13/2020,10,8653,393,3373,2595,39,0,15053
9/13/2020,11,8607,469,3225,2988,111,0,15400
9/13/2020,12,8765,730,3577,2542,142,0,15756
9/13/2020,13,8780,883,3478,2864,136,0,16141
9/13/2020,14,8777,991,3535,2917,201,0,16421
9/13/2020,15,8763,1127,3581,2654,181,0,16306
9/13/2020,16,8763,1147,3833,2554,167,0,16464
9/13/2020,17,8774,1161,4259,2306,94,0,16594
9/13/2020,18,8811,1149,4186,1854,42,0,16042
9/13/2020,19,8839,1139,4219,1720,5,0,15922
9/13/2020,20,8841,1137,4026,1723,0,3,15730
9/13/2020,21,8837,1140,3910,1800,0,2,15689
9/13/2020,22,8839,815,3590,1738,0,0,14982
9/13/2020,23,8850,494,3342,1836,0,0,14522
9/13/2020,24,8853,232,3181,1763,0,0,14029
9/14/2020,1,8859,202,3210,1209,0,0,13480
9/14/2020,2,8853,213,3172,939,0,6,13183
9/14/2020,3,8854,215,3107,953,0,10,13139
9/14/2020,4,8852,245,3162,1037,0,10,13306
9/14/2020,5,8954,318,3055,735,0,17,13079
9/14/2020,6,9021,503,3527,1017,1,27,14096
9/14/2020,7,9022,976,3802,966,16,30,14812
9/14/2020,8,9021,1391,3844,735,102,30,15123
9/14/2020,9,9028,1599,3737,428,207,30,15029
9/14/2020,10,9036,1581,3670,438,279,30,15034
9/14/2020,11,9024,1422,3231,474,325,30,14506
9/14/2020,12,9026,1445,3400,400,366,30,14667
9/14/2020,13,9018,1467,3748,393,384,33,15043
9/14/2020,14,8989,1416,3875,403,368,31,15082
9/14/2020,15,8984,1523,3674,340,349,31,14901
9/14/2020,16,8982,1244,3807,329,256,31,14649
9/14/2020,17,8980,1187,4264,372,139,33,14975
9/14/2020,18,8957,1201,4254,362,45,31,14850
9/14/2020,19,8934,1195,4069,459,1,31,14689
9/14/2020,20,8926,1189,4051,514,0,31,14711
9/14/2020,21,8937,1065,3996,470,0,31,14499
9/14/2020,22,8935,928,3730,560,0,31,14184
9/14/2020,23,8966,606,3397,633,0,18,13620
9/14/2020,24,8980,414,3069,653,0,16,13132
9/15/2020,1,8985,237,3041,657,0,15,12935
9/15/2020,2,8984,288,3088,580,0,14,12954
9/15/2020,3,8990,376,3108,462,0,14,12950
9/15/2020,4,8994,398,3032,443,0,15,12882
9/15/2020,5,8996,451,3212,465,0,17,13141
9/15/2020,6,8991,584,3385,483,2,27,13472
9/15/2020,7,8982,585,3864,682,17,31,14161
9/15/2020,8,8973,610,4297,701,79,31,14691
9/15/2020,9,8958,755,4127,664,168,31,14703
9/15/2020,10,8961,815,3950,608,257,31,14622
9/15/2020,11,8952,1018,3457,926,309,31,14693
9/15/2020,12,8939,1117,3028,1057,336,32,14509
9/15/2020,13,8939,1079,3097,1555,335,31,15036
9/15/2020,14,8937,1051,3263,1647,302,32,15232
9/15/2020,15,8926,1052,3204,1810,266,32,15290
9/15/2020,16,8930,1061,3562,1758,192,32,15535
9/15/2020,17,8979,1040,3522,1902,112,32,15587
9/15/2020,18,9031,1041,3737,1811,34,32,15686
9/15/2020,19,9041,789,3780,2075,0,32,15717
9/15/2020,20,9041,627,3879,2263,0,32,15842
9/15/2020,21,9044,473,3683,2515,0,32,15747
9/15/2020,22,9043,216,3078,2465,0,31,14833
9/15/2020,23,9036,195,2983,2275,0,20,14509
9/15/2020,24,9037,195,2975,1949,0,18,14174
9/16/2020,1,9037,193,2964,1474,0,17,13685
9/16/2020,2,9043,194,2910,1225,0,17,13389
9/16/2020,3,9051,192,2907,1150,0,18,13318
9/16/2020,4,9050,191,2836,1033,0,17,13127
9/16/2020,5,9056,193,2940,1173,0,37,13399
9/16/2020,6,9062,194,3106,1646,2,45,14055
9/16/2020,7,9063,199,3333,2310,14,53,14972
9/16/2020,8,9053,296,3614,2181,76,54,15274
9/16/2020,9,9050,429,3525,2390,179,56,15629
9/16/2020,10,9047,607,3458,2350,250,58,15770
9/16/2020,11,9049,906,3097,2385,304,59,15800
9/16/2020,12,9122,1037,3271,2344,360,58,16192
9/16/2020,13,9125,1039,3298,2372,363,55,16252
9/16/2020,14,9130,1041,3304,2414,353,57,16299
9/16/2020,15,9153,1039,3644,2270,285,56,16447
9/16/2020,16,9151,1040,3693,2045,218,56,16203
9/16/2020,17,9154,1044,3596,2225,120,55,16194
9/16/2020,18,9148,1042,3800,1693,36,49,15768
9/16/2020,19,9141,1093,3668,2163,2,39,16106
9/16/2020,20,9135,712,3712,2082,0,48,15689
9/16/2020,21,9139,610,3726,2120,0,44,15639
9/16/2020,22,9149,482,3629,2176,0,32,15468
9/16/2020,23,9149,387,3372,1778,0,26,14712
9/16/2020,24,9149,295,3128,1686,0,15,14273
9/17/2020,1,9150,198,3116,1416,0,15,13895
9/17/2020,2,9155,199,2911,1293,0,15,13573
9/17/2020,3,9154,206,2871,1205,0,15,13451
9/17/2020,4,9192,209,2921,1268,0,16,13606
9/17/2020,5,9206,310,2958,1216,0,22,13712
9/17/2020,6,9225,543,3267,1095,0,27,14157
9/17/2020,7,9247,617,3974,1311,9,34,15192
9/17/2020,8,9264,700,4279,1043,80,33,15399
9/17/2020,9,9274,1029,4372,820,188,33,15716
9/17/2020,10,9284,1196,4108,796,347,32,15763
9/17/2020,11,9282,1421,4044,720,378,32,15877
9/17/2020,12,9295,1733,4063,648,319,32,16090
9/17/2020,13,9292,1515,3967,825,335,32,15966
9/17/2020,14,9275,1487,3764,1071,325,32,15954
9/17/2020,15,9259,1490,3375,1344,327,32,15827
9/17/2020,16,9250,1537,3486,1613,273,34,16193
9/17/2020,17,9238,1668,4041,1748,167,35,16897
9/17/2020,18,9232,1673,4071,1827,50,32,16885
9/17/2020,19,9200,1618,3945,1926,0,32,16721
9/17/2020,20,9191,1086,4170,1911,0,32,16390
9/17/2020,21,9211,690,4099,2035,0,32,16067
9/17/2020,22,9241,488,3563,2026,0,32,15350
9/17/2020,23,9282,238,3224,1963,0,26,14733
9/17/2020,24,9297,168,3048,1819,0,17,14349
9/18/2020,1,9313,168,3003,1794,0,15,14293
9/18/2020,2,9317,169,2966,1601,0,14,14067
9/18/2020,3,9315,171,2932,1479,0,16,13913
9/18/2020,4,9302,172,2903,1729,0,16,14122
9/18/2020,5,9307,249,2968,1735,0,20,14279
9/18/2020,6,9304,331,3344,1710,2,25,14716
9/18/2020,7,9284,370,4224,1654,22,31,15585
9/18/2020,8,9276,410,4432,1282,125,31,15556
9/18/2020,9,9273,391,4233,1156,262,32,15347
9/18/2020,10,9265,392,3764,1375,348,31,15175
9/18/2020,11,9258,516,3604,1370,378,31,15157
9/18/2020,12,9260,845,3557,1480,373,32,15547
9/18/2020,13,9267,1038,3584,1806,335,33,16063
9/18/2020,14,9265,1225,3458,1567,349,31,15895
9/18/2020,15,9265,1318,3371,1526,331,32,15843
9/18/2020,16,9264,1325,3593,1267,283,32,15764
9/18/2020,17,9263,1164,3852,1696,168,36,16179
9/18/2020,18,9272,1113,4005,1731,51,33,16205
9/18/2020,19,9276,1160,4405,1422,2,32,16297
9/18/2020,20,9273,1006,4533,1521,0,32,16365
9/18/2020,21,9269,669,3941,1515,0,32,15426
9/18/2020,22,9279,269,3751,1480,0,32,14811
9/18/2020,23,9284,125,3449,1380,0,18,14256
9/18/2020,24,9284,113,3164,1009,0,5,13575
9/19/2020,1,9288,113,3082,987,0,0,13470
9/19/2020,2,9288,114,3099,903,0,0,13404
9/19/2020,3,9284,114,3122,802,0,0,13322
9/19/2020,4,9280,117,3232,733,0,0,13362
9/19/2020,5,9284,116,3232,615,0,0,13247
9/19/2020,6,9283,229,3685,551,2,0,13750
9/19/2020,7,9281,211,3631,658,23,0,13804
9/19/2020,8,9274,184,3710,558,145,0,13871
9/19/2020,9,9271,198,3940,298,287,0,13994
9/19/2020,10,9268,407,3967,211,364,0,14217
9/19/2020,11,9267,596,3926,145,402,0,14336
9/19/2020,12,9261,821,3768,112,386,0,14348
9/19/2020,13,9257,1033,3847,115,352,0,14604
9/19/2020,14,9252,1205,3563,116,146,0,14282
9/19/2020,15,9256,1274,3529,98,84,0,14241
9/19/2020,16,9251,1279,3641,130,208,0,14509
9/19/2020,17,9247,1376,4144,216,177,0,15160
9/19/2020,18,9236,1476,4225,213,55,0,15205
9/19/2020,19,9227,1540,4430,249,1,0,15447
9/19/2020,20,9228,1555,4443,335,0,0,15561
9/19/2020,21,9229,1304,4212,477,0,0,15222
9/19/2020,22,9225,843,3757,642,0,0,14467
9/19/2020,23,9240,462,3369,632,0,0,13703
9/19/2020,24,9247,356,3379,674,0,0,13656
9/20/2020,1,9252,151,3674,611,0,0,13688
9/20/2020,2,9251,119,3482,639,0,0,13491
9/20/2020,3,9252,162,3361,658,0,0,13433
9/20/2020,4,9256,140,3065,801,0,0,13262
9/20/2020,5,9255,113,2895,695,0,0,12958
9/20/2020,6,9258,113,2893,875,2,0,13141
9/20/2020,7,9256,112,2821,1084,14,0,13287
9/20/2020,8,9243,113,3133,1138,105,0,13732
9/20/2020,9,9298,151,3404,685,249,0,13787
9/20/2020,10,9183,205,3339,779,323,0,13829
9/20/2020,11,9160,215,3317,776,342,0,13810
9/20/2020,12,9229,336,3278,837,341,0,14021
9/20/2020,13,9310,420,3096,872,336,0,14034
9/20/2020,14,9277,527,3096,802,326,0,14028
9/20/2020,15,9306,646,3173,802,289,0,14216
9/20/2020,16,9300,653,3481,710,252,0,14396
9/20/2020,17,9295,686,4213,851,174,0,15219
9/20/2020,18,9294,690,4510,745,51,0,15290
9/20/2020,19,9300,803,4936,708,0,0,15747
9/20/2020,20,9302,858,4537,976,0,0,15673
9/20/2020,21,9299,582,3908,1273,0,0,15062
9/20/2020,22,9310,190,3598,1649,0,0,14747
9/20/2020,23,9308,113,3099,1927,0,0,14447
9/20/2020,24,9318,114,2828,1703,0,1,13964
9/21/2020,1,9323,114,2803,1886,0,9,14135
9/21/2020,2,9331,113,2809,1807,0,10,14070
9/21/2020,3,9339,115,3058,1825,0,15,14352
9/21/2020,4,9332,198,3107,1780,0,16,14433
9/21/2020,5,9321,314,3056,1518,0,17,14226
9/21/2020,6,9321,476,3225,1584,1,25,14632
9/21/2020,7,9317,538,3508,1760,21,29,15173
9/21/2020,8,9322,626,3706,1375,128,30,15187
9/21/2020,9,9322,774,4024,860,260,31,15271
9/21/2020,10,9324,925,4043,732,361,31,15416
9/21/2020,11,9324,1012,3783,771,405,30,15325
9/21/2020,12,9307,1042,3633,790,408,30,15210
9/21/2020,13,9317,1121,3654,712,409,31,15244
9/21/2020,14,9317,1200,3601,592,408,32,15150
9/21/2020,15,9323,1259,3465,463,369,29,14908
9/21/2020,16,9336,1266,3641,431,279,48,15001
9/21/2020,17,9327,1296,4080,521,156,80,15460
9/21/2020,18,9317,1151,4254,582,38,86,15428
9/21/2020,19,9316,1118,4276,744,0,83,15537
9/21/2020,20,9313,934,4124,987,0,82,15440
9/21/2020,21,9320,727,3897,1163,0,80,15187
9/21/2020,22,9319,605,3588,1233,0,80,14825
9/21/2020,23,9319,444,3024,1313,0,76,14176
9/21/2020,24,9331,176,3103,1305,0,29,13944
9/22/2020,1,9339,139,3186,1234,0,15,13913
9/22/2020,2,9348,159,3395,1189,0,14,14105
9/22/2020,3,9346,260,3495,1176,0,15,14292
9/22/2020,4,9352,533,3234,1067,0,14,14200
9/22/2020,5,9353,835,3040,566,0,16,13810
9/22/2020,6,9356,965,3378,738,2,28,14467
9/22/2020,7,9354,967,3940,683,15,29,14988
9/22/2020,8,9357,1075,4205,647,97,29,15410
9/22/2020,9,9348,1045,4099,480,209,30,15211
9/22/2020,10,9330,1146,3984,255,292,29,15036
9/22/2020,11,9324,1426,4083,229,362,29,15453
9/22/2020,12,9330,1155,3803,342,402,30,15062
9/22/2020,13,9176,1092,3800,375,395,32,14870
9/22/2020,14,9175,647,4061,458,362,52,14755
9/22/2020,15,9318,518,4058,555,303,80,14832
9/22/2020,16,9323,572,3799,731,219,82,14726
9/22/2020,17,9316,666,4180,869,118,134,15283
9/22/2020,18,9321,778,4232,1012,24,106,15473
9/22/2020,19,9325,730,4164,1262,0,84,15565
9/22/2020,20,9328,686,3975,1399,0,85,15473
9/22/2020,21,9325,675,3659,1452,0,82,15193
9/22/2020,22,9324,419,3432,1427,0,84,14686
9/22/2020,23,9338,344,3300,1433,0,30,14445
9/22/2020,24,9350,206,3020,1368,0,14,13958
9/23/2020,1,9356,116,2802,1647,0,13,13934
9/23/2020,2,9340,128,2882,1298,0,14,13662
9/23/2020,3,9331,130,2842,1224,0,14,13541
9/23/2020,4,9348,150,2843,891,0,15,13247
9/23/2020,5,9346,178,3050,646,0,16,13236
9/23/2020,6,9342,229,3465,627,3,42,13708
9/23/2020,7,9351,529,4136,391,16,93,14516
9/23/2020,8,9342,519,4185,271,107,149,14573
9/23/2020,9,9336,553,4051,178,229,138,14485
9/23/2020,10,9334,728,4231,99,345,189,14926
9/23/2020,11,9337,860,3945,172,402,110,14826
9/23/2020,12,9332,1006,3780,331,389,87,14925
9/23/2020,13,9330,1241,3733,619,392,87,15402
9/23/2020,14,9328,1370,3581,766,376,87,15508
9/23/2020,15,9323,1344,3623,621,324,88,15323
9/23/2020,16,9321,1344,3733,794,246,88,15526
9/23/2020,17,9320,1382,4152,869,140,87,15950
9/23/2020,18,9321,1473,4165,797,31,87,15874
9/23/2020,19,9321,1429,4120,751,0,87,15708
9/23/2020,20,9320,1459,4271,698,0,88,15836
9/23/2020,21,9322,1290,3941,678,0,88,15319
9/23/2020,22,9335,940,4010,637,0,42,14964
9/23/2020,23,9344,707,3781,592,0,21,14445
9/23/2020,24,9349,285,3499,710,0,16,13859
9/24/2020,1,9349,155,3287,685,0,16,13492
9/24/2020,2,9350,106,3188,564,0,15,13223
9/24/2020,3,9352,110,3159,529,0,15,13165
9/24/2020,4,9348,142,3305,446,0,15,13256
9/24/2020,5,9350,203,3180,377,0,17,13127
9/24/2020,6,9355,398,3377,467,2,48,13647
9/24/2020,7,9364,670,4014,684,12,81,14825
9/24/2020,8,9369,739,3868,790,81,86,14933
9/24/2020,9,9356,750,3875,599,188,87,14855
9/24/2020,10,9356,871,4172,440,291,86,15216
9/24/2020,11,9353,1141,4191,385,297,99,15466
9/24/2020,12,9342,1281,3914,581,345,90,15553
9/24/2020,13,9321,1372,3649,547,405,86,15380
9/24/2020,14,9317,1579,3958,805,361,86,16106
9/24/2020,15,9317,1731,4047,821,272,86,16274
9/24/2020,16,9317,1744,4064,757,200,86,16168
9/24/2020,17,9325,1747,4172,614,124,87,16069
9/24/2020,18,9335,1858,4541,487,26,88,16335
9/24/2020,19,9332,1756,4402,548,0,87,16125
9/24/2020,20,9334,1673,4125,597,0,86,15815
9/24/2020,21,9332,1219,4097,692,0,82,15422
9/24/2020,22,9328,809,4057,736,0,40,14970
9/24/2020,23,9342,715,3686,802,0,24,14569
9/24/2020,24,9349,201,3658,714,0,17,13939
9/25/2020,1,9359,179,4004,518,0,17,14077
9/25/2020,2,9357,210,3773,479,0,17,13836
9/25/2020,3,9354,279,3673,437,0,17,13760
9/25/2020,4,9351,375,3555,457,0,17,13755
9/25/2020,5,9350,469,3347,412,0,23,13601
9/25/2020,6,9345,699,3538,341,2,49,13974
9/25/2020,7,9345,1035,3921,340,10,83,14734
9/25/2020,8,9337,1173,4227,328,83,84,15232
9/25/2020,9,9328,1353,4200,255,190,83,15409
9/25/2020,10,9327,1394,4055,212,249,84,15321
9/25/2020,11,9323,1325,3886,224,329,85,15172
9/25/2020,12,9321,1431,3825,276,403,85,15341
9/25/2020,13,9318,1507,3555,285,405,88,15158
9/25/2020,14,9318,1598,3844,323,382,87,15552
9/25/2020,15,9317,1680,3730,321,316,86,15450
9/25/2020,16,9320,1811,4102,389,229,87,15938
9/25/2020,17,9310,1941,4347,468,118,88,16272
9/25/2020,18,9312,1701,4442,476,28,58,16017
9/25/2020,19,9306,1642,4394,543,0,32,15917
9/25/2020,20,9302,1478,4215,481,0,32,15508
9/25/2020,21,9210,834,3937,729,0,32,14742
9/25/2020,22,8651,453,3709,1610,0,32,14455
9/25/2020,23,8549,178,3550,1759,0,21,14057
9/25/2020,24,8556,107,3160,2140,0,5,13968
9/26/2020,1,8560,109,3101,1834,0,0,13604
9/26/2020,2,8558,108,2750,2015,0,0,13431
9/26/2020,3,8558,108,2805,1786,0,0,13257
9/26/2020,4,8557,108,2836,1832,0,0,13333
9/26/2020,5,8552,108,3219,1666,0,0,13545
9/26/2020,6,8548,108,3493,1596,2,0,13747
9/26/2020,7,8548,113,3540,1703,10,22,13936
9/26/2020,8,8545,123,3311,1705,93,52,13829
9/26/2020,9,8543,270,3860,1318,215,53,14259
9/26/2020,10,8543,487,3998,1365,311,54,14758
9/26/2020,11,8544,751,3858,1713,382,52,15300
9/26/2020,12,8539,876,3775,2023,373,53,15639
9/26/2020,13,8541,1040,3619,2182,378,53,15813
9/26/2020,14,8538,1073,3630,2207,371,53,15872
9/26/2020,15,8537,1122,3684,2043,287,53,15726
9/26/2020,16,8542,1256,3726,2082,213,56,15875
9/26/2020,17,8538,1257,3828,2077,90,55,15845
9/26/2020,18,8547,1256,3859,2036,19,56,15773
9/26/2020,19,8550,1268,4192,2051,0,55,16116
9/26/2020,20,8545,1297,4243,2218,0,55,16358
9/26/2020,21,8528,1278,3744,2684,0,55,16289
9/26/2020,22,8526,631,3219,2646,0,54,15076
9/26/2020,23,8531,230,3142,2792,0,7,14702
9/26/2020,24,8538,156,3069,2696,0,0,14459
9/27/2020,1,8542,157,2745,2654,0,0,14098
9/27/2020,2,8543,157,2726,2592,0,0,14018
9/27/2020,3,8544,157,2785,2271,0,0,13757
9/27/2020,4,8542,157,2782,2204,0,0,13685
9/27/2020,5,8544,159,2836,2434,0,0,13973
9/27/2020,6,8543,163,2862,2617,1,0,14186
9/27/2020,7,8540,250,2829,2815,2,0,14436
9/27/2020,8,8532,271,2857,3277,46,0,14983
9/27/2020,9,8536,550,2917,3422,130,0,15555
9/27/2020,10,8539,918,2915,3210,172,0,15754
9/27/2020,11,8536,1142,3142,2992,225,4,16041
9/27/2020,12,8537,1171,3494,3025,281,20,16528
9/27/2020,13,8527,1245,3757,2816,347,50,16742
9/27/2020,14,8529,1468,4029,2477,361,55,16919
9/27/2020,15,8533,1558,4219,2105,295,55,16765
9/27/2020,16,8534,1660,4424,1888,208,56,16770
9/27/2020,17,8535,1793,4496,1804,100,57,16785
9/27/2020,18,8529,1600,4580,1337,18,57,16121
9/27/2020,19,8533,1824,4811,1070,0,75,16313
9/27/2020,20,8536,1559,4628,1093,0,88,15904
9/27/2020,21,8543,1667,4491,876,0,55,15632
9/27/2020,22,8545,1503,4230,990,0,51,15319
9/27/2020,23,8556,1299,3978,1093,0,52,14978
9/27/2020,24,8562,625,3610,1385,0,51,14233
9/28/2020,1,8566,365,3277,1476,0,49,13733
9/28/2020,2,8565,442,3396,1139,0,49,13591
9/28/2020,3,8563,658,3764,795,0,86,13866
9/28/2020,4,8561,950,3333,841,0,70,13755
9/28/2020,5,8560,1365,3154,706,0,66,13851
9/28/2020,6,8549,1434,3459,996,3,73,14514
9/28/2020,7,8542,1497,3837,1363,5,80,15324
9/28/2020,8,8542,1539,3916,1229,55,85,15366
9/28/2020,9,8536,1574,4066,1174,138,119,15607
9/28/2020,10,8541,1853,3963,1338,237,193,16125
9/28/2020,11,8550,2239,3976,1261,257,209,16492
9/28/2020,12,8544,2370,4224,1317,253,221,16929
9/28/2020,13,8545,2333,4462,1089,282,221,16932
9/28/2020,14,8541,2307,4073,1084,272,219,16496
9/28/2020,15,8546,2199,4000,1041,219,169,16174
9/28/2020,16,8544,2511,4423,1086,112,190,16866
9/28/2020,17,8550,2256,4496,1626,61,193,17182
9/28/2020,18,8544,2127,4126,1799,4,102,16702
9/28/2020,19,8544,2199,4624,1702,0,88,17157
9/28/2020,20,8537,2137,4432,1322,0,89,16517
9/28/2020,21,8541,2516,4258,1025,0,107,16447
9/28/2020,22,8543,1756,4111,1183,0,117,15710
9/28/2020,23,8542,1505,3626,1610,0,45,15328
9/28/2020,24,8542,601,3323,1879,0,20,14365
9/29/2020,1,8534,193,3237,1828,0,13,13805
9/29/2020,2,8529,164,3087,1736,0,12,13528
9/29/2020,3,8530,213,3087,1963,0,12,13805
9/29/2020,4,8600,327,3019,1958,0,15,13919
9/29/2020,5,8746,685,3069,1672,0,26,14198
9/29/2020,6,8748,1052,3298,1747,2,62,14909
9/29/2020,7,8747,1473,3937,1539,4,104,15804
9/29/2020,8,8751,1934,3694,1271,54,172,15876
9/29/2020,9,8750,1698,3742,1059,154,138,15541
9/29/2020,10,8863,1536,3732,959,219,90,15399
9/29/2020,11,8944,1467,3490,1082,219,82,15284
9/29/2020,12,8967,1458,3328,1258,219,82,15312
9/29/2020,13,9102,1354,3288,1256,187,83,15270
9/29/2020,14,9133,1536,3330,1209,138,84,15430
9/29/2020,15,9135,1335,3562,1209,134,84,15459
9/29/2020,16,9137,1414,3949,950,108,84,15642
9/29/2020,17,9138,1630,4418,683,37,110,16016
9/29/2020,18,9134,1694,4491,578,5,87,15989
9/29/2020,19,9133,1488,4275,597,0,83,15576
9/29/2020,20,9138,1307,4066,734,0,82,15327
9/29/2020,21,9146,1404,3943,677,0,85,15255
9/29/2020,22,9149,1152,3880,791,0,83,15055
9/29/2020,23,9193,449,3917,858,0,81,14498
9/29/2020,24,9320,200,3272,958,0,67,13817
9/30/2020,1,9314,187,3292,818,0,25,13636
9/30/2020,2,9304,241,3220,637,0,14,13416
9/30/2020,3,9312,173,3134,823,0,14,13456
9/30/2020,4,9323,159,2982,896,0,14,13374
9/30/2020,5,9329,159,3082,1232,0,18,13820
9/30/2020,6,9317,159,3276,1331,1,27,14111
9/30/2020,7,9329,163,3405,1940,3,31,14871
9/30/2020,8,9334,168,3448,2380,27,31,15388
9/30/2020,9,9359,325,3779,2706,91,31,16291
9/30/2020,10,9360,431,3349,2801,106,31,16078
9/30/2020,11,9353,844,3423,2723,169,31,16543
9/30/2020,12,9357,1017,3341,2878,119,31,16743
9/30/2020,13,9229,1111,3395,2418,139,32,16324
9/30/2020,14,9328,1151,3284,2388,156,31,16338
9/30/2020,15,9370,1346,3359,2370,114,32,16591
9/30/2020,16,9366,1418,3653,2651,71,31,17190
9/30/2020,17,9373,1505,3829,2841,49,31,17628
9/30/2020,18,9369,1499,3921,2475,10,31,17305
9/30/2020,19,9380,1495,3775,2525,0,31,17206
9/30/2020,20,9395,1493,3636,2274,0,31,16829
9/30/2020,21,9402,595,3408,2793,0,32,16230
9/30/2020,22,8977,454,3522,2176,0,31,15160
9/30/2020,23,8678,279,3301,2493,0,20,14771
9/30/2020,24,8687,164,3120,2206,0,17,14194
10/1/2020,1,8688,165,2885,1734,0,17,13489
10/1/2020,2,8693,166,2954,1579,0,16,13408
10/1/2020,3,8690,236,3003,1296,0,16,13241
10/1/2020,4,8693,396,2964,1403,0,17,13473
10/1/2020,5,8687,538,3132,1303,0,19,13679
10/1/2020,6,8688,602,3247,1732,2,30,14301
10/1/2020,7,8690,768,3867,1874,10,31,15240
10/1/2020,8,8687,1035,3870,1737,82,31,15442
10/1/2020,9,8688,1197,3879,1396,173,31,15364
10/1/2020,10,8695,1315,3822,1393,252,32,15509
10/1/2020,11,8695,1452,3558,1740,283,51,15779
10/1/2020,12,8695,1565,3457,1701,234,80,15732
10/1/2020,13,8697,1597,3484,1530,239,82,15629
10/1/2020,14,8695,1527,3620,1370,208,81,15501
10/1/2020,15,8695,1530,3717,1445,107,82,15576
10/1/2020,16,8688,1626,3824,1323,119,82,15662
10/1/2020,17,8691,1566,4104,1153,80,83,15677
10/1/2020,18,8695,1910,4651,704,15,105,16080
10/1/2020,19,8692,2057,4826,427,0,185,16187
10/1/2020,20,8680,1804,4609,427,0,140,15660
10/1/2020,21,8683,1791,4464,625,0,92,15655
10/1/2020,22,8691,1608,4086,799,0,84,15268
10/1/2020,23,8694,1150,3635,851,0,75,14405
10/1/2020,24,8699,555,3556,1060,0,73,13943
10/2/2020,1,8700,279,3281,892,0,76,13228
10/2/2020,2,8700,190,3232,903,0,77,13102
10/2/2020,3,8702,307,3173,1127,0,30,13339
10/2/2020,4,8697,480,3132,959,0,16,13284
10/2/2020,5,8697,720,3296,1054,0,18,13785
10/2/2020,6,8699,938,3671,1323,1,26,14658
10/2/2020,7,8703,1449,4126,1215,3,38,15534
10/2/2020,8,8697,1588,4103,1166,56,72,15682
10/2/2020,9,8685,1552,4054,993,139,125,15548
10/2/2020,10,8693,1457,3900,931,197,211,15389
10/2/2020,11,8693,1421,4004,821,225,165,15329
10/2/2020,12,8693,1497,3976,808,252,88,15314
10/2/2020,13,8694,1561,3828,962,234,95,15374
10/2/2020,14,8691,1509,3692,866,237,101,15096
10/2/2020,15,8685,1614,3913,1088,170,148,15618
10/2/2020,16,8677,1584,4174,1060,122,160,15777
10/2/2020,17,8689,1591,4303,909,86,197,15775
10/2/2020,18,8690,1727,4555,596,16,172,15756
10/2/2020,19,8688,1818,4541,472,0,112,15631
10/2/2020,20,8691,1701,4430,442,0,109,15373
10/2/2020,21,8696,1446,4371,325,0,162,15000
10/2/2020,22,8697,1222,4152,238,0,131,14440
10/2/2020,23,8692,1187,3927,204,0,66,14076
10/2/2020,24,8624,994,3598,121,0,73,13410
10/3/2020,1,8398,1135,3848,144,0,21,13546
10/3/2020,2,8392,1259,3610,162,0,0,13423
10/3/2020,3,8390,1260,3637,164,0,0,13451
10/3/2020,4,8392,1264,3664,114,0,0,13434
10/3/2020,5,8395,1263,3840,139,0,0,13637
10/3/2020,6,8510,1190,3737,139,1,0,13577
10/3/2020,7,8606,1198,3935,173,5,0,13917
10/3/2020,8,8836,1060,4062,188,63,0,14209
10/3/2020,9,9049,959,4019,213,167,0,14407
10/3/2020,10,9099,1081,4052,351,250,0,14833
10/3/2020,11,9100,1047,4033,351,253,0,14784
10/3/2020,12,9107,894,4306,376,237,0,14920
10/3/2020,13,9192,1000,4115,472,204,0,14983
10/3/2020,14,9228,1230,4146,451,238,0,15293
10/3/2020,15,9276,1316,4116,425,202,0,15335
10/3/2020,16,9275,1702,4392,295,122,0,15786
10/3/2020,17,9273,2014,4571,223,73,0,16154
10/3/2020,18,9272,1874,4658,205,12,0,16021
10/3/2020,19,9271,1850,4559,160,0,0,15840
10/3/2020,20,9266,1769,4313,197,0,0,15545
10/3/2020,21,9277,1788,4472,157,0,0,15694
10/3/2020,22,9280,1696,4086,140,0,0,15202
10/3/2020,23,9289,1383,3593,125,0,0,14390
10/3/2020,24,9404,879,3590,116,0,0,13989
10/4/2020,1,9411,423,3658,266,0,0,13758
10/4/2020,2,9411,273,3617,257,0,0,13558
10/4/2020,3,9417,180,3576,233,0,0,13406
10/4/2020,4,9415,190,3474,460,0,0,13539
10/4/2020,5,9402,272,3542,369,0,0,13585
10/4/2020,6,9411,495,3536,384,0,0,13826
10/4/2020,7,9433,696,3646,387,7,0,14169
10/4/2020,8,9444,788,3746,760,41,0,14779
10/4/2020,9,9441,778,3851,709,104,0,14883
10/4/2020,10,9446,805,3979,732,154,0,15116
10/4/2020,11,9446,1220,4106,565,160,0,15497
10/4/2020,12,9451,1495,4059,413,137,0,15555
10/4/2020,13,9450,1567,3848,516,143,0,15524
10/4/2020,14,9449,1249,3870,573,169,3,15313
10/4/2020,15,9454,1349,4067,453,146,2,15471
10/4/2020,16,9467,1487,4372,475,78,0,15879
10/4/2020,17,9466,1559,4693,507,13,0,16238
10/4/2020,18,9467,1417,4762,513,3,0,16162
10/4/2020,19,9450,1441,4885,540,0,0,16316
10/4/2020,20,9440,1570,4349,634,0,0,15993
10/4/2020,21,9441,1289,3881,688,0,0,15299
10/4/2020,22,9444,1139,3736,432,0,0,14751
10/4/2020,23,9467,974,3596,614,0,0,14651
10/4/2020,24,9468,341,3524,743,0,0,14076
10/5/2020,1,9481,236,3358,594,0,0,13669
10/5/2020,2,9485,352,3232,657,0,1,13727
10/5/2020,3,9475,490,3153,560,0,10,13688
10/5/2020,4,9481,608,3101,666,0,12,13868
10/5/2020,5,9481,787,3137,447,0,17,13869
10/5/2020,6,9482,1020,3529,602,1,24,14658
10/5/2020,7,9479,1453,4107,637,5,32,15713
10/5/2020,8,9476,1585,4310,469,50,31,15921
10/5/2020,9,9482,1845,4124,296,176,31,15954
10/5/2020,10,9482,2181,4092,250,274,31,16310
10/5/2020,11,9494,2076,4008,261,343,31,16213
10/5/2020,12,9502,1846,3944,361,332,26,16011
10/5/2020,13,9500,1790,3862,520,264,26,15962
10/5/2020,14,9501,1701,3721,715,244,26,15908
10/5/2020,15,9496,1687,3583,763,287,26,15842
10/5/2020,16,9492,1609,3689,860,207,26,15883
10/5/2020,17,9493,1521,4121,1239,110,27,16511
10/5/2020,18,9486,1418,4239,1459,19,30,16651
10/5/2020,19,9488,1326,4393,1824,0,31,17062
10/5/2020,20,9484,1320,4043,2064,0,31,16942
10/5/2020,21,9483,1156,3898,2151,0,30,16718
10/5/2020,22,9487,388,3557,2276,0,27,15735
10/5/2020,23,9488,198,3407,1752,0,21,14866
10/5/2020,24,9492,199,3343,1713,0,13,14760
10/6/2020,1,9491,198,3270,1355,0,10,14324
10/6/2020,2,9489,196,3248,1155,0,11,14099
10/6/2020,3,9493,198,3247,1018,0,11,13967
10/6/2020,4,9492,199,3209,1106,0,11,14017
10/6/2020,5,9495,197,3190,1426,0,16,14324
10/6/2020,6,9503,198,3351,2378,2,20,15452
10/6/2020,7,9504,198,3582,3343,7,26,16660
10/6/2020,8,9499,197,3564,3183,63,26,16532
10/6/2020,9,9495,198,3754,3137,133,26,16743
10/6/2020,10,9486,198,3714,2902,244,26,16570
10/6/2020,11,9473,203,3728,2872,252,29,16557
10/6/2020,12,9475,366,3779,2678,248,30,16576
10/6/2020,13,9474,495,3666,2287,318,31,16271
10/6/2020,14,9475,445,3749,2101,310,31,16111
10/6/2020,15,9472,460,3741,2288,260,31,16252
10/6/2020,16,9474,536,3844,2558,163,31,16606
10/6/2020,17,9478,588,4370,2525,67,29,17057
10/6/2020,18,9475,557,4337,2271,9,31,16680
10/6/2020,19,9473,541,4245,2270,0,31,16560
10/6/2020,20,9477,559,4281,2455,0,31,16803
10/6/2020,21,9471,377,3946,2460,0,31,16285
10/6/2020,22,9460,227,3534,2011,0,31,15263
10/6/2020,23,9468,226,3262,1318,0,23,14297
10/6/2020,24,9467,224,3443,715,0,15,13864
10/7/2020,1,9303,200,3212,882,0,15,13612
10/7/2020,2,8975,198,3325,926,0,16,13440
10/7/2020,3,8941,198,3312,745,0,15,13211
10/7/2020,4,8944,198,3224,1001,0,15,13382
10/7/2020,5,8941,194,3186,1228,0,21,13570
10/7/2020,6,9195,198,3298,1844,0,28,14563
10/7/2020,7,9459,202,3451,2840,1,28,15981
10/7/2020,8,9452,201,3543,3672,6,28,16902
10/7/2020,9,9457,270,3538,3882,25,32,17204
10/7/2020,10,9460,299,3624,3549,128,31,17091
10/7/2020,11,9449,406,3595,3325,219,31,17025
10/7/2020,12,9453,559,3635,2952,234,31,16864
10/7/2020,13,9438,766,3645,2593,307,31,16780
10/7/2020,14,9463,906,3652,2324,263,31,16639
10/7/2020,15,9472,1048,3726,1819,268,32,16365
10/7/2020,16,9480,1236,3939,1875,240,33,16803
10/7/2020,17,9475,1237,4002,2536,115,32,17397
10/7/2020,18,9481,1145,4320,2508,18,32,17504
10/7/2020,19,9480,1118,4195,2741,0,32,17566
10/7/2020,20,9475,999,4392,2515,0,32,17413
10/7/2020,21,9475,746,4185,2482,0,32,16920
10/7/2020,22,9481,471,3978,2243,0,32,16205
10/7/2020,23,9484,231,3709,1284,0,22,14730
10/7/2020,24,9413,204,3569,374,0,17,13577
10/8/2020,1,9089,205,3427,564,0,16,13301
10/8/2020,2,8929,205,3418,649,0,16,13217
10/8/2020,3,8926,205,3465,606,0,16,13218
10/8/2020,4,8924,282,3458,723,0,17,13404
10/8/2020,5,8928,377,3722,817,0,20,13864
10/8/2020,6,9201,479,4241,749,2,27,14699
10/8/2020,7,9472,588,4851,601,13,32,15557
10/8/2020,8,9469,601,4872,482,110,32,15566
10/8/2020,9,9470,646,4787,378,238,33,15552
10/8/2020,10,9480,696,4553,665,335,35,15764
10/8/2020,11,9483,840,4144,931,330,50,15778
10/8/2020,12,9483,1106,4030,1054,296,78,16047
10/8/2020,13,9486,1309,3689,1022,297,84,15887
10/8/2020,14,9482,1375,3843,1077,246,83,16106
10/8/2020,15,9479,1367,3775,1044,227,84,15976
10/8/2020,16,9475,1380,4136,981,148,85,16205
10/8/2020,17,9472,1395,4096,1039,71,86,16159
10/8/2020,18,9473,1397,4355,877,9,86,16197
10/8/2020,19,9470,1496,4579,759,0,86,16390
10/8/2020,20,9465,1582,4458,640,0,85,16230
10/8/2020,21,9474,1418,4659,503,1,100,16155
10/8/2020,22,9474,1030,4411,420,0,139,15474
10/8/2020,23,9471,694,4235,359,0,80,14839
10/8/2020,24,9480,467,3665,349,0,72,14033
10/9/2020,1,9482,301,3536,277,0,70,13666
10/9/2020,2,9484,430,3581,244,0,71,13810
10/9/2020,3,9494,771,3576,229,0,71,14141
10/9/2020,4,9500,1141,3424,240,0,70,14375
10/9/2020,5,9409,1334,3209,248,0,72,14272
10/9/2020,6,9398,1424,4027,412,0,81,15342
10/9/2020,7,9396,1583,4392,572,10,87,16040
10/9/2020,8,9399,1480,4236,832,106,88,16141
10/9/2020,9,9397,1340,4016,821,226,88,15888
10/9/2020,10,9398,1485,4149,744,303,88,16167
10/9/2020,11,9401,1429,3968,1030,313,88,16229
10/9/2020,12,9401,1340,3699,1362,355,88,16245
10/9/2020,13,9403,1171,3850,968,362,88,15842
10/9/2020,14,9404,958,3880,1687,279,88,16296
10/9/2020,15,9408,893,3846,1796,209,88,16240
10/9/2020,16,9444,852,3701,2162,140,88,16387
10/9/2020,17,9502,855,3831,2612,76,88,16964
10/9/2020,18,9503,918,3898,2522,8,88,16937
10/9/2020,19,9500,856,3623,2922,0,84,16985
10/9/2020,20,9497,529,3461,3142,0,32,16661
10/9/2020,21,9497,362,3392,3033,0,32,16316
10/9/2020,22,9493,257,3026,2988,0,32,15796
10/9/2020,23,9495,169,2933,2331,0,15,14943
10/9/2020,24,9484,166,2982,1191,0,0,13823
10/10/2020,1,9484,169,2730,922,0,0,13305
10/10/2020,2,9344,166,2671,861,0,0,13042
10/10/2020,3,9184,167,2725,802,0,0,12878
10/10/2020,4,9187,162,2755,760,0,0,12864
10/10/2020,5,9191,132,2863,942,0,0,13128
10/10/2020,6,9195,151,2818,1215,1,0,13380
10/10/2020,7,9195,163,2944,1811,2,0,14115
10/10/2020,8,9236,164,2879,2436,33,0,14748
10/10/2020,9,9388,166,3000,2455,101,0,15110
10/10/2020,10,9393,165,3064,2522,148,0,15292
10/10/2020,11,9383,172,3117,2815,162,0,15649
10/10/2020,12,9388,257,3430,2682,233,0,15990
10/10/2020,13,9387,324,3396,2833,216,0,16156
10/10/2020,14,9383,415,3505,2752,141,0,16196
10/10/2020,15,9468,504,3479,2388,117,0,15956
10/10/2020,16,9475,639,3530,2069,87,0,15800
10/10/2020,17,9462,885,3847,2036,36,0,16266
10/10/2020,18,9471,889,4045,2090,5,0,16500
10/10/2020,19,9470,886,4146,2068,0,0,16570
10/10/2020,20,9470,756,4027,1792,0,0,16045
10/10/2020,21,9470,506,3980,1865,0,0,15821
10/10/2020,22,9475,479,3716,1603,0,0,15273
10/10/2020,23,9476,282,3658,1147,0,0,14563
10/10/2020,24,9479,168,3479,1090,0,0,14216
10/11/2020,1,9481,169,3220,1001,0,0,13871
10/11/2020,2,9484,168,3101,809,0,0,13562
10/11/2020,3,9479,169,3005,765,0,0,13418
10/11/2020,4,9478,170,2875,824,0,0,13347
10/11/2020,5,9483,169,2985,855,0,0,13492
10/11/2020,6,9485,169,3049,865,1,0,13569
10/11/2020,7,9483,171,3163,1620,7,0,14444
10/11/2020,8,9479,174,3233,1630,100,0,14616
10/11/2020,9,9478,180,3198,1786,226,0,14868
10/11/2020,10,9480,170,3166,1775,369,0,14960
10/11/2020,11,9470,170,3164,1746,415,0,14965
10/11/2020,12,9469,170,3179,1775,425,0,15018
10/11/2020,13,9468,173,3312,1634,427,0,15014
10/11/2020,14,9466,172,3222,1682,417,0,14959
10/11/2020,15,9465,170,3226,1551,382,0,14794
10/11/2020,16,9467,163,3577,1580,271,0,15058
10/11/2020,17,9469,258,4238,1625,118,0,15708
10/11/2020,18,9466,281,4460,1633,11,0,15851
10/11/2020,19,9466,244,4366,2003,0,0,16079
10/11/2020,20,9465,175,4005,2238,0,0,15883
10/11/2020,21,9459,174,3591,2372,0,0,15596
10/11/2020,22,9458,172,3305,2231,0,0,15166
10/11/2020,23,9446,172,3177,1800,0,0,14595
10/11/2020,24,9441,172,3066,1320,0,0,13999
10/12/2020,1,9442,172,2981,1095,0,0,13690
10/12/2020,2,9430,173,2827,1059,0,0,13489
10/12/2020,3,9439,172,2682,1014,0,0,13307
10/12/2020,4,9435,171,2774,997,0,0,13377
10/12/2020,5,9427,171,2814,1063,0,0,13475
10/12/2020,6,9426,173,2873,1028,1,0,13501
10/12/2020,7,9426,172,2885,1687,4,0,14174
10/12/2020,8,9429,172,2955,1938,47,0,14541
10/12/2020,9,9430,174,3045,1997,101,0,14747
10/12/2020,10,9428,181,3298,2205,123,0,15235
10/12/2020,11,9425,285,3258,2322,145,0,15435
10/12/2020,12,9422,330,3134,2323,218,0,15427
10/12/2020,13,9416,368,3324,2202,266,0,15576
10/12/2020,14,9398,477,3150,2291,174,0,15490
10/12/2020,15,9403,483,3116,2802,130,0,15934
10/12/2020,16,9408,508,3183,3215,77,0,16391
10/12/2020,17,9418,491,3512,3153,21,0,16595
10/12/2020,18,9420,487,3679,3046,2,1,16635
10/12/2020,19,9418,498,3495,3099,0,0,16510
10/12/2020,20,9412,506,3393,2864,0,2,16177
10/12/2020,21,9406,325,3181,2950,0,2,15864
10/12/2020,22,9406,166,3099,2260,0,0,14931
10/12/2020,23,9410,175,3051,1375,0,0,14011
10/12/2020,24,9413,192,2943,1218,0,0,13766
10/13/2020,1,9398,194,2871,1233,0,6,13702
10/13/2020,2,9374,193,2881,1118,0,5,13571
10/13/2020,3,9353,193,2812,1162,0,16,13536
10/13/2020,4,9343,193,2866,1194,0,18,13614
10/13/2020,5,9333,195,3192,1203,0,27,13950
10/13/2020,6,9327,331,3484,1383,1,52,14578
10/13/2020,7,9321,480,3782,1244,3,89,14919
10/13/2020,8,9309,723,4314,1193,53,124,15716
10/13/2020,9,9266,1105,4092,1052,143,135,15793
10/13/2020,10,9285,1155,3988,971,221,94,15714
10/13/2020,11,9326,1212,4188,839,266,120,15951
10/13/2020,12,9324,1162,3842,742,343,169,15582
10/13/2020,13,9298,1160,3944,788,330,115,15635
10/13/2020,14,9327,1156,3934,896,306,83,15702
10/13/2020,15,9331,1157,4018,909,297,81,15793
10/13/2020,16,9325,1155,4006,1010,208,79,15783
10/13/2020,17,9327,1158,4074,1442,108,79,16188
10/13/2020,18,9326,1153,4090,1491,8,79,16147
10/13/2020,19,9329,1154,4096,2071,0,79,16729
10/13/2020,20,9327,1145,4093,2082,0,88,16735
10/13/2020,21,9325,950,3866,2177,0,100,16418
10/13/2020,22,9356,366,3738,2172,0,77,15709
10/13/2020,23,9375,190,3464,2280,0,34,15343
10/13/2020,24,9401,191,3100,1818,0,15,14525
10/14/2020,1,9397,191,3027,1674,0,15,14304
10/14/2020,2,9397,191,3141,1381,0,17,14127
10/14/2020,3,9397,191,3158,1153,0,17,13916
10/14/2020,4,9393,223,3607,768,0,15,14006
10/14/2020,5,9403,214,3477,671,0,17,13782
10/14/2020,6,9402,201,3649,469,1,39,13761
10/14/2020,7,9402,264,4325,516,5,87,14599
10/14/2020,8,9401,240,4027,644,83,88,14483
10/14/2020,9,9394,193,3881,403,115,84,14070
10/14/2020,10,9396,192,3775,430,201,84,14078
10/14/2020,11,9395,239,3731,800,345,84,14594
10/14/2020,12,9393,369,3551,997,368,83,14761
10/14/2020,13,9256,540,3744,1448,323,84,15395
10/14/2020,14,9334,581,3898,1524,326,87,15750
10/14/2020,15,9384,616,3833,2049,235,105,16222
10/14/2020,16,9383,720,3989,1939,116,94,16241
10/14/2020,17,9383,723,4151,2204,42,89,16592
10/14/2020,18,9387,726,4080,2677,2,88,16960
10/14/2020,19,9389,722,3746,3159,0,88,17104
10/14/2020,20,9383,581,3540,3015,0,87,16606
10/14/2020,21,9385,335,3421,3438,0,46,16625
10/14/2020,22,9383,189,3241,2961,0,31,15805
10/14/2020,23,9380,177,3204,2392,0,20,15173
10/14/2020,24,9385,190,3205,1560,0,17,14357
10/15/2020,1,9390,189,3186,1548,0,17,14330
10/15/2020,2,9383,188,3122,1377,0,17,14087
10/15/2020,3,9372,188,3128,1288,0,16,13992
10/15/2020,4,9372,188,3087,1438,0,16,14101
10/15/2020,5,9379,192,3166,1830,0,19,14586
10/15/2020,6,9378,195,3146,2788,1,26,15534
10/15/2020,7,9379,227,3634,3410,1,31,16682
10/15/2020,8,9364,247,3748,3625,10,31,17025
10/15/2020,9,9306,274,4033,3748,16,31,17408
10/15/2020,10,9274,290,4101,3967,33,31,17696
10/15/2020,11,9275,400,3979,4062,79,31,17826
10/15/2020,12,9278,548,3816,3916,44,31,17633
10/15/2020,13,9281,973,3812,3626,32,31,17755
10/15/2020,14,9278,1254,3866,3413,25,31,17867
10/15/2020,15,9270,1338,4003,3157,23,31,17822
10/15/2020,16,9270,1383,4406,2959,11,31,18060
10/15/2020,17,9262,1204,4572,2749,6,31,17824
10/15/2020,18,9267,1110,4476,2391,0,31,17275
10/15/2020,19,9263,1101,4248,1884,0,31,16527
10/15/2020,20,9265,1100,4188,1858,0,31,16442
10/15/2020,21,9279,945,4222,1921,0,31,16398
10/15/2020,22,9292,524,4366,1851,0,31,16064
10/15/2020,23,9291,276,3909,1966,0,20,15462
10/15/2020,24,9289,170,3359,1769,0,16,14603
10/16/2020,1,9289,190,3482,1645,0,16,14622
10/16/2020,2,9300,190,3726,1375,0,15,14606
10/16/2020,3,9314,197,3409,1222,0,15,14157
10/16/2020,4,9335,294,3387,1312,0,16,14344
10/16/2020,5,9348,416,3558,890,0,18,14230
10/16/2020,6,9353,544,4240,1029,0,24,15190
10/16/2020,7,9356,591,4717,922,2,31,15619
10/16/2020,8,9354,783,4854,944,50,31,16016
10/16/2020,9,9354,729,4638,671,155,31,15578
10/16/2020,10,9359,694,4166,736,234,31,15220
10/16/2020,11,9363,569,3904,609,310,31,14786
10/16/2020,12,9385,690,3877,873,292,51,15168
10/16/2020,13,9390,990,3901,847,300,79,15507
10/16/2020,14,9391,956,3802,1552,257,83,16041
10/16/2020,15,9393,1015,3983,1475,229,82,16177
10/16/2020,16,9394,1178,4249,1553,183,87,16644
10/16/2020,17,9392,1051,4387,1661,87,84,16662
10/16/2020,18,9392,1147,4905,1396,6,82,16928
10/16/2020,19,9389,1406,5269,1025,0,83,17172
10/16/2020,20,9394,1173,5297,1027,0,83,16974
10/16/2020,21,9393,831,5033,979,0,83,16319
10/16/2020,22,9400,663,4526,946,0,88,15623
10/16/2020,23,9401,483,4246,1073,0,26,15229
10/16/2020,24,9397,279,3784,1248,0,2,14710
10/17/2020,1,9398,135,3680,1331,0,0,14544
10/17/2020,2,9405,134,3314,1011,0,0,13864
10/17/2020,3,9408,133,3345,918,0,0,13804
10/17/2020,4,9408,134,3286,1277,0,0,14105
10/17/2020,5,9406,134,3451,1376,0,0,14367
10/17/2020,6,9407,134,3760,1163,1,0,14465
10/17/2020,7,9410,134,4409,1269,4,0,15226
10/17/2020,8,9402,134,4505,1238,59,0,15338
10/17/2020,9,9389,138,4467,1168,148,1,15311
10/17/2020,10,9394,152,4101,1326,242,0,15215
10/17/2020,11,9395,206,4117,1325,286,0,15329
10/17/2020,12,9393,298,4160,1176,294,0,15321
10/17/2020,13,9390,369,4105,1144,347,0,15355
10/17/2020,14,9390,370,3655,1229,313,0,14957
10/17/2020,15,9389,371,3851,916,328,0,14855
10/17/2020,16,9393,371,4361,938,215,0,15278
10/17/2020,17,9408,390,4981,1286,79,0,16144
10/17/2020,18,9407,594,5084,1534,3,0,16622
10/17/2020,19,9408,659,4404,2333,0,0,16804
10/17/2020,20,9409,518,4160,2104,0,0,16191
10/17/2020,21,9413,235,3820,2585,0,0,16053
10/17/2020,22,9412,138,3668,2547,0,0,15765
10/17/2020,23,9422,140,3270,2357,0,0,15189
10/17/2020,24,9432,138,3194,1695,0,0,14459
10/18/2020,1,9454,138,3091,1227,0,0,13910
10/18/2020,2,9441,137,3151,1058,0,0,13787
10/18/2020,3,9456,137,3155,1037,0,0,13785
10/18/2020,4,9411,137,3097,832,0,0,13477
10/18/2020,5,9184,137,3151,1092,0,0,13564
10/18/2020,6,9182,138,3229,1440,1,0,13990
10/18/2020,7,9177,139,3258,1448,2,0,14024
10/18/2020,8,9398,142,3415,1680,38,0,14673
10/18/2020,9,9478,143,3552,2076,78,0,15327
10/18/2020,10,9478,144,3553,2408,93,0,15676
10/18/2020,11,9479,144,3685,2721,146,0,16175
10/18/2020,12,9482,144,3653,2896,140,1,16316
10/18/2020,13,9478,144,3663,2707,103,2,16097
10/18/2020,14,9439,144,3638,2625,93,0,15939
10/18/2020,15,9483,143,3580,2692,58,0,15956
10/18/2020,16,9486,144,3741,2505,32,0,15908
10/18/2020,17,9490,145,4171,2629,8,0,16443
10/18/2020,18,9492,146,4546,2451,0,0,16635
10/18/2020,19,9489,146,4581,2121,0,0,16337
10/18/2020,20,9489,145,4562,2065,0,0,16261
10/18/2020,21,9489,147,4231,1622,0,0,15489
10/18/2020,22,9486,200,4346,1254,0,0,15286
10/18/2020,23,9478,153,3654,1135,0,0,14420
10/18/2020,24,9467,185,3359,674,0,0,13685
10/19/2020,1,9470,191,3468,520,0,3,13652
10/19/2020,2,9481,213,3427,338,0,10,13469
10/19/2020,3,9489,370,3387,277,0,13,13536
10/19/2020,4,9496,484,3534,263,0,16,13793
10/19/2020,5,9497,559,3739,198,0,32,14025
10/19/2020,6,9503,689,4263,201,0,73,14729
10/19/2020,7,9508,868,4654,206,1,100,15337
10/19/2020,8,9506,1160,4519,187,3,171,15546
10/19/2020,9,9505,1514,4552,144,16,190,15921
10/19/2020,10,9504,1572,4499,142,34,190,15941
10/19/2020,11,9504,1854,4413,155,60,133,16119
10/19/2020,12,9502,1868,4225,169,74,123,15961
10/19/2020,13,9499,1778,4223,155,63,123,15841
10/19/2020,14,9492,1843,4134,189,61,150,15869
10/19/2020,15,9484,1880,4270,287,36,128,16085
10/19/2020,16,9485,2094,4538,332,32,147,16628
10/19/2020,17,9479,2404,4611,317,6,190,17007
10/19/2020,18,9477,2286,4674,315,0,185,16937
10/19/2020,19,9474,2145,4417,388,0,140,16564
10/19/2020,20,9470,1972,4145,401,0,89,16077
10/19/2020,21,9465,1587,4045,664,0,101,15862
10/19/2020,22,9475,1097,3894,714,0,86,15266
10/19/2020,23,9476,512,3823,770,0,34,14615
10/19/2020,24,9477,245,3662,858,0,17,14259
10/20/2020,1,9473,203,3685,738,0,16,14115
10/20/2020,2,9472,210,3843,562,0,17,14104
10/20/2020,3,9477,380,3790,500,0,17,14164
10/20/2020,4,9474,683,3406,181,0,17,13761
10/20/2020,5,9464,902,3490,173,0,22,14051
10/20/2020,6,9472,1019,4100,282,0,49,14922
10/20/2020,7,9470,1238,4532,305,2,95,15642
10/20/2020,8,9382,1366,4624,362,13,140,15887
10/20/2020,9,9364,1207,4359,401,90,139,15560
10/20/2020,10,9358,1224,4071,226,167,139,15185
10/20/2020,11,9355,1221,3995,105,135,140,14951
10/20/2020,12,9353,1254,3943,76,138,140,14904
10/20/2020,13,9356,1314,3953,136,249,139,15147
10/20/2020,14,9458,1312,4048,76,113,138,15145
10/20/2020,15,9470,1391,4070,103,128,139,15301
10/20/2020,16,9470,1536,4196,176,95,139,15612
10/20/2020,17,9463,1521,4144,325,42,139,15634
10/20/2020,18,9462,1435,4355,649,1,140,16042
10/20/2020,19,9460,1341,4697,998,0,177,16673
10/20/2020,20,9457,999,4316,1296,0,197,16265
10/20/2020,21,9463,946,4167,1494,0,163,16233
10/20/2020,22,9461,433,3923,1525,0,90,15432
10/20/2020,23,9465,234,3692,1239,0,38,14668
10/20/2020,24,9469,271,3395,1434,0,18,14587
10/21/2020,1,9463,275,3154,1319,0,17,14228
10/21/2020,2,9460,236,3060,1183,0,16,13955
10/21/2020,3,9463,201,2973,1201,0,16,13854
10/21/2020,4,9458,199,3052,1257,0,16,13982
10/21/2020,5,9447,200,3014,1416,0,18,14095
10/21/2020,6,9453,199,3001,2211,0,45,14909
10/21/2020,7,9446,261,3323,2782,1,84,15897
10/21/2020,8,9440,441,3480,2980,3,129,16473
10/21/2020,9,9444,556,3815,2895,13,135,16858
10/21/2020,10,9441,660,3571,3109,18,134,16933
10/21/2020,11,9443,785,3665,3044,36,133,17106
10/21/2020,12,9433,911,3829,2753,47,129,17102
10/21/2020,13,9428,1007,4183,2273,118,130,17139
10/21/2020,14,9427,1061,4186,1854,156,130,16814
10/21/2020,15,9423,1021,4368,1386,127,130,16455
10/21/2020,16,9423,1176,4709,1236,82,128,16754
10/21/2020,17,9437,1533,4495,813,27,133,16438
10/21/2020,18,9441,1757,4608,572,1,133,16512
10/21/2020,19,9444,1501,4596,641,0,176,16358
10/21/2020,20,9448,1134,4549,748,0,191,16070
10/21/2020,21,9451,1042,4341,776,0,136,15746
10/21/2020,22,9452,893,4287,607,0,46,15285
10/21/2020,23,9456,731,4168,554,0,24,14933
10/21/2020,24,9459,410,3609,495,0,16,13989
10/22/2020,1,9462,206,3823,479,0,13,13983
10/22/2020,2,9460,275,3857,452,0,12,14056
10/22/2020,3,9464,454,3715,323,0,14,13970
10/22/2020,4,9464,616,3507,315,0,12,13914
10/22/2020,5,9457,808,3582,192,0,20,14059
10/22/2020,6,9458,921,3966,249,0,51,14645
10/22/2020,7,9459,1122,4548,250,1,92,15472
10/22/2020,8,9456,1339,4709,339,5,134,15982
10/22/2020,9,9453,1391,4819,280,20,133,16096
10/22/2020,10,9457,1452,4684,379,40,135,16147
10/22/2020,11,9460,1340,4546,492,65,135,16038
10/22/2020,12,9462,1497,4035,623,76,136,15829
10/22/2020,13,9463,1139,4110,532,89,133,15466
10/22/2020,14,9461,1151,4162,619,77,133,15603
10/22/2020,15,9464,1242,4311,557,50,135,15759
10/22/2020,16,9462,1372,4486,514,35,136,16005
10/22/2020,17,9458,1362,4491,743,25,137,16216
10/22/2020,18,9453,1335,4515,1059,2,138,16502
10/22/2020,19,9453,1170,4461,1224,0,139,16447
10/22/2020,20,9455,798,4337,1313,0,137,16040
10/22/2020,21,9447,605,3995,1606,0,136,15789
10/22/2020,22,9456,315,3694,1690,0,105,15260
10/22/2020,23,9458,203,3114,1544,0,80,14399
10/22/2020,24,9460,202,3152,1228,0,20,14062
10/23/2020,1,9461,203,3140,1136,0,16,13956
10/23/2020,2,9461,203,2987,1082,0,16,13749
10/23/2020,3,9464,203,2857,872,0,16,13412
10/23/2020,4,9458,202,2845,1044,0,16,13565
10/23/2020,5,9464,202,2899,1345,0,22,13932
10/23/2020,6,9466,201,3093,1779,2,26,14567
10/23/2020,7,9466,202,3278,2789,2,30,15767
10/23/2020,8,9468,202,3418,3214,27,31,16360
10/23/2020,9,9468,203,3446,2813,137,31,16098
10/23/2020,10,9465,203,3256,2559,175,31,15689
10/23/2020,11,9464,208,3182,2671,263,31,15819
10/23/2020,12,9460,315,3249,2341,314,31,15710
10/23/2020,13,9453,433,3448,2160,301,31,15826
10/23/2020,14,9446,541,3511,1996,272,31,15797
10/23/2020,15,9449,541,3615,2388,179,31,16203
10/23/2020,16,9452,551,3904,2665,92,31,16695
10/23/2020,17,9447,560,3910,2498,8,32,16455
10/23/2020,18,9443,551,3947,2183,0,32,16156
10/23/2020,19,9438,543,3848,2115,0,32,15976
10/23/2020,20,9435,443,3804,2255,0,32,15969
10/23/2020,21,9419,418,3688,2351,0,32,15908
10/23/2020,22,9408,289,3394,2117,0,32,15240
10/23/2020,23,9418,154,3245,1572,0,22,14411
10/23/2020,24,9403,145,3206,1090,0,4,13848
10/24/2020,1,9389,166,3082,859,0,0,13496
10/24/2020,2,9382,177,3036,571,0,0,13166
10/24/2020,3,9242,211,3043,614,0,0,13110
10/24/2020,4,9093,163,3049,849,0,0,13154
10/24/2020,5,9094,143,3206,895,0,0,13338
10/24/2020,6,9316,144,3591,850,2,0,13903
10/24/2020,7,9395,149,3509,1125,2,8,14188
10/24/2020,8,9386,151,4120,1078,57,12,14804
10/24/2020,9,9386,214,4697,773,104,18,15192
10/24/2020,10,9386,270,4498,693,177,21,15045
10/24/2020,11,9385,466,4284,476,281,22,14914
10/24/2020,12,9381,805,4404,386,303,14,15293
10/24/2020,13,9378,1003,4155,497,294,0,15327
10/24/2020,14,9373,982,4050,603,260,18,15286
10/24/2020,15,9372,1056,4124,697,175,46,15470
10/24/2020,16,9370,1111,4274,621,114,60,15550
10/24/2020,17,9367,1202,4838,483,34,73,15997
10/24/2020,18,9363,1172,4947,325,2,95,15904
10/24/2020,19,9363,1114,4733,423,0,100,15733
10/24/2020,20,9352,953,4522,523,0,95,15445
10/24/2020,21,9328,447,4175,342,0,73,14365
10/24/2020,22,9329,203,4148,556,0,72,14308
10/24/2020,23,9329,143,3786,328,0,56,13642
10/24/2020,24,9326,144,3633,509,0,57,13669
10/25/2020,1,9139,147,3460,558,0,14,13318
10/25/2020,2,9029,146,3449,621,0,0,13245
10/25/2020,3,9028,147,3307,629,0,0,13111
10/25/2020,4,9029,146,3364,583,0,0,13122
10/25/2020,5,9033,150,3285,769,0,0,13237
10/25/2020,6,9055,152,3439,853,2,0,13501
10/25/2020,7,9319,150,3462,845,2,0,13778
10/25/2020,8,9334,150,3668,877,38,0,14067
10/25/2020,9,9331,153,3899,707,122,0,14212
10/25/2020,10,9332,254,3913,701,213,0,14413
10/25/2020,11,9337,388,4066,625,199,0,14615
10/25/2020,12,9346,491,4208,551,202,0,14798
10/25/2020,13,9341,493,4340,541,184,0,14899
10/25/2020,14,9344,497,4233,690,226,0,14990
10/25/2020,15,9342,497,4132,756,150,0,14877
10/25/2020,16,9344,501,4351,919,91,0,15206
10/25/2020,17,9344,584,5007,1003,29,0,15967
10/25/2020,18,9340,643,5075,945,0,0,16003
10/25/2020,19,9343,564,4821,946,0,0,15674
10/25/2020,20,9341,527,4392,1109,0,1,15370
10/25/2020,21,9347,519,4066,961,0,0,14893
10/25/2020,22,9343,498,3905,790,0,0,14536
10/25/2020,23,9334,300,3651,731,0,0,14016
10/25/2020,24,9324,155,3810,752,0,0,14041
10/26/2020,1,9320,158,3665,600,0,0,13743
10/26/2020,2,9309,211,3363,493,0,0,13376
10/26/2020,3,9304,353,3285,424,0,13,13379
10/26/2020,4,9145,465,3560,403,0,13,13586
10/26/2020,5,9070,644,3957,311,0,17,13999
10/26/2020,6,9297,961,3940,222,0,27,14447
10/26/2020,7,9293,1239,4429,169,2,32,15164
10/26/2020,8,9283,1627,4583,122,6,32,15653
10/26/2020,9,9282,1725,4663,117,16,32,15835
10/26/2020,10,9283,2040,4508,236,31,34,16132
10/26/2020,11,9280,1796,4468,223,45,33,15845
10/26/2020,12,9282,1808,4479,249,58,32,15908
10/26/2020,13,9284,1758,4395,339,60,32,15868
10/26/2020,14,9299,1644,4381,396,46,32,15798
10/26/2020,15,9308,1576,4281,649,41,32,15887
10/26/2020,16,9305,1580,4373,722,24,32,16036
10/26/2020,17,9318,1895,4664,617,7,32,16533
10/26/2020,18,9330,1955,4651,603,0,31,16570
10/26/2020,19,9329,1932,4619,457,0,31,16368
10/26/2020,20,9328,1632,4330,507,0,31,15828
10/26/2020,21,9325,1526,4090,345,0,32,15318
10/26/2020,22,9331,802,4277,492,0,32,14934
10/26/2020,23,9337,486,4285,512,0,22,14642
10/26/2020,24,9338,401,3952,464,0,17,14172
10/27/2020,1,9339,388,3871,414,0,16,14028
10/27/2020,2,9337,224,3745,359,0,16,13681
10/27/2020,3,9332,401,3814,343,0,16,13906
10/27/2020,4,9339,704,3723,337,0,16,14119
10/27/2020,5,9353,982,3904,326,0,22,14587
10/27/2020,6,9367,1289,4202,312,0,29,15199
10/27/2020,7,9368,1554,4342,341,0,44,15649
10/27/2020,8,9371,1677,4360,301,7,37,15753
10/27/2020,9,9374,1784,4299,278,41,35,15811
10/27/2020,10,9375,1948,4524,285,65,33,16230
10/27/2020,11,9375,1848,4209,281,130,32,15875
10/27/2020,12,9371,1837,4520,327,76,32,16163
10/27/2020,13,9371,1988,4683,513,65,32,16652
10/27/2020,14,9369,1992,4264,482,58,32,16197
10/27/2020,15,9370,1866,4596,571,22,32,16457
10/27/2020,16,9365,2063,4779,431,9,32,16679
10/27/2020,17,9366,2425,4791,369,2,32,16985
10/27/2020,18,9368,1998,4639,353,0,32,16390
10/27/2020,19,9369,1728,4785,324,0,32,16238
10/27/2020,20,9366,1679,4509,384,0,32,15970
10/27/2020,21,9370,1321,4378,442,0,32,15543
10/27/2020,22,9367,737,4150,526,0,32,14812
10/27/2020,23,9366,452,4064,580,0,20,14482
10/27/2020,24,9363,285,3901,757,0,16,14322
10/28/2020,1,9363,209,3379,761,0,16,13728
10/28/2020,2,9372,291,3326,874,0,16,13879
10/28/2020,3,9373,433,3303,1153,0,16,14278
10/28/2020,4,9376,543,3336,1129,0,16,14400
10/28/2020,5,9371,545,3744,686,0,19,14365
10/28/2020,6,9376,546,4185,942,0,33,15082
10/28/2020,7,9372,549,4511,1507,1,34,15974
10/28/2020,8,9372,564,4443,1801,7,32,16219
10/28/2020,9,9372,542,4405,2017,50,32,16418
10/28/2020,10,9370,543,4216,1975,107,32,16243
10/28/2020,11,9375,545,4077,1239,240,33,15509
10/28/2020,12,9372,552,3982,1260,317,32,15515
10/28/2020,13,9203,554,3777,1626,270,32,15462
10/28/2020,14,9282,589,3770,1815,287,32,15775
10/28/2020,15,9339,735,3797,1583,231,32,15717
10/28/2020,16,9232,737,4159,1668,151,32,15979
10/28/2020,17,9206,739,4343,1731,41,32,16092
10/28/2020,18,9200,738,4483,1865,1,32,16319
10/28/2020,19,9203,737,4486,1687,0,32,16145
10/28/2020,20,9202,755,4470,1446,0,32,15905
10/28/2020,21,9207,611,4318,1262,0,32,15430
10/28/2020,22,9205,611,4194,858,0,32,14900
10/28/2020,23,9206,528,4089,707,0,20,14550
10/28/2020,24,9210,274,3788,620,0,15,13907
10/29/2020,1,9212,210,3942,564,0,16,13944
10/29/2020,2,9219,298,3788,378,0,14,13697
10/29/2020,3,9240,461,3978,243,0,15,13937
10/29/2020,4,9240,709,4215,125,0,15,14304
10/29/2020,5,9272,1114,4096,117,0,17,14616
10/29/2020,6,9264,1485,4117,198,0,29,15093
10/29/2020,7,9247,1908,4151,379,2,31,15718
10/29/2020,8,9245,1927,4267,630,7,31,16107
10/29/2020,9,9236,1933,3897,668,20,31,15785
10/29/2020,10,9237,1960,3847,628,37,31,15740
10/29/2020,11,9237,1863,3769,889,64,31,15853
10/29/2020,12,9237,1615,3773,841,77,32,15575
10/29/2020,13,9096,1595,3737,748,93,33,15302
10/29/2020,14,9063,1586,3758,998,84,32,15521
10/29/2020,15,9133,1120,3696,1480,60,32,15521
10/29/2020,16,9227,1026,3726,2263,64,32,16338
10/29/2020,17,9227,1119,3760,2427,21,32,16586
10/29/2020,18,9230,1120,3959,2713,0,32,17054
10/29/2020,19,9228,917,4137,2313,0,32,16627
10/29/2020,20,9220,642,3964,2281,0,32,16139
10/29/2020,21,9197,610,3959,1979,0,32,15777
10/29/2020,22,9197,481,3821,1824,0,32,15355
10/29/2020,23,9201,226,3671,1886,0,24,15008
10/29/2020,24,9197,205,3431,2091,0,21,14945
10/30/2020,1,9204,292,3369,1860,0,18,14743
10/30/2020,2,9202,371,3379,1640,0,17,14609
10/30/2020,3,9201,748,3386,1206,0,18,14559
10/30/2020,4,9197,1062,3563,951,0,17,14790
10/30/2020,5,9196,1197,3556,808,0,18,14775
10/30/2020,6,9199,1368,3784,869,1,25,15246
10/30/2020,7,9202,1542,4198,908,3,32,15885
10/30/2020,8,9202,1599,4678,874,19,32,16404
10/30/2020,9,9198,1569,4691,761,83,42,16344
10/30/2020,10,9180,1598,4433,834,152,42,16239
10/30/2020,11,9189,1695,4109,609,198,45,15845
10/30/2020,12,9180,1481,3974,735,234,46,15650
10/30/2020,13,9166,1429,3783,945,245,33,15601
10/30/2020,14,9165,1525,3871,616,252,32,15461
10/30/2020,15,9164,1669,3954,623,161,32,15603
10/30/2020,16,9162,1717,3897,931,107,36,15850
10/30/2020,17,9170,1722,4563,1132,26,32,16645
10/30/2020,18,9186,1969,4811,873,0,32,16871
10/30/2020,19,9187,1947,4924,637,0,32,16727
10/30/2020,20,9179,1873,4795,547,0,32,16426
10/30/2020,21,9170,1729,4390,443,0,32,15764
10/30/2020,22,9176,876,4840,305,0,32,15229
10/30/2020,23,9176,538,4480,265,0,22,14481
10/30/2020,24,9183,201,4745,214,0,11,14354
10/31/2020,1,9187,156,4377,197,0,0,13917
10/31/2020,2,9190,218,4308,200,0,0,13916
10/31/2020,3,9185,351,4535,211,0,0,14282
10/31/2020,4,9183,558,4554,262,0,0,14557
10/31/2020,5,9186,596,4652,276,0,0,14710
10/31/2020,6,9219,622,4349,326,1,0,14517
10/31/2020,7,9219,693,4278,404,3,0,14597
10/31/2020,8,9222,694,4456,548,50,0,14970
10/31/2020,9,9217,740,4355,718,169,5,15204
10/31/2020,10,9218,602,4067,789,249,6,14931
10/31/2020,11,9215,486,3922,757,309,0,14689
10/31/2020,12,9214,485,3779,816,322,0,14616
10/31/2020,13,9196,407,3719,1106,256,0,14684
10/31/2020,14,9148,298,3759,1085,213,0,14503
10/31/2020,15,9197,347,3797,1432,152,0,14925
10/31/2020,16,9207,360,3939,1995,106,0,15607
10/31/2020,17,9205,359,4529,2038,41,0,16172
10/31/2020,18,9206,362,4547,2402,0,0,16517
10/31/2020,19,9213,364,4525,2357,0,0,16459
10/31/2020,20,9206,346,4098,2133,0,0,15783
10/31/2020,21,9209,307,3664,2305,0,0,15485
10/31/2020,22,9211,201,3494,1817,0,0,14723
10/31/2020,23,9207,145,3296,1279,0,0,13927
10/31/2020,24,9210,143,3090,1133,0,0,13576
11/1/2020,1,9209,142,2986,1315,0,0,13652
11/1/2020,2,9208,146,2866,1455,0,0,13675
11/1/2020,3,9199,144,2896,1285,0,0,13524
11/1/2020,4,9205,143,2853,1633,0,0,13834
11/1/2020,5,9231,145,2901,1460,0,0,13737
11/1/2020,6,9261,145,3063,1533,0,0,14002
11/1/2020,7,9268,146,3092,1741,2,0,14249
11/1/2020,8,9264,145,3173,2139,3,0,14724
11/1/2020,9,9264,145,3292,3044,18,0,15763
11/1/2020,10,9263,145,3274,3533,39,0,16254
11/1/2020,11,9262,143,3287,3645,27,0,16364
11/1/2020,12,9262,145,3432,3992,35,0,16866
11/1/2020,13,9260,144,3516,4106,87,0,17113
11/1/2020,14,9269,145,3507,4124,93,0,17138
11/1/2020,15,9268,144,3528,3883,87,0,16910
11/1/2020,16,9252,147,3840,3651,33,0,16923
11/1/2020,17,9258,148,4017,4129,15,0,17567
11/1/2020,18,9274,149,5027,4084,0,0,18534
11/1/2020,19,9283,149,4785,4203,0,0,18420
11/1/2020,20,9285,133,4254,4033,0,0,17705
11/1/2020,21,9286,152,4057,3821,0,0,17316
11/1/2020,22,9284,179,3519,3685,0,0,16667
11/1/2020,23,9291,187,3131,3229,0,0,15838
11/1/2020,24,9293,155,3068,2588,0,0,15104
11/2/2020,1,9293,148,2904,2475,0,10,14830
11/2/2020,2,9284,149,2917,2228,0,13,14591
11/2/2020,3,9285,149,2913,2213,0,16,14576
11/2/2020,4,9291,149,2994,2065,0,15,14514
11/2/2020,5,9291,149,3122,2273,0,16,14851
11/2/2020,6,9293,150,3289,2772,0,19,15523
11/2/2020,7,9288,162,3781,2861,2,26,16120
11/2/2020,8,9286,172,4392,2728,32,31,16641
11/2/2020,9,9288,184,4616,2589,138,31,16846
11/2/2020,10,9288,231,4440,2663,198,31,16851
11/2/2020,11,9290,286,4370,2677,242,31,16896
11/2/2020,12,9292,378,4088,2954,267,31,17010
11/2/2020,13,9294,506,3646,2897,251,31,16625
11/2/2020,14,9290,510,3782,3007,209,31,16829
11/2/2020,15,9294,513,3831,3556,158,36,17388
11/2/2020,16,9303,515,4252,3507,87,37,17701
11/2/2020,17,9312,514,4701,4218,12,32,18789
11/2/2020,18,9310,511,5118,4334,0,32,19305
11/2/2020,19,9313,514,4780,4404,0,32,19043
11/2/2020,20,9313,528,4273,4086,0,32,18232
11/2/2020,21,9307,538,4245,3295,0,32,17417
11/2/2020,22,9307,347,3844,3678,0,31,17207
11/2/2020,23,9307,203,3346,3345,0,30,16231
11/2/2020,24,9303,239,3078,2989,0,20,15629
11/3/2020,1,9302,286,2961,2481,0,17,15047
11/3/2020,2,9309,382,2797,2166,0,17,14671
11/3/2020,3,9304,592,2695,2069,0,17,14677
11/3/2020,4,9298,716,2786,1774,0,17,14591
11/3/2020,5,9291,991,2740,2120,0,18,15160
11/3/2020,6,9295,1289,2979,1806,0,40,15409
11/3/2020,7,9292,1368,3891,1685,0,55,16291
11/3/2020,8,9295,1539,5052,1380,33,61,17360
11/3/2020,9,9261,1669,5242,927,78,62,17239
11/3/2020,10,9260,1949,5309,559,156,62,17295
11/3/2020,11,9289,2002,5153,442,142,63,17091
11/3/2020,12,9301,2024,5073,328,162,63,16951
11/3/2020,13,9303,2288,4366,542,188,62,16749
11/3/2020,14,9304,2310,3960,735,173,65,16547
11/3/2020,15,9305,2339,3919,740,127,64,16494
11/3/2020,16,9281,2198,3993,1222,70,60,16824
11/3/2020,17,9272,2257,4236,1387,24,61,17237
11/3/2020,18,9289,2773,4771,1826,0,61,18720
11/3/2020,19,9304,2679,4534,1939,0,54,18510
11/3/2020,20,9304,2070,4104,2506,0,46,18030
11/3/2020,21,9308,1556,4035,3055,0,45,17999
11/3/2020,22,9295,616,3598,3031,0,43,16583
11/3/2020,23,9292,318,3442,2916,0,47,16015
11/3/2020,24,9304,233,3532,2119,0,53,15241
11/4/2020,1,9302,229,3099,2472,0,52,15154
11/4/2020,2,9300,216,2990,2068,0,45,14619
11/4/2020,3,9288,218,2854,2141,0,45,14546
11/4/2020,4,9278,218,2798,1800,0,42,14136
11/4/2020,5,9278,216,2802,2082,0,38,14416
11/4/2020,6,9280,215,2946,2193,0,39,14673
11/4/2020,7,9274,215,3117,2591,1,50,15248
11/4/2020,8,9277,239,3289,3009,38,50,15902
11/4/2020,9,9268,249,3455,2828,163,42,16005
11/4/2020,10,9268,250,3411,2675,267,41,15912
11/4/2020,11,9120,299,3294,2446,342,46,15547
11/4/2020,12,9237,339,3361,1751,374,44,15106
11/4/2020,13,9272,568,3161,1733,377,46,15157
11/4/2020,14,9275,832,3024,1805,352,45,15333
11/4/2020,15,9274,972,3193,1859,282,45,15625
11/4/2020,16,9277,992,3698,2186,171,49,16373
11/4/2020,17,9280,1117,4017,2861,37,44,17356
11/4/2020,18,9278,1149,4302,3453,0,36,18218
11/4/2020,19,9292,1105,4415,2909,0,32,17753
11/4/2020,20,9290,1105,4362,2805,0,33,17595
11/4/2020,21,9293,883,4120,2900,0,32,17228
11/4/2020,22,9296,796,3801,3004,0,35,16932
11/4/2020,23,9290,296,3493,2597,0,32,15708
11/4/2020,24,9291,202,3041,2218,0,17,14769
11/5/2020,1,9293,202,2774,1889,0,16,14174
11/5/2020,2,9294,202,2630,1655,0,16,13797
11/5/2020,3,9290,202,2629,1522,0,16,13659
11/5/2020,4,9321,201,2656,1419,0,16,13613
11/5/2020,5,9345,201,3041,1119,0,16,13722
11/5/2020,6,9316,202,3203,1438,0,18,14177
11/5/2020,7,9281,203,3200,2670,1,28,15383
11/5/2020,8,9282,230,3524,2917,26,32,16011
11/5/2020,9,9272,242,3577,2793,137,32,16053
11/5/2020,10,9272,241,3593,2437,250,32,15825
11/5/2020,11,9274,313,3483,2840,290,32,16232
11/5/2020,12,9280,318,3487,2740,259,32,16116
11/5/2020,13,9311,477,3667,2629,239,32,16355
11/5/2020,14,9352,620,3479,2591,233,32,16307
11/5/2020,15,9350,747,3942,2131,178,33,16381
11/5/2020,16,9350,751,4221,1897,58,33,16310
11/5/2020,17,9353,753,4618,2325,8,33,17090
11/5/2020,18,9355,755,4706,2630,0,33,17479
11/5/2020,19,9368,745,4627,2339,0,33,17112
11/5/2020,20,9369,748,4585,2591,0,33,17326
11/5/2020,21,9373,552,4358,2681,0,33,16997
11/5/2020,22,9370,406,4193,2661,0,34,16664
11/5/2020,23,9373,236,3717,2486,0,33,15845
11/5/2020,24,9369,202,3093,2266,0,22,14952
11/6/2020,1,9395,202,2986,1929,0,19,14531
11/6/2020,2,9395,202,2846,1471,0,19,13933
11/6/2020,3,9396,201,2769,1390,0,18,13774
11/6/2020,4,9398,202,2736,1411,0,18,13765
11/6/2020,5,9407,201,2857,1309,0,17,13791
11/6/2020,6,9416,201,2949,1785,0,18,14369
11/6/2020,7,9426,200,3339,2091,2,27,15085
11/6/2020,8,9425,203,3699,2554,26,32,15939
11/6/2020,9,9422,231,3881,2280,133,32,15979
11/6/2020,10,9415,206,4071,1986,218,32,15928
11/6/2020,11,9412,199,3948,1802,231,32,15624
11/6/2020,12,9412,199,3678,1667,275,32,15263
11/6/2020,13,9426,208,3975,1350,314,32,15305
11/6/2020,14,9426,280,4101,1678,300,32,15817
11/6/2020,15,9425,406,4130,1750,204,32,15947
11/6/2020,16,9419,534,4310,1766,119,32,16180
11/6/2020,17,9424,548,4469,2058,24,38,16561
11/6/2020,18,9421,572,4552,2273,0,43,16861
11/6/2020,19,9423,702,4551,2524,0,35,17235
11/6/2020,20,9424,705,4365,2434,0,43,16971
11/6/2020,21,9425,704,4210,2241,0,42,16622
11/6/2020,22,9425,498,3617,2197,0,35,15772
11/6/2020,23,9423,250,3191,2452,0,32,15348
11/6/2020,24,9428,150,2955,2133,0,10,14676
11/7/2020,1,9432,149,2688,1248,0,0,13517
11/7/2020,2,9431,147,2681,1027,0,0,13286
11/7/2020,3,9429,147,2651,997,0,0,13224
11/7/2020,4,9424,146,2735,1069,0,0,13374
11/7/2020,5,9411,147,2833,627,0,0,13018
11/7/2020,6,9415,144,2792,734,0,0,13085
11/7/2020,7,9434,145,2800,1571,1,0,13951
11/7/2020,8,9438,147,3031,1852,29,0,14497
11/7/2020,9,9433,145,3221,1487,148,1,14435
11/7/2020,10,9427,146,3485,1386,255,0,14699
11/7/2020,11,9426,145,3446,1496,309,0,14822
11/7/2020,12,9439,144,3353,1583,333,0,14852
11/7/2020,13,9449,145,3397,1428,332,0,14751
11/7/2020,14,9448,145,3301,1412,323,0,14629
11/7/2020,15,9445,145,3494,1341,238,0,14663
11/7/2020,16,9449,144,3864,1295,135,0,14887
11/7/2020,17,9442,180,4341,1199,30,0,15192
11/7/2020,18,9443,183,4521,2487,0,0,16634
11/7/2020,19,9436,144,4366,2417,0,0,16363
11/7/2020,20,9437,145,4463,2237,0,0,16282
11/7/2020,21,9437,144,3969,1915,0,0,15465
11/7/2020,22,9439,145,3174,2131,0,0,14889
11/7/2020,23,9444,145,3094,1904,0,0,14587
11/7/2020,24,9443,145,3035,1464,0,0,14087
11/8/2020,1,9445,145,2786,1180,0,0,13556
11/8/2020,2,9449,146,2673,946,0,0,13214
11/8/2020,3,9448,144,2775,673,0,0,13040
11/8/2020,4,9313,143,2707,670,0,0,12833
11/8/2020,5,9154,143,2806,767,0,0,12870
11/8/2020,6,9159,144,2840,881,0,0,13024
11/8/2020,7,9379,144,2913,1046,2,0,13484
11/8/2020,8,9465,145,2990,860,28,0,13488
11/8/2020,9,9458,143,3136,755,162,2,13656
11/8/2020,10,9450,144,3290,537,294,2,13717
11/8/2020,11,9450,144,3681,338,375,0,13988
11/8/2020,12,9486,143,3611,322,404,0,13966
11/8/2020,13,9522,142,3404,339,401,0,13808
11/8/2020,14,9520,143,3412,375,377,0,13827
11/8/2020,15,9517,141,3745,337,279,0,14019
11/8/2020,16,9518,142,4163,442,134,0,14399
11/8/2020,17,9514,143,4856,611,34,0,15158
11/8/2020,18,9508,143,5466,855,0,11,15983
11/8/2020,19,9508,147,5101,1181,0,12,15949
11/8/2020,20,9507,145,4539,1257,0,17,15465
11/8/2020,21,9503,144,4287,1478,0,17,15429
11/8/2020,22,9511,143,3875,1606,0,14,15149
11/8/2020,23,9513,141,3886,869,0,16,14425
11/8/2020,24,9514,143,3364,1304,0,3,14328
11/9/2020,1,9505,143,3143,1482,0,0,14273
11/9/2020,2,9513,143,3027,1006,0,8,13697
11/9/2020,3,9510,142,2879,840,0,12,13383
11/9/2020,4,9515,144,2755,626,0,15,13055
11/9/2020,5,9521,143,3001,855,0,17,13537
11/9/2020,6,9519,152,3359,795,0,18,13843
11/9/2020,7,9506,303,3711,1204,2,24,14750
11/9/2020,8,9501,353,4307,1556,32,32,15781
11/9/2020,9,9501,352,4442,1531,166,31,16023
11/9/2020,10,9499,349,4466,1170,262,29,15775
11/9/2020,11,9496,427,4078,923,322,32,15278
11/9/2020,12,9490,527,4138,769,364,51,15339
11/9/2020,13,9487,734,3952,842,351,53,15419
11/9/2020,14,9487,849,3883,984,316,51,15570
11/9/2020,15,9503,850,3945,1220,253,47,15818
11/9/2020,16,9512,849,4070,1020,136,43,15630
11/9/2020,17,9506,848,4612,1102,30,47,16145
11/9/2020,18,9505,867,4922,1582,0,47,16923
11/9/2020,19,9499,856,4632,1643,0,51,16681
11/9/2020,20,9501,629,4413,2038,0,48,16629
11/9/2020,21,9509,357,4212,2123,0,33,16234
11/9/2020,22,9511,219,3786,2313,0,32,15861
11/9/2020,23,9506,222,3477,2173,0,32,15410
11/9/2020,24,9497,202,3217,1783,0,26,14725
11/10/2020,1,9499,194,2946,1606,0,17,14262
11/10/2020,2,9510,193,2890,914,0,15,13522
11/10/2020,3,9511,204,2801,780,0,16,13312
11/10/2020,4,9505,201,2787,591,0,15,13099
11/10/2020,5,9504,192,2856,543,0,15,13110
11/10/2020,6,9508,192,2949,960,0,19,13628
11/10/2020,7,9519,194,2940,2353,3,28,15037
11/10/2020,8,9520,193,3636,2608,19,31,16007
11/10/2020,9,9522,193,3897,2594,124,31,16361
11/10/2020,10,9526,195,4093,2349,202,31,16396
11/10/2020,11,9529,196,3946,2603,260,31,16565
11/10/2020,12,9526,195,3761,2631,262,31,16406
11/10/2020,13,9523,194,3460,2394,270,32,15873
11/10/2020,14,9371,203,3501,2655,240,31,16001
11/10/2020,15,8966,255,3684,2947,237,31,16120
11/10/2020,16,9043,203,3857,2689,124,32,15948
11/10/2020,17,9086,196,4327,2271,24,32,15936
11/10/2020,18,9078,197,4613,2932,0,32,16852
11/10/2020,19,9084,197,4343,3470,0,32,17126
11/10/2020,20,9086,202,4070,3676,0,32,17066
11/10/2020,21,9088,226,3942,3588,0,32,16876
11/10/2020,22,9091,198,3744,3494,0,32,16559
11/10/2020,23,9096,198,3147,3104,0,32,15577
11/10/2020,24,9086,199,2988,1727,0,25,14025
11/11/2020,1,9088,202,2877,1348,0,15,13530
11/11/2020,2,9090,201,2793,812,0,15,12911
11/11/2020,3,9086,239,2813,905,0,15,13058
11/11/2020,4,9084,261,2836,919,0,21,13121
11/11/2020,5,9095,276,2813,869,0,25,13078
11/11/2020,6,9095,298,2782,1051,0,32,13258
11/11/2020,7,9100,351,2820,2701,1,42,15015
11/11/2020,8,9100,405,3107,3090,3,51,15756
11/11/2020,9,9101,423,3558,3222,31,50,16385
11/11/2020,10,9098,490,3668,3308,80,42,16686
11/11/2020,11,9092,540,3482,2683,147,39,15983
11/11/2020,12,9049,664,3526,2380,139,51,15809
11/11/2020,13,9089,1048,3570,1948,160,47,15862
11/11/2020,14,8938,1173,3520,1863,238,49,15781
11/11/2020,15,8961,1164,3758,1744,200,44,15871
11/11/2020,16,9087,1169,4425,1274,125,44,16124
11/11/2020,17,9088,1170,4605,1569,25,40,16497
11/11/2020,18,9067,1167,5085,1738,0,35,17092
11/11/2020,19,9075,1051,5045,1673,0,31,16875
11/11/2020,20,9088,883,4951,1573,0,31,16526
11/11/2020,21,9090,491,4895,1403,0,31,15910
11/11/2020,22,9086,233,4594,1276,0,31,15220
11/11/2020,23,9089,202,4304,1108,0,31,14734
11/11/2020,24,9156,201,3944,934,0,21,14256
11/12/2020,1,9419,202,3653,709,0,16,13999
11/12/2020,2,9455,202,3384,706,0,16,13763
11/12/2020,3,9458,276,3151,624,0,16,13525
11/12/2020,4,9459,410,3333,578,0,16,13796
11/12/2020,5,9451,541,3501,465,0,15,13973
11/12/2020,6,9462,544,3579,299,0,17,13901
11/12/2020,7,9459,553,4155,235,2,23,14427
11/12/2020,8,9460,691,5312,275,16,30,15784
11/12/2020,9,9461,701,5104,285,111,30,15692
11/12/2020,10,9458,712,4565,260,165,30,15190
11/12/2020,11,9457,1038,4289,258,264,30,15336
11/12/2020,12,9458,1202,4324,313,363,30,15690
11/12/2020,13,9461,1293,4254,219,122,30,15379
11/12/2020,14,9465,1500,4219,164,11,30,15389
11/12/2020,15,9482,1706,4273,130,153,30,15774
11/12/2020,16,9488,1893,4350,126,54,31,15942
11/12/2020,17,9488,1956,4956,184,28,31,16643
11/12/2020,18,9486,2061,5216,260,0,32,17055
11/12/2020,19,9486,1696,5373,354,0,31,16940
11/12/2020,20,9489,1499,5419,446,0,31,16884
11/12/2020,21,9487,793,4812,634,0,31,15757
11/12/2020,22,9487,472,4657,697,0,31,15344
11/12/2020,23,9496,207,4326,777,0,31,14837
11/12/2020,24,9506,203,4001,729,0,22,14461
11/13/2020,1,9514,205,4023,820,0,17,14579
11/13/2020,2,9524,204,4226,558,0,16,14528
11/13/2020,3,9524,203,4116,487,0,16,14346
11/13/2020,4,9527,203,3845,493,0,16,14084
11/13/2020,5,9530,202,3421,552,0,15,13720
11/13/2020,6,9528,201,3276,449,0,17,13471
11/13/2020,7,9523,204,4022,711,1,24,14485
11/13/2020,8,9522,288,4454,968,6,31,15269
11/13/2020,9,9522,350,4864,988,30,31,15785
11/13/2020,10,9519,436,5439,775,88,36,16293
11/13/2020,11,9524,605,4951,913,139,41,16173
11/13/2020,12,9523,599,4482,1344,74,44,16066
11/13/2020,13,9525,505,4402,1687,88,45,16252
11/13/2020,14,9531,536,4209,2391,159,33,16859
11/13/2020,15,9530,539,4351,2188,85,34,16727
11/13/2020,16,9527,543,4499,2457,35,31,17092
11/13/2020,17,9528,557,5530,2603,6,31,18255
11/13/2020,18,9529,561,5920,2405,0,31,18446
11/13/2020,19,9527,605,6027,2281,0,31,18471
11/13/2020,20,9525,549,5503,2300,0,30,17907
11/13/2020,21,9528,541,5484,1933,0,31,17517
11/13/2020,22,9526,342,4860,1779,0,31,16538
11/13/2020,23,9523,198,4837,1464,0,31,16053
11/13/2020,24,9530,147,4141,1167,0,19,15004
11/14/2020,1,9526,143,3727,1025,0,0,14421
11/14/2020,2,9527,142,3623,794,0,1,14087
11/14/2020,3,9531,142,3557,796,0,1,14027
11/14/2020,4,9528,143,3638,842,0,8,14159
11/14/2020,5,9531,141,3559,640,0,4,13875
11/14/2020,6,9530,142,4019,551,0,0,14242
11/14/2020,7,9531,143,4118,396,1,0,14189
11/14/2020,8,9534,143,4844,343,12,0,14876
11/14/2020,9,9537,149,5150,314,120,0,15270
11/14/2020,10,9533,142,4816,297,259,0,15047
11/14/2020,11,9537,146,5055,321,329,0,15388
11/14/2020,12,9535,341,4694,455,346,0,15371
11/14/2020,13,9538,496,4212,564,362,1,15173
11/14/2020,14,9539,726,4160,545,330,1,15301
11/14/2020,15,9536,877,4184,525,243,6,15371
11/14/2020,16,9535,984,4347,678,98,1,15643
11/14/2020,17,9529,1040,4823,832,16,0,16240
11/14/2020,18,9530,1279,5535,1302,0,2,17648
11/14/2020,19,9543,1135,4947,2255,0,9,17889
11/14/2020,20,9543,845,4419,2416,0,5,17228
11/14/2020,21,9544,521,4188,2895,0,0,17148
11/14/2020,22,9533,231,3985,3059,0,0,16808
11/14/2020,23,9541,141,3807,2762,0,0,16251
11/14/2020,24,9541,141,3609,2364,0,0,15655
11/15/2020,1,9542,142,3454,2018,0,0,15156
11/15/2020,2,9540,138,3376,1427,0,0,14481
11/15/2020,3,9525,140,3333,1075,0,0,14073
11/15/2020,4,9525,139,3403,1153,0,0,14220
11/15/2020,5,9523,140,3438,700,0,0,13801
11/15/2020,6,9523,140,3373,894,0,0,13930
11/15/2020,7,9523,141,3459,1273,0,0,14396
11/15/2020,8,9526,139,3584,1706,1,0,14956
11/15/2020,9,9522,141,3724,2272,10,0,15669
11/15/2020,10,9521,141,3657,3043,15,0,16377
11/15/2020,11,9530,139,3619,3770,29,0,17087
11/15/2020,12,9532,139,3605,4150,33,0,17459
11/15/2020,13,9540,141,3941,4109,39,0,17770
11/15/2020,14,9545,141,4251,3512,26,0,17475
11/15/2020,15,9531,141,4173,3254,12,0,17111
11/15/2020,16,9531,212,4289,2641,8,0,16681
11/15/2020,17,9541,306,4598,2501,0,0,16946
11/15/2020,18,9543,367,4708,3039,0,0,17657
11/15/2020,19,9540,370,4570,3090,0,0,17570
11/15/2020,20,9537,369,4520,2929,0,0,17355
11/15/2020,21,9529,371,4771,2142,0,0,16813
11/15/2020,22,9529,370,4507,2003,0,0,16409
11/15/2020,23,9532,367,4358,1472,0,0,15729
11/15/2020,24,9531,235,4332,759,0,0,14857
11/16/2020,1,9525,142,4124,637,0,0,14428
11/16/2020,2,9286,141,3923,769,0,7,14126
11/16/2020,3,9228,141,3769,689,0,11,13838
11/16/2020,4,9216,142,3650,1130,0,10,14148
11/16/2020,5,9230,146,3677,1076,0,14,14143
11/16/2020,6,9485,174,3652,1540,0,17,14868
11/16/2020,7,9545,236,3862,2509,1,25,16178
11/16/2020,8,9524,371,4092,3077,4,32,17100
11/16/2020,9,9522,471,4020,3519,25,32,17589
11/16/2020,10,9548,592,3905,3978,65,33,18121
11/16/2020,11,9547,638,3929,3953,131,32,18230
11/16/2020,12,9543,898,4005,3898,144,33,18521
11/16/2020,13,9544,1183,4140,3996,110,33,19006
11/16/2020,14,9545,1569,3967,3552,95,33,18761
11/16/2020,15,9519,1813,4141,3273,81,32,18859
11/16/2020,16,9533,1823,4338,2699,49,31,18473
11/16/2020,17,9542,1879,4581,2787,9,31,18829
11/16/2020,18,9542,2046,5127,2908,0,31,19654
11/16/2020,19,9543,1981,4670,2796,0,30,19020
11/16/2020,20,9541,1979,4531,2293,0,30,18374
11/16/2020,21,9547,1520,4469,2196,0,30,17762
11/16/2020,22,9545,543,4621,2355,0,30,17094
11/16/2020,23,9545,285,4306,1912,0,30,16078
11/16/2020,24,9547,199,4319,1611,0,21,15697
11/17/2020,1,9545,198,4013,1331,0,15,15102
11/17/2020,2,9545,199,3972,1138,0,15,14869
11/17/2020,3,9547,200,3880,1310,0,15,14952
11/17/2020,4,9548,200,3711,1424,0,16,14899
11/17/2020,5,9549,199,3829,1394,0,15,14986
11/17/2020,6,9544,203,4021,1363,0,17,15148
11/17/2020,7,9544,286,4194,1747,2,24,15797
11/17/2020,8,9471,379,4400,2161,4,32,16447
11/17/2020,9,9456,512,4363,3173,46,32,17582
11/17/2020,10,9459,574,4327,3480,130,32,18002
11/17/2020,11,9461,763,4258,3096,134,32,17744
11/17/2020,12,9461,1058,4295,3275,165,32,18286
11/17/2020,13,9514,1293,4157,3404,168,32,18568
11/17/2020,14,9538,1490,4116,2862,203,32,18241
11/17/2020,15,9537,1503,4141,3208,122,32,18543
11/17/2020,16,9534,1425,4518,2860,71,32,18440
11/17/2020,17,9528,1537,4712,2905,8,33,18723
11/17/2020,18,9528,1588,5039,3042,0,32,19229
11/17/2020,19,9534,1586,4962,2913,0,32,19027
11/17/2020,20,9537,1501,4767,2920,0,32,18757
11/17/2020,21,9538,668,4909,2883,0,32,18030
11/17/2020,22,9542,430,4914,2797,0,32,17715
11/17/2020,23,9532,429,4783,2511,0,32,17287
11/17/2020,24,9538,299,4404,2082,0,21,16344
11/18/2020,1,9511,213,4388,1600,0,17,15729
11/18/2020,2,9522,233,4692,1247,0,17,15711
11/18/2020,3,9546,252,4418,956,0,16,15188
11/18/2020,4,9547,371,4322,782,0,16,15038
11/18/2020,5,9546,536,4273,631,0,16,15002
11/18/2020,6,9540,655,4280,426,0,17,14918
11/18/2020,7,9537,804,4818,620,1,25,15805
11/18/2020,8,9540,1020,5598,594,7,31,16790
11/18/2020,9,9457,1135,5679,530,34,33,16868
11/18/2020,10,9369,1729,5723,433,75,38,17367
11/18/2020,11,9431,1609,5424,395,130,35,17024
11/18/2020,12,9542,1507,5220,490,198,31,16988
11/18/2020,13,9546,1321,5381,660,257,31,17196
11/18/2020,14,9540,1047,4664,953,248,31,16483
11/18/2020,15,9542,1282,4711,1129,224,33,16921
11/18/2020,16,9538,1423,4754,907,104,33,16759
11/18/2020,17,9539,1560,4941,1306,17,31,17394
11/18/2020,18,9543,1646,5653,1693,0,31,18566
11/18/2020,19,9540,1544,4868,2135,0,32,18119
11/18/2020,20,9544,1363,4513,2564,0,32,18016
11/18/2020,21,9541,890,4498,2824,0,32,17785
11/18/2020,22,9543,580,4308,2743,0,32,17206
11/18/2020,23,9547,466,4094,2557,0,32,16696
11/18/2020,24,9547,199,4019,2466,0,22,16253
11/19/2020,1,9556,198,3666,2668,0,17,16105
11/19/2020,2,9556,198,3512,2300,0,16,15582
11/19/2020,3,9553,196,3540,2041,0,15,15345
11/19/2020,4,9553,195,3564,2237,0,15,15564
11/19/2020,5,9553,194,3606,2130,0,16,15499
11/19/2020,6,9552,194,3637,2517,0,19,15919
11/19/2020,7,9549,195,3961,2816,2,26,16549
11/19/2020,8,9546,195,4159,3394,6,31,17331
11/19/2020,9,9540,196,4199,3922,75,31,17963
11/19/2020,10,9542,195,4208,4105,129,33,18212
11/19/2020,11,9549,199,4026,3821,226,31,17852
11/19/2020,12,9552,309,3884,3673,226,31,17675
11/19/2020,13,9550,419,3618,3548,292,33,17460
11/19/2020,14,9550,536,3528,3416,287,32,17349
11/19/2020,15,9550,540,3671,3449,182,31,17423
11/19/2020,16,9553,544,4107,3465,85,31,17785
11/19/2020,17,9552,547,4512,3722,9,31,18373
11/19/2020,18,9546,545,4651,4246,0,31,19019
11/19/2020,19,9551,542,4648,3923,0,32,18696
11/19/2020,20,9548,338,4500,4066,0,32,18484
11/19/2020,21,9547,197,3911,4086,0,32,17773
11/19/2020,22,9547,197,3879,3307,0,32,16962
11/19/2020,23,9551,197,3490,2415,0,32,15685
11/19/2020,24,9552,197,3497,1694,0,22,14962
11/20/2020,1,9551,198,3379,1018,0,17,14163
11/20/2020,2,9550,196,3218,786,0,16,13766
11/20/2020,3,9334,195,3224,711,0,16,13480
11/20/2020,4,9383,197,3363,618,0,16,13577
11/20/2020,5,9344,197,3329,593,0,16,13479
11/20/2020,6,9266,195,3329,970,0,18,13778
11/20/2020,7,9458,196,3468,1763,2,22,14909
11/20/2020,8,9529,196,3893,2669,3,31,16321
11/20/2020,9,9525,196,3939,3759,39,31,17489
11/20/2020,10,9528,195,3915,3562,188,33,17421
11/20/2020,11,9530,201,3957,3073,265,31,17057
11/20/2020,12,9534,294,3950,2722,237,34,16771
11/20/2020,13,9530,365,3972,2964,154,32,17017
11/20/2020,14,9535,487,3653,2859,192,41,16767
11/20/2020,15,9536,538,3672,2466,157,41,16410
11/20/2020,16,9533,541,3783,2523,88,42,16510
11/20/2020,17,9532,541,4206,3007,10,43,17339
11/20/2020,18,9531,541,4306,3321,0,37,17736
11/20/2020,19,9529,536,4560,3214,0,31,17870
11/20/2020,20,9529,534,4512,3012,0,31,17618
11/20/2020,21,9528,342,4755,2845,0,33,17503
11/20/2020,22,9529,195,4342,2497,0,34,16597
11/20/2020,23,9529,192,4043,1937,0,31,15732
11/20/2020,24,9532,140,3658,1157,0,15,14502
11/21/2020,1,9528,137,3437,812,0,1,13915
11/21/2020,2,9533,134,3406,679,0,1,13753
11/21/2020,3,9534,132,3329,554,0,2,13551
11/21/2020,4,9515,138,3316,483,0,2,13454
11/21/2020,5,9461,138,3483,349,0,5,13436
11/21/2020,6,9251,139,3688,774,0,7,13859
11/21/2020,7,9343,138,3800,751,2,5,14039
11/21/2020,8,9558,141,3875,616,4,3,14197
11/21/2020,9,9556,141,4224,578,33,5,14537
11/21/2020,10,9548,196,4470,490,95,1,14800
11/21/2020,11,9556,205,4779,515,119,2,15176
11/21/2020,12,9561,311,5076,518,126,0,15592
11/21/2020,13,9553,465,4806,555,102,0,15481
11/21/2020,14,9553,786,4874,613,91,0,15917
11/21/2020,15,9554,1204,4664,514,75,0,16011
11/21/2020,16,9545,1172,4716,375,36,0,15844
11/21/2020,17,9537,1239,5423,244,4,0,16447
11/21/2020,18,9536,1696,5819,203,0,0,17254
11/21/2020,19,9542,1513,5552,268,0,7,16882
11/21/2020,20,9545,1358,4913,419,0,10,16245
11/21/2020,21,9543,902,4592,490,0,6,15533
11/21/2020,22,9546,237,4726,665,0,7,15181
11/21/2020,23,9525,139,4460,762,0,7,14893
11/21/2020,24,9538,139,4214,641,0,4,14536
11/22/2020,1,9539,143,3889,686,0,6,14263
11/22/2020,2,9535,144,3595,768,0,1,14043
11/22/2020,3,9539,194,3440,857,0,0,14030
11/22/2020,4,9536,209,3499,886,0,0,14130
11/22/2020,5,9539,236,3706,598,0,0,14079
11/22/2020,6,9539,240,3732,837,0,0,14348
11/22/2020,7,9536,290,3818,824,0,0,14468
11/22/2020,8,9537,335,4311,731,1,1,14916
11/22/2020,9,9535,363,4317,866,10,0,15091
11/22/2020,10,9537,423,4418,1493,18,0,15889
11/22/2020,11,9535,578,4623,1632,23,0,16391
11/22/2020,12,9535,916,4794,1449,28,0,16722
11/22/2020,13,9530,1144,5048,1340,25,0,17087
11/22/2020,14,9526,1410,4620,1430,24,0,17010
11/22/2020,15,9531,1479,4972,1553,15,0,17550
11/22/2020,16,9520,1552,4461,1520,13,0,17066
11/22/2020,17,9517,1695,4674,1459,1,1,17347
11/22/2020,18,9519,1803,5373,1536,1,0,18232
11/22/2020,19,9521,1801,4991,1584,1,0,17898
11/22/2020,20,9519,995,4972,1380,0,0,16866
11/22/2020,21,9520,561,5454,1169,0,0,16704
11/22/2020,22,9519,562,5157,1092,0,0,16330
11/22/2020,23,9513,546,4800,1117,0,0,15976
11/22/2020,24,9517,235,4362,1036,0,1,15151
11/23/2020,1,9520,139,4260,947,0,12,14878
11/23/2020,2,9529,140,3828,1185,0,11,14693
11/23/2020,3,9524,141,3600,1425,0,14,14704
11/23/2020,4,9512,143,3547,1228,0,15,14445
11/23/2020,5,9523,202,3782,1264,0,16,14787
11/23/2020,6,9523,165,4188,1014,0,20,14910
11/23/2020,7,9523,289,4523,1306,1,28,15670
11/23/2020,8,9521,343,4574,1550,2,33,16023
11/23/2020,9,9523,556,4636,1677,10,33,16435
11/23/2020,10,9520,668,4840,1845,17,33,16923
11/23/2020,11,9521,880,5077,1950,54,33,17515
11/23/2020,12,9527,1161,5063,2115,74,34,17974
11/23/2020,13,9529,1340,4416,2162,104,34,17585
11/23/2020,14,9526,1608,4492,2380,70,33,18109
11/23/2020,15,9532,1728,4645,2441,65,32,18443
11/23/2020,16,9529,1671,4581,2255,42,32,18110
11/23/2020,17,9529,1693,4679,2218,5,31,18155
11/23/2020,18,9530,1745,5107,2422,0,32,18836
11/23/2020,19,9529,2004,4737,2161,0,32,18463
11/23/2020,20,9531,2004,4563,1666,0,32,17796
11/23/2020,21,9532,1391,4861,1832,0,33,17649
11/23/2020,22,9524,895,4815,1482,0,33,16749
11/23/2020,23,9525,458,4824,1329,0,32,16168
11/23/2020,24,9520,297,4717,1056,0,21,15611
11/24/2020,1,9526,219,4291,845,0,18,14899
11/24/2020,2,9525,264,4342,719,0,16,14866
11/24/2020,3,9532,277,4426,545,0,16,14796
11/24/2020,4,9530,431,4295,480,0,16,14752
11/24/2020,5,9527,845,4109,293,0,16,14790
11/24/2020,6,9471,1218,4247,298,0,17,15251
11/24/2020,7,9463,1469,4524,297,2,27,15782
11/24/2020,8,9438,1635,4959,344,3,31,16410
11/24/2020,9,9437,1623,5201,359,43,31,16694
11/24/2020,10,9450,1650,5093,363,100,31,16687
11/24/2020,11,9450,1734,5060,349,101,32,16726
11/24/2020,12,9503,1617,5054,349,157,32,16712
11/24/2020,13,9531,1741,4994,407,142,30,16845
11/24/2020,14,9525,1582,4756,625,150,30,16668
11/24/2020,15,9524,1717,4594,767,77,30,16709
11/24/2020,16,9530,2048,4598,658,23,32,16889
11/24/2020,17,9529,2042,5316,1080,1,32,18000
11/24/2020,18,9526,2117,5718,1348,0,31,18740
11/24/2020,19,9527,2054,5436,1592,0,31,18640
11/24/2020,20,9524,2014,4747,1862,0,31,18178
11/24/2020,21,9518,2003,4523,2106,0,32,18182
11/24/2020,22,9506,1082,4437,1687,0,33,16745
11/24/2020,23,9499,306,4428,2055,0,33,16321
11/24/2020,24,9508,198,4413,1881,0,17,16017
11/25/2020,1,9510,205,4198,1905,0,17,15835
11/25/2020,2,9514,285,4207,1627,0,16,15649
11/25/2020,3,9522,342,3990,1586,0,15,15455
11/25/2020,4,9528,470,3498,1519,0,16,15031
11/25/2020,5,9531,754,3481,1086,0,16,14868
11/25/2020,6,9531,1206,3898,692,0,18,15345
11/25/2020,7,9532,1664,4246,1118,0,23,16583
11/25/2020,8,9528,1742,4608,1864,1,31,17774
11/25/2020,9,9524,1740,4945,2051,5,33,18298
11/25/2020,10,9517,1829,5288,1730,14,32,18410
11/25/2020,11,9513,1710,5360,1825,34,32,18474
11/25/2020,12,9511,1679,5322,1791,47,32,18382
11/25/2020,13,9523,1749,5250,1348,38,32,17940
11/25/2020,14,9527,2061,5400,1113,33,33,18167
11/25/2020,15,9523,1880,5046,1097,19,34,17599
11/25/2020,16,9523,1917,4941,1371,8,38,17798
11/25/2020,17,9525,1928,4880,1829,0,32,18194
11/25/2020,18,9524,1933,5120,2029,0,32,18638
11/25/2020,19,9523,1451,4890,2080,0,32,17976
11/25/2020,20,9527,1080,4988,2008,0,32,17635
11/25/2020,21,9523,797,4872,1758,0,32,16982
11/25/2020,22,9523,598,5053,1636,0,33,16843
11/25/2020,23,9526,396,4592,1531,0,33,16078
11/25/2020,24,9523,254,4385,1536,0,24,15722
11/26/2020,1,9526,252,3953,1698,0,19,15448
11/26/2020,2,9526,248,3871,1323,0,16,14984
11/26/2020,3,9525,355,3472,1473,0,16,14841
11/26/2020,4,9517,480,3470,1402,0,16,14885
11/26/2020,5,9522,665,3483,1291,0,16,14977
11/26/2020,6,9505,864,3885,907,0,19,15180
11/26/2020,7,9512,988,4365,780,0,30,15675
11/26/2020,8,9499,1076,4690,1081,1,38,16385
11/26/2020,9,9496,1081,4662,1392,4,31,16666
11/26/2020,10,9495,1191,4972,1391,11,32,17092
11/26/2020,11,9496,1394,4752,1515,29,31,17217
11/26/2020,12,9511,1530,4661,1560,42,31,17335
11/26/2020,13,9513,1364,4559,1899,36,31,17402
11/26/2020,14,9511,1151,4690,1544,32,31,16959
11/26/2020,15,9513,1108,5052,1588,22,31,17314
11/26/2020,16,9507,1168,4680,1548,10,31,16944
11/26/2020,17,9501,1218,5299,1459,0,29,17506
11/26/2020,18,9498,1219,5696,1539,0,31,17983
11/26/2020,19,9498,1219,5573,1350,0,31,17671
11/26/2020,20,9500,1056,5335,1383,0,31,17305
11/26/2020,21,9496,689,5333,1368,0,31,16917
11/26/2020,22,9499,551,5028,1465,0,30,16573
11/26/2020,23,9499,346,4483,1595,0,30,15953
11/26/2020,24,9500,200,4348,1349,0,25,15422
11/27/2020,1,9502,200,4219,1042,0,14,14977
11/27/2020,2,9503,201,4330,829,0,13,14876
11/27/2020,3,9499,279,4251,742,0,13,14784
11/27/2020,4,9500,367,4161,460,0,13,14501
11/27/2020,5,9489,429,4178,507,0,14,14617
11/27/2020,6,9489,436,4167,350,0,18,14460
11/27/2020,7,9492,496,4372,414,1,25,14800
11/27/2020,8,9490,689,4798,729,2,31,15739
11/27/2020,9,9484,884,5381,565,13,31,16358
11/27/2020,10,9482,1267,5403,494,31,31,16708
11/27/2020,11,9478,1115,5072,650,68,31,16414
11/27/2020,12,9474,1285,4765,903,87,31,16545
11/27/2020,13,9474,1479,4510,1045,81,31,16620
11/27/2020,14,9477,1585,4809,1044,61,31,17007
11/27/2020,15,9476,1561,4501,1057,40,31,16666
11/27/2020,16,9477,1455,4651,908,17,32,16540
11/27/2020,17,9475,1471,5152,898,0,31,17027
11/27/2020,18,9473,1481,5149,962,0,31,17096
11/27/2020,19,9472,1458,5028,834,0,34,16826
11/27/2020,20,9472,1459,5031,978,0,33,16973
11/27/2020,21,9459,940,4772,1037,0,32,16240
11/27/2020,22,9465,593,4458,985,0,32,15533
11/27/2020,23,9471,338,4302,931,0,32,15074
11/27/2020,24,9456,195,4276,877,0,18,14822
11/28/2020,1,9475,196,4151,785,0,11,14618
11/28/2020,2,9072,196,4143,1373,0,0,14784
11/28/2020,3,9045,194,4116,1564,0,0,14919
11/28/2020,4,9044,196,4178,1111,0,0,14529
11/28/2020,5,9035,196,4174,1127,0,0,14532
11/28/2020,6,9033,196,4368,1208,0,0,14805
11/28/2020,7,9036,196,4344,1071,0,0,14647
11/28/2020,8,9033,196,4345,1473,2,0,15049
11/28/2020,9,9027,194,4463,1436,54,15,15189
11/28/2020,10,9028,192,4531,1420,186,45,15402
11/28/2020,11,9028,200,4348,1387,297,51,15311
11/28/2020,12,9032,313,4324,1749,321,51,15790
11/28/2020,13,9034,420,4335,2056,309,52,16206
11/28/2020,14,9035,532,4301,2076,296,56,16296
11/28/2020,15,8964,537,4331,2235,215,54,16336
11/28/2020,16,9033,536,4660,2445,97,57,16828
11/28/2020,17,9028,536,4773,2540,13,57,16947
11/28/2020,18,9026,537,4748,3289,0,53,17653
11/28/2020,19,9030,537,4755,3364,0,56,17742
11/28/2020,20,9036,537,4654,3599,0,63,17889
11/28/2020,21,9032,533,4661,3653,0,23,17902
11/28/2020,22,9033,442,4205,3636,0,5,17321
11/28/2020,23,9028,287,3892,3311,0,10,16528
11/28/2020,24,9026,192,3892,2491,0,8,15609
11/29/2020,1,9022,192,3663,2202,0,3,15082
11/29/2020,2,9023,191,3663,1766,0,1,14644
11/29/2020,3,9027,191,3570,1617,0,4,14409
11/29/2020,4,9024,193,3550,1581,0,5,14353
11/29/2020,5,9025,192,3522,1424,0,1,14164
11/29/2020,6,9019,191,3512,1716,0,0,14438
11/29/2020,7,9023,191,3934,1670,1,0,14819
11/29/2020,8,9019,190,4100,1999,5,0,15313
11/29/2020,9,9017,189,3985,2174,86,0,15451
11/29/2020,10,9014,190,3731,2401,219,0,15555
11/29/2020,11,9012,261,3648,2518,244,0,15683
11/29/2020,12,9014,418,3733,2477,287,0,15929
11/29/2020,13,9011,604,3773,2267,264,0,15919
11/29/2020,14,8993,832,3868,1976,258,1,15928
11/29/2020,15,8993,842,4099,1991,170,21,16116
11/29/2020,16,9013,844,4341,1954,56,48,16256
11/29/2020,17,9013,841,4730,2310,7,51,16952
11/29/2020,18,9005,845,5280,2951,0,52,18133
11/29/2020,19,8994,846,5492,2845,0,51,18228
11/29/2020,20,8994,653,5034,2822,0,57,17560
11/29/2020,21,8995,535,5390,2367,0,55,17342
11/29/2020,22,8999,440,5558,2085,0,54,17136
11/29/2020,23,8990,416,5158,1645,0,54,16263
11/29/2020,24,9000,285,4977,1190,0,17,15469
11/30/2020,1,9005,189,5041,817,0,0,15052
11/30/2020,2,9001,216,4843,874,0,0,14934
11/30/2020,3,9001,248,4328,957,0,0,14534
11/30/2020,4,9001,414,4216,763,0,14,14408
11/30/2020,5,9003,735,4124,750,0,19,14631
11/30/2020,6,9001,1029,4196,798,0,39,15063
11/30/2020,7,9019,1099,4364,1146,0,74,15702
11/30/2020,8,9028,1137,4110,1855,0,85,16215
11/30/2020,9,9018,1162,4059,1992,1,87,16319
11/30/2020,10,9022,1195,4110,2155,7,106,16595
11/30/2020,11,9026,1393,3947,2528,15,89,16998
11/30/2020,12,9027,1521,3817,2876,18,84,17343
11/30/2020,13,9026,1108,3796,3094,20,83,17127
11/30/2020,14,9028,1037,3802,3761,20,83,17731
11/30/2020,15,9028,1167,3720,3751,12,83,17761
11/30/2020,16,9025,1315,3848,3498,8,83,17777
11/30/2020,17,9024,1358,4160,3586,0,85,18213
11/30/2020,18,9023,1266,4159,3913,0,87,18448
11/30/2020,19,9025,1129,4055,3289,0,83,17581
11/30/2020,20,9027,968,4068,3305,0,82,17450
11/30/2020,21,9029,753,4115,3527,0,81,17505
11/30/2020,22,9033,676,4087,3354,0,81,17231
11/30/2020,23,9038,240,3832,3495,0,82,16687
11/30/2020,24,9039,188,3783,2624,0,36,15670
12/1/2020,1,9043,274,3533,1852,0,19,14721
12/1/2020,2,9043,339,3538,1505,0,17,14442
12/1/2020,3,9046,404,3602,1356,0,17,14425
12/1/2020,4,9043,405,3281,1322,0,18,14069
12/1/2020,5,9045,405,3378,1458,0,19,14305
12/1/2020,6,9039,406,3462,1951,0,21,14879
12/1/2020,7,9043,423,3503,2632,0,33,15634
12/1/2020,8,9041,475,3856,3069,0,84,16525
12/1/2020,9,9037,476,4035,3079,1,108,16736
12/1/2020,10,9037,478,4133,3168,5,113,16934
12/1/2020,11,9035,565,3926,3403,13,100,17042
12/1/2020,12,9037,736,4199,3408,18,90,17488
12/1/2020,13,9032,986,4092,3462,33,48,17653
12/1/2020,14,9026,1362,4215,3340,16,32,17991
12/1/2020,15,9033,1481,4115,3034,12,32,17707
12/1/2020,16,9038,1535,4144,2877,5,32,17631
12/1/2020,17,9029,1510,4217,3046,0,32,17834
12/1/2020,18,9025,1515,4320,3492,0,32,18384
12/1/2020,19,9024,1533,4314,3601,0,32,18504
12/1/2020,20,9025,1304,4180,3596,0,31,18136
12/1/2020,21,9031,933,4259,3641,0,31,17895
12/1/2020,22,9023,931,3947,3599,0,33,17533
12/1/2020,23,9029,764,3720,3468,0,44,17025
12/1/2020,24,9029,515,3797,2981,0,71,16393
12/2/2020,1,9036,335,3613,2422,0,69,15475
12/2/2020,2,9040,261,3479,2292,0,63,15135
12/2/2020,3,9036,347,3649,1752,0,64,14848
12/2/2020,4,9033,411,3638,1839,0,68,14989
12/2/2020,5,9036,470,3676,1712,0,70,14964
12/2/2020,6,9034,470,3866,1853,0,72,15295
12/2/2020,7,9035,476,4185,2775,0,82,16553
12/2/2020,8,9033,477,4175,3256,1,85,17027
12/2/2020,9,9025,476,4157,3279,7,85,17029
12/2/2020,10,9013,549,4136,3277,31,85,17091
12/2/2020,11,9011,422,4032,3134,67,61,16727
12/2/2020,12,8209,509,3887,3058,93,85,15841
12/2/2020,13,8768,856,4101,3062,120,88,16995
12/2/2020,14,8898,1217,4019,2813,152,92,17191
12/2/2020,15,9018,945,4232,3033,138,91,17457
12/2/2020,16,9020,990,4238,2510,79,89,16926
12/2/2020,17,9021,1016,4217,2871,14,89,17228
12/2/2020,18,9019,1023,4466,3526,0,89,18123
12/2/2020,19,9018,1016,4226,3642,0,89,17991
12/2/2020,20,9016,1006,4256,3740,0,88,18106
12/2/2020,21,9017,1005,4198,3011,0,88,17319
12/2/2020,22,9017,442,4093,2984,0,46,16582
12/2/2020,23,9019,253,3935,2905,0,32,16144
12/2/2020,24,9020,254,3765,2567,0,22,15628
12/3/2020,1,9019,254,3813,2118,0,18,15222
12/3/2020,2,9021,253,3597,1957,0,18,14846
12/3/2020,3,9020,305,3551,1886,0,19,14781
12/3/2020,4,9016,313,3507,1557,0,18,14411
12/3/2020,5,9022,350,3640,1512,0,18,14542
12/3/2020,6,9023,487,3728,1905,0,18,15161
12/3/2020,7,9020,626,3683,3072,2,26,16429
12/3/2020,8,9022,758,4000,3527,3,29,17339
12/3/2020,9,9025,767,4037,3272,42,27,17170
12/3/2020,10,9019,918,3888,3022,142,27,17016
12/3/2020,11,9019,1046,3710,2916,208,27,16926
12/3/2020,12,9018,1158,3710,3214,196,27,17323
12/3/2020,13,9017,1062,3660,3252,189,27,17207
12/3/2020,14,9016,943,3824,2952,181,31,16947
12/3/2020,15,9014,951,3860,3299,137,80,17341
12/3/2020,16,9011,1093,3969,2977,49,79,17178
12/3/2020,17,9008,1219,4104,3089,4,80,17504
12/3/2020,18,9015,1220,4465,3500,0,81,18281
12/3/2020,19,9018,1126,4224,3497,0,83,17948
12/3/2020,20,9018,764,4344,3448,0,82,17656
12/3/2020,21,9016,692,4148,3494,0,83,17433
12/3/2020,22,9018,690,4278,3041,0,45,17072
12/3/2020,23,9020,456,4141,2796,0,32,16445
12/3/2020,24,9025,254,3866,2776,0,23,15944
12/4/2020,1,9024,255,3888,2314,0,19,15500
12/4/2020,2,9029,257,3520,2268,0,20,15094
12/4/2020,3,9034,259,3395,2288,0,20,14996
12/4/2020,4,9036,342,3454,2267,0,17,15116
12/4/2020,5,9049,423,3586,2211,0,17,15286
12/4/2020,6,9044,533,3775,2541,0,18,15911
12/4/2020,7,9045,715,3754,2922,0,24,16460
12/4/2020,8,9045,965,3992,2974,1,31,17008
12/4/2020,9,9042,1010,4009,3030,8,31,17130
12/4/2020,10,9038,1133,3802,3237,21,31,17262
12/4/2020,11,9038,1324,3872,3090,27,52,17403
12/4/2020,12,9032,1639,4056,2963,28,81,17799
12/4/2020,13,9035,1691,4478,2597,29,83,17913
12/4/2020,14,8898,2187,4811,1500,20,105,17521
12/4/2020,15,8928,2128,4690,979,22,157,16904
12/4/2020,16,8914,2073,4819,905,16,174,16901
12/4/2020,17,8944,2573,4847,711,1,196,17272
12/4/2020,18,9040,2905,4908,724,0,211,17788
12/4/2020,19,9044,2654,4904,780,0,198,17580
12/4/2020,20,9044,2107,5502,742,0,131,17526
12/4/2020,21,9046,1943,5517,832,0,83,17421
12/4/2020,22,9045,1521,5180,822,0,82,16650
12/4/2020,23,9046,767,4956,708,0,85,15562
12/4/2020,24,9040,374,4427,712,0,68,14621
12/5/2020,1,9058,222,4126,873,0,50,14329
12/5/2020,2,9059,196,3650,932,0,8,13845
12/5/2020,3,9063,285,3644,1143,0,0,14135
12/5/2020,4,9067,556,3613,1201,0,0,14437
12/5/2020,5,9069,861,3540,1243,0,0,14713
12/5/2020,6,9070,1222,3593,990,0,1,14876
12/5/2020,7,9070,1245,3685,1093,1,4,15098
12/5/2020,8,9071,1239,4170,1481,2,23,15986
12/5/2020,9,9067,1241,4386,1408,9,52,16163
12/5/2020,10,9056,1245,4390,1423,26,55,16195
12/5/2020,11,9054,1246,4602,1529,76,54,16561
12/5/2020,12,9052,1212,4611,1489,99,53,16516
12/5/2020,13,9053,1319,4632,1474,100,54,16632
12/5/2020,14,9056,1296,4775,1518,94,53,16792
12/5/2020,15,9054,1173,4315,1606,103,57,16308
12/5/2020,16,9053,1146,4779,1564,26,57,16625
12/5/2020,17,9055,1196,5625,1392,3,74,17345
12/5/2020,18,9052,1692,5954,1369,0,147,18214
12/5/2020,19,9056,1387,5965,1302,0,153,17863
12/5/2020,20,9054,1009,5535,1306,0,84,16988
12/5/2020,21,9051,850,5291,1248,0,51,16491
12/5/2020,22,9051,750,4977,1044,0,61,15883
12/5/2020,23,9052,675,4637,880,0,70,15314
12/5/2020,24,9052,340,4279,699,0,51,14421
12/6/2020,1,9052,284,4093,689,0,51,14169
12/6/2020,2,9042,301,3772,675,0,10,13800
12/6/2020,3,9051,635,3821,508,0,0,14015
12/6/2020,4,9050,1006,3572,333,0,0,13961
12/6/2020,5,9049,1235,3573,316,0,0,14173
12/6/2020,6,9057,1242,3667,304,0,0,14270
12/6/2020,7,9059,1233,3936,329,0,0,14557
12/6/2020,8,9062,1237,4237,332,3,0,14871
12/6/2020,9,9059,1250,4589,279,31,0,15208
12/6/2020,10,9052,1352,4346,274,77,0,15101
12/6/2020,11,9050,1289,4332,294,135,0,15100
12/6/2020,12,9051,1344,4502,233,204,0,15334
12/6/2020,13,9055,1635,4297,210,222,1,15420
12/6/2020,14,9054,1778,4395,204,196,31,15658
12/6/2020,15,9057,1780,4760,237,129,91,16054
12/6/2020,16,9052,1793,4812,262,62,87,16068
12/6/2020,17,9044,1905,5730,260,5,89,17033
12/6/2020,18,9045,2537,5899,202,0,163,17846
12/6/2020,19,9048,2150,5960,210,0,155,17523
12/6/2020,20,9051,1746,5779,240,0,114,16930
12/6/2020,21,9045,1839,5586,248,0,99,16817
12/6/2020,22,9045,1575,5134,266,0,59,16079
12/6/2020,23,9050,1154,4577,224,0,50,15055
12/6/2020,24,9063,1083,3972,221,0,51,14390
12/7/2020,1,9078,1033,3766,218,0,54,14149
12/7/2020,2,9076,1031,3644,291,0,63,14105
12/7/2020,3,9077,1241,3703,367,0,66,14454
12/7/2020,4,9072,1515,3870,306,0,64,14827
12/7/2020,5,9086,1791,4162,380,0,64,15483
12/7/2020,6,9127,1784,4437,420,0,73,15841
12/7/2020,7,9085,1767,4920,414,1,81,16268
12/7/2020,8,9081,1861,5547,414,5,110,17018
12/7/2020,9,9060,2205,5382,419,57,177,17300
12/7/2020,10,9070,2281,4860,419,106,198,16934
12/7/2020,11,9084,2353,4492,432,224,198,16783
12/7/2020,12,9083,1990,4388,687,295,154,16597
12/7/2020,13,9079,1816,4212,1119,305,89,16620
12/7/2020,14,9078,1750,4137,1291,244,89,16589
12/7/2020,15,9081,1909,4563,1283,162,88,17086
12/7/2020,16,9082,2099,4824,1691,59,89,17844
12/7/2020,17,9080,2185,5169,2022,10,87,18553
12/7/2020,18,9082,2315,5805,2215,0,88,19505
12/7/2020,19,9097,2142,5597,2335,0,88,19259
12/7/2020,20,9096,2132,5455,2282,0,88,19053
12/7/2020,21,9095,2149,5357,2164,0,107,18872
12/7/2020,22,9099,1910,5135,1759,0,144,18047
12/7/2020,23,9095,1279,4764,1565,0,136,16839
12/7/2020,24,9097,931,4605,1412,0,100,16145
12/8/2020,1,9099,851,4283,1255,0,78,15566
12/8/2020,2,9101,861,4259,1107,0,72,15400
12/8/2020,3,9099,975,4168,1023,0,72,15337
12/8/2020,4,9103,1195,3950,985,0,72,15305
12/8/2020,5,9103,1521,4169,877,0,73,15743
12/8/2020,6,9110,1798,4554,826,0,87,16375
12/8/2020,7,9099,1968,5074,664,0,89,16894
12/8/2020,8,9025,2056,5584,792,0,135,17592
12/8/2020,9,8998,2019,5630,955,36,129,17767
12/8/2020,10,8995,2101,5628,600,135,147,17606
12/8/2020,11,8994,2086,5196,805,190,206,17477
12/8/2020,12,8988,1898,4501,1228,249,122,16986
12/8/2020,13,8992,1873,4922,825,311,90,17013
12/8/2020,14,8997,1892,4965,710,278,141,16983
12/8/2020,15,9000,1957,4866,1046,164,115,17148
12/8/2020,16,9001,2088,4841,1463,47,88,17528
12/8/2020,17,9003,2131,5475,1886,3,109,18607
12/8/2020,18,9037,2185,5576,2630,0,152,19580
12/8/2020,19,9117,2093,5216,2972,0,100,19498
12/8/2020,20,9117,1885,4770,3016,0,87,18875
12/8/2020,21,9116,1163,4627,3053,0,87,18046
12/8/2020,22,9116,598,4421,3150,0,85,17370
12/8/2020,23,9116,285,3899,3168,0,87,16555
12/8/2020,24,9123,191,3808,2959,0,38,16119
12/9/2020,1,9126,195,3860,2907,0,17,16105
12/9/2020,2,9127,212,3934,3176,0,16,16465
12/9/2020,3,9125,300,3819,3116,0,16,16376
12/9/2020,4,9123,562,3488,3248,0,15,16436
12/9/2020,5,9122,808,3533,3207,0,16,16686
12/9/2020,6,9122,958,3838,2599,0,19,16536
12/9/2020,7,9119,1230,4212,2392,0,49,17002
12/9/2020,8,9115,1228,4572,2546,0,81,17542
12/9/2020,9,9111,1218,4759,2493,1,84,17666
12/9/2020,10,9110,1333,4921,2410,5,83,17862
12/9/2020,11,9109,1671,4769,2429,11,83,18072
12/9/2020,12,9114,2092,4853,2198,16,83,18356
12/9/2020,13,9110,2108,4591,2161,23,83,18076
12/9/2020,14,9107,2117,4644,2234,26,83,18211
12/9/2020,15,9100,2204,4393,2076,17,83,17873
12/9/2020,16,9097,2238,4303,2010,8,83,17739
12/9/2020,17,9108,2289,4959,1957,1,83,18397
12/9/2020,18,9112,2594,5646,1832,0,84,19268
12/9/2020,19,9129,2447,5738,1810,0,83,19207
12/9/2020,20,9131,2409,5606,1571,0,87,18804
12/9/2020,21,9133,2231,5400,1384,0,87,18235
12/9/2020,22,9127,2151,5045,1296,0,87,17706
12/9/2020,23,9126,1279,4624,1302,0,87,16418
12/9/2020,24,9127,1027,4124,1183,0,34,15495
12/10/2020,1,9127,894,3420,1186,0,17,14644
12/10/2020,2,9125,897,3369,863,0,16,14270
12/10/2020,3,9134,966,3576,789,0,16,14481
12/10/2020,4,9131,1051,3554,621,0,16,14373
12/10/2020,5,9134,1109,3495,626,0,16,14380
12/10/2020,6,9132,1220,3541,566,0,20,14479
12/10/2020,7,9132,1556,4149,577,1,50,15465
12/10/2020,8,9126,1833,4720,492,2,84,16257
12/10/2020,9,9129,2733,5027,327,14,172,17402
12/10/2020,10,9129,2786,4940,277,49,197,17378
12/10/2020,11,9138,2376,4742,301,90,192,16839
12/10/2020,12,9137,2329,4635,352,170,216,16839
12/10/2020,13,9132,2232,4540,484,199,152,16739
12/10/2020,14,9131,2277,4377,571,153,136,16645
12/10/2020,15,9132,2527,4297,555,104,135,16750
12/10/2020,16,9128,2379,4255,626,35,107,16530
12/10/2020,17,9137,2320,4828,813,6,87,17191
12/10/2020,18,8989,2787,5665,1370,0,120,18931
12/10/2020,19,8327,2721,5570,1730,0,88,18436
12/10/2020,20,8325,2426,5474,1903,0,89,18217
12/10/2020,21,8323,2150,4748,2210,0,86,17517
12/10/2020,22,8321,1881,4614,2410,0,87,17313
12/10/2020,23,8319,1632,3817,2386,0,88,16242
12/10/2020,24,8316,1069,3607,1950,0,84,15026
12/11/2020,1,8322,377,3574,2245,0,85,14603
12/11/2020,2,8323,255,3505,1975,0,39,14097
12/11/2020,3,8331,435,3470,2093,0,17,14346
12/11/2020,4,8331,824,3429,1752,0,17,14353
12/11/2020,5,8331,1223,3486,1497,0,17,14554
12/11/2020,6,8331,1609,3547,1365,0,19,14871
12/11/2020,7,8328,1656,4099,1251,1,26,15361
12/11/2020,8,8320,1813,4914,1037,2,32,16118
12/11/2020,9,8321,2178,5039,875,30,32,16475
12/11/2020,10,8321,2446,5024,691,106,32,16620
12/11/2020,11,8319,2192,4770,455,204,32,15972
12/11/2020,12,8322,2015,4592,348,244,32,15553
12/11/2020,13,8327,2124,4791,273,207,32,15754
12/11/2020,14,8327,2297,4744,289,171,32,15860
12/11/2020,15,8327,2448,4672,379,95,32,15953
12/11/2020,16,8327,2584,4774,378,42,32,16137
12/11/2020,17,8327,2826,5303,446,4,32,16938
12/11/2020,18,8326,3192,5832,831,0,32,18213
12/11/2020,19,8330,2704,5394,1123,0,32,17583
12/11/2020,20,8326,2084,5108,1389,0,32,16939
12/11/2020,21,8324,2089,4925,1324,0,32,16694
12/11/2020,22,8329,1572,4717,1304,0,32,15954
12/11/2020,23,8328,1103,4054,1194,0,32,14711
12/11/2020,24,8328,627,4037,1430,0,15,14437
12/12/2020,1,8324,296,3718,1709,0,0,14047
12/12/2020,2,8326,234,3362,1477,0,0,13399
12/12/2020,3,8322,233,3297,1859,0,0,13711
12/12/2020,4,8316,240,3375,2080,0,0,14011
12/12/2020,5,8319,303,3313,2430,0,0,14365
12/12/2020,6,8329,404,3391,2423,0,0,14547
12/12/2020,7,8328,519,3517,1985,0,0,14349
12/12/2020,8,8329,524,3510,2401,2,3,14769
12/12/2020,9,8327,524,3971,3072,5,2,15901
12/12/2020,10,8317,523,3890,3211,23,7,15971
12/12/2020,11,8308,522,4070,3435,30,47,16412
12/12/2020,12,8310,522,4421,3539,26,62,16880
12/12/2020,13,8310,321,4173,3737,33,60,16634
12/12/2020,14,8311,205,4444,3820,38,56,16874
12/12/2020,15,8311,206,4470,4011,28,56,17082
12/12/2020,16,8310,206,4437,4136,20,56,17165
12/12/2020,17,8313,206,4760,4068,4,56,17407
12/12/2020,18,8314,206,5097,4136,0,57,17810
12/12/2020,19,8316,202,4784,4143,0,57,17502
12/12/2020,20,8318,203,4355,4134,0,57,17067
12/12/2020,21,8319,205,3930,4113,0,21,16588
12/12/2020,22,8321,205,3783,3985,0,0,16294
12/12/2020,23,8319,205,3654,3819,0,0,15997
12/12/2020,24,8319,205,3582,3324,0,0,15430
12/13/2020,1,8317,206,3420,3055,0,0,14998
12/13/2020,2,8310,208,3390,2725,0,0,14633
12/13/2020,3,8318,208,3443,2475,0,0,14444
12/13/2020,4,8307,263,3293,2311,0,0,14174
12/13/2020,5,8308,308,3366,2313,0,0,14295
12/13/2020,6,8307,519,3460,2104,0,0,14390
12/13/2020,7,8317,926,3698,1730,0,0,14671
12/13/2020,8,8319,1156,3821,1581,1,0,14878
12/13/2020,9,8319,1181,4080,1526,15,0,15121
12/13/2020,10,8321,1348,4618,1519,65,0,15871
12/13/2020,11,8322,1422,4616,1353,62,2,15777
12/13/2020,12,8323,1528,4695,1272,78,3,15899
12/13/2020,13,8324,1826,4912,1005,73,0,16140
12/13/2020,14,8323,2099,4974,695,64,1,16156
12/13/2020,15,8280,2294,4939,681,50,30,16274
12/13/2020,16,8325,2306,4805,526,36,56,16054
12/13/2020,17,8323,2730,5474,355,4,74,16960
12/13/2020,18,8321,3364,5525,378,0,111,17699
12/13/2020,19,8296,3215,5588,366,0,79,17544
12/13/2020,20,8325,3155,5375,324,0,55,17234
12/13/2020,21,8323,2623,5187,272,0,58,16463
12/13/2020,22,8326,2122,4868,273,0,17,15606
12/13/2020,23,8323,1401,4716,345,0,0,14785
12/13/2020,24,8322,840,4673,391,0,0,14226
12/14/2020,1,8324,561,4403,434,0,0,13722
12/14/2020,2,8320,374,4079,452,0,13,13238
12/14/2020,3,8324,582,3898,420,0,16,13240
12/14/2020,4,8324,1054,3597,462,0,18,13455
12/14/2020,5,8327,1603,3459,635,0,18,14042
12/14/2020,6,8327,1687,3487,544,0,18,14063
12/14/2020,7,8325,1685,3995,739,0,25,14769
12/14/2020,8,8327,1669,4575,1352,1,31,15955
12/14/2020,9,8321,1661,4537,2419,4,31,16973
12/14/2020,10,8320,1663,4372,2821,16,31,17223
12/14/2020,11,8321,1662,3988,3317,36,31,17355
12/14/2020,12,8318,1649,4078,3463,37,31,17576
12/14/2020,13,8316,1536,4094,3803,44,31,17824
12/14/2020,14,8309,1669,3672,3867,66,32,17615
12/14/2020,15,8306,1703,4007,3482,65,33,17596
12/14/2020,16,8314,1819,4260,3019,41,31,17484
12/14/2020,17,8322,1991,4951,3582,4,31,18881
12/14/2020,18,8322,2238,5961,3702,0,31,20254
12/14/2020,19,8326,2459,5938,3598,0,32,20353
12/14/2020,20,8325,1707,5720,3507,1,32,19292
12/14/2020,21,8378,1257,4830,3447,0,32,17944
12/14/2020,22,8586,1213,4547,3176,0,32,17554
12/14/2020,23,8740,1206,4546,2737,0,32,17261
12/14/2020,24,8727,1010,4313,2460,0,24,16534
12/15/2020,1,8770,944,3808,2176,0,16,15714
12/15/2020,2,8900,1143,3605,1967,0,15,15630
12/15/2020,3,8899,1413,3616,1457,0,15,15400
12/15/2020,4,8900,1501,3440,1229,0,15,15085
12/15/2020,5,8901,1537,3616,1086,0,16,15156
12/15/2020,6,8905,1777,3660,1063,0,20,15425
12/15/2020,7,8903,1925,4198,1173,2,26,16227
12/15/2020,8,8830,2160,4960,1367,3,32,17352
12/15/2020,9,8800,2944,4777,1222,50,53,17846
12/15/2020,10,8799,3260,4528,840,147,96,17670
12/15/2020,11,8800,3538,4484,558,227,152,17759
12/15/2020,12,8795,3348,4564,283,234,146,17370
12/15/2020,13,8798,3205,4445,103,244,130,16925
12/15/2020,14,8978,3154,4594,89,203,150,17168
12/15/2020,15,9063,3274,4907,58,135,147,17584
12/15/2020,16,9063,3786,5191,44,57,134,18275
12/15/2020,17,9077,4279,5580,128,4,169,19237
12/15/2020,18,9080,4799,5588,333,0,202,20002
12/15/2020,19,9078,4527,5618,551,0,183,19957
12/15/2020,20,9085,4049,5635,819,0,125,19713
12/15/2020,21,9098,3347,5568,1078,0,109,19200
12/15/2020,22,9095,2724,4876,1289,0,174,18158
12/15/2020,23,9090,1854,4173,1521,0,126,16764
12/15/2020,24,9094,1160,3754,1605,0,37,15650
12/16/2020,1,9086,1061,3232,1834,0,16,15229
12/16/2020,2,9098,1137,3209,1777,0,14,15235
12/16/2020,3,9106,1230,3101,2044,0,13,15494
12/16/2020,4,9122,1372,3122,2024,0,13,15653
12/16/2020,5,9118,1493,3139,2454,0,14,16218
12/16/2020,6,9117,1975,3451,2682,0,19,17244
12/16/2020,7,9112,2217,4049,3073,0,23,18474
12/16/2020,8,9111,2558,4984,3435,2,29,20119
12/16/2020,9,9106,3009,4842,3534,7,51,20549
12/16/2020,10,9102,2806,4543,3556,30,72,20109
12/16/2020,11,9098,3032,4316,3419,61,91,20017
12/16/2020,12,9099,3237,4360,3151,72,73,19992
12/16/2020,13,9101,3855,4552,2895,77,119,20599
12/16/2020,14,8968,3914,4637,2889,58,97,20563
12/16/2020,15,8999,4169,5120,2708,47,116,21159
12/16/2020,16,9104,4569,5478,2518,25,153,21847
12/16/2020,17,9107,4636,5735,2516,1,171,22166
12/16/2020,18,9106,4843,5646,2759,0,209,22563
12/16/2020,19,9108,4648,5656,2684,0,158,22254
12/16/2020,20,9106,4658,5736,2594,0,122,22216
12/16/2020,21,9111,3864,5644,2644,0,84,21347
12/16/2020,22,9108,3435,5168,2526,0,81,20318
12/16/2020,23,9106,2678,4437,2356,0,81,18658
12/16/2020,24,9116,2331,3754,2239,0,73,17513
12/17/2020,1,9115,2230,3233,1917,0,69,16564
12/17/2020,2,9115,2329,3078,1639,0,66,16227
12/17/2020,3,8786,2456,3302,1488,0,66,16098
12/17/2020,4,8692,2641,3041,1067,0,66,15507
12/17/2020,5,8693,2768,3155,1209,0,65,15890
12/17/2020,6,8693,2930,3630,1071,0,67,16391
12/17/2020,7,8697,3841,4651,907,0,75,18171
12/17/2020,8,8698,5109,5390,821,2,119,20139
12/17/2020,9,8697,5047,5274,799,6,114,19937
12/17/2020,10,8685,5110,5279,708,26,89,19897
12/17/2020,11,8689,5293,4997,605,56,88,19728
12/17/2020,12,8693,5254,4840,563,84,88,19522
12/17/2020,13,8694,5641,4857,528,113,136,19969
12/17/2020,14,8698,5131,4975,466,114,95,19479
12/17/2020,15,8698,5014,5176,452,85,81,19506
12/17/2020,16,8701,4519,5456,424,41,107,19248
12/17/2020,17,8699,4809,5903,398,2,101,19912
12/17/2020,18,8698,5554,6040,381,0,140,20813
12/17/2020,19,8699,5420,6023,486,0,123,20751
12/17/2020,20,8705,5075,6048,533,0,114,20475
12/17/2020,21,8699,5467,5755,487,0,162,20570
12/17/2020,22,8704,5395,5293,444,0,178,20014
12/17/2020,23,8701,4042,4874,433,0,104,18154
12/17/2020,24,8696,3090,4798,402,0,81,17067
12/18/2020,1,8702,2974,4099,419,0,78,16272
12/18/2020,2,8707,2939,3784,428,0,75,15933
12/18/2020,3,8702,2963,3833,422,0,75,15995
12/18/2020,4,8702,3045,3819,444,0,75,16085
12/18/2020,5,8712,3598,3585,447,0,83,16425
12/18/2020,6,8705,3663,4223,413,0,72,17076
12/18/2020,7,8706,4147,5189,389,0,85,18516
12/18/2020,8,8709,5087,5548,384,2,155,19885
12/18/2020,9,8709,5051,5340,336,32,194,19662
12/18/2020,10,8704,4902,5189,303,115,117,19330
12/18/2020,11,8712,4628,4879,277,226,99,18821
12/18/2020,12,8714,4423,4710,251,304,98,18500
12/18/2020,13,8712,3835,4472,235,327,96,17677
12/18/2020,14,8706,3606,4448,263,309,83,17415
12/18/2020,15,8703,3767,4549,327,221,81,17648
12/18/2020,16,8702,4058,4726,410,100,81,18077
12/18/2020,17,8705,4397,5177,587,9,81,18956
12/18/2020,18,8703,4852,5599,926,0,81,20161
12/18/2020,19,8709,4392,5811,1199,0,81,20192
12/18/2020,20,8709,3637,5663,1449,0,80,19538
12/18/2020,21,8710,3563,5354,1662,0,83,19372
12/18/2020,22,8706,3234,4827,1769,0,83,18619
12/18/2020,23,8709,2714,4018,2058,0,83,17582
12/18/2020,24,8690,1654,3472,2321,0,71,16208
12/19/2020,1,8702,1211,3214,2567,0,30,15724
12/19/2020,2,8707,1025,3105,2651,0,0,15488
12/19/2020,3,8706,928,3041,2743,0,0,15418
12/19/2020,4,8713,939,3079,2312,0,0,15043
12/19/2020,5,8705,1001,3101,2530,0,0,15337
12/19/2020,6,8712,1142,3057,2634,0,0,15545
12/19/2020,7,8711,1358,3172,2698,0,0,15939
12/19/2020,8,8718,1545,3760,2680,1,0,16704
12/19/2020,9,8718,1559,3800,3004,7,0,17088
12/19/2020,10,8656,1600,3934,2971,30,0,17191
12/19/2020,11,8535,1435,4322,2982,47,0,17321
12/19/2020,12,8582,1848,4581,2511,57,0,17579
12/19/2020,13,8705,1993,4444,2377,52,0,17571
12/19/2020,14,8706,2076,4315,2285,45,0,17427
12/19/2020,15,8709,2085,4253,2221,37,0,17305
12/19/2020,16,8703,2038,4607,2247,20,0,17615
12/19/2020,17,8743,2401,5001,2521,2,0,18668
12/19/2020,18,8803,2896,5241,2524,0,0,19464
12/19/2020,19,8805,2327,5093,2601,0,0,18826
12/19/2020,20,8806,1682,4867,2684,0,0,18039
12/19/2020,21,8803,1334,4800,2514,0,0,17451
12/19/2020,22,8803,794,4834,2213,0,0,16644
12/19/2020,23,8799,777,4121,2224,0,0,15921
12/19/2020,24,8806,472,3619,2246,0,0,15143
12/20/2020,1,8814,203,3397,2187,0,0,14601
12/20/2020,2,8798,202,3086,1844,0,0,13930
12/20/2020,3,8804,204,3130,1582,0,0,13720
12/20/2020,4,8809,203,3212,1398,0,0,13622
12/20/2020,5,8810,203,3086,1404,0,0,13503
12/20/2020,6,8758,232,3102,1650,0,0,13742
12/20/2020,7,8688,233,3274,1623,0,0,13818
12/20/2020,8,8690,235,3455,1745,0,0,14125
12/20/2020,9,8684,294,3896,1907,0,0,14781
12/20/2020,10,8680,468,4462,1897,5,0,15512
12/20/2020,11,8683,672,4950,1856,8,0,16169
12/20/2020,12,8681,1072,4944,1895,13,0,16605
12/20/2020,13,8914,1318,4618,2022,17,0,16889
12/20/2020,14,9020,1575,4277,2317,21,2,17212
12/20/2020,15,9026,1537,4235,2526,14,0,17338
12/20/2020,16,9025,1526,4103,2296,5,0,16955
12/20/2020,17,9033,1526,4482,2687,0,0,17728
12/20/2020,18,9012,1521,5241,2667,0,0,18441
12/20/2020,19,8976,1359,4814,2706,0,0,17855
12/20/2020,20,8968,995,4410,2668,0,0,17041
12/20/2020,21,8962,837,4535,2546,0,0,16880
12/20/2020,22,8952,335,4181,2585,0,0,16053
12/20/2020,23,8960,204,4143,2447,0,0,15754
12/20/2020,24,9117,204,3503,2425,0,0,15249
12/21/2020,1,9238,204,3271,2064,0,0,14777
12/21/2020,2,9335,204,3237,2141,0,7,14924
12/21/2020,3,9322,207,3105,1649,0,11,14294
12/21/2020,4,9319,224,3105,1325,0,12,13985
12/21/2020,5,9321,454,3161,1551,0,12,14499
12/21/2020,6,9322,931,3228,980,0,12,14473
12/21/2020,7,9326,1205,3799,1121,0,21,15472
12/21/2020,8,9331,1437,4765,1071,0,32,16636
12/21/2020,9,9326,1593,5454,913,13,37,17336
12/21/2020,10,9328,1788,5535,785,24,40,17500
12/21/2020,11,9325,2013,5397,676,27,38,17476
12/21/2020,12,9327,2330,5106,837,25,39,17664
12/21/2020,13,9328,2471,4928,993,30,37,17787
12/21/2020,14,9326,2614,4921,971,34,36,17902
12/21/2020,15,9328,2479,5011,934,14,44,17810
12/21/2020,16,9447,2338,5206,886,7,73,17957
12/21/2020,17,9476,2392,5787,827,0,81,18563
12/21/2020,18,9480,2804,6311,641,0,81,19317
12/21/2020,19,9479,2575,6257,513,0,81,18905
12/21/2020,20,9478,2347,6156,525,0,81,18587
12/21/2020,21,9478,2076,5924,512,0,82,18072
12/21/2020,22,9476,2055,5211,488,0,43,17273
12/21/2020,23,9467,1773,4307,619,0,27,16193
12/21/2020,24,9457,1099,3747,788,0,17,15108
12/22/2020,1,9463,544,3704,938,0,12,14661
12/22/2020,2,9476,266,3650,1125,0,12,14529
12/22/2020,3,9485,269,3177,1250,0,12,14193
12/22/2020,4,9512,271,3126,949,0,12,13870
12/22/2020,5,9564,277,3214,1189,0,12,14256
12/22/2020,6,9553,394,3264,1253,0,12,14476
12/22/2020,7,9556,609,3544,1500,1,21,15231
12/22/2020,8,9560,635,4154,1874,1,27,16251
12/22/2020,9,9552,697,4661,1973,14,27,16924
12/22/2020,10,9551,876,4706,1937,89,28,17187
12/22/2020,11,9558,1144,4339,2179,144,28,17392
12/22/2020,12,9552,1258,4279,2945,144,35,18213
12/22/2020,13,9520,1357,4492,2847,87,38,18341
12/22/2020,14,9517,1585,4239,2680,99,45,18165
12/22/2020,15,9516,1668,4267,2379,76,68,17974
12/22/2020,16,9519,1718,4528,1924,47,90,17826
12/22/2020,17,9519,1553,5315,1764,3,90,18244
12/22/2020,18,9540,1778,6432,1342,0,106,19198
12/22/2020,19,9559,1348,6405,1042,0,83,18437
12/22/2020,20,9561,1202,6485,702,0,84,18034
12/22/2020,21,9561,1067,6236,499,0,100,17463
12/22/2020,22,9558,1197,5668,419,0,52,16894
12/22/2020,23,9570,572,5133,550,0,27,15852
12/22/2020,24,9585,271,4330,666,0,18,14870
12/23/2020,1,9587,277,3635,1065,0,13,14577
12/23/2020,2,9592,268,3229,1389,0,12,14490
12/23/2020,3,9589,268,3291,1747,0,12,14907
12/23/2020,4,9592,267,3055,1970,0,13,14897
12/23/2020,5,9592,267,3145,2511,0,12,15527
12/23/2020,6,9527,265,3298,2276,0,13,15379
12/23/2020,7,9523,268,3640,2100,1,19,15551
12/23/2020,8,9522,268,4272,3064,2,26,17154
12/23/2020,9,9524,267,4443,3418,9,27,17688
12/23/2020,10,9524,267,4448,3574,24,27,17864
12/23/2020,11,9519,266,4281,3689,88,26,17869
12/23/2020,12,9523,267,4037,3611,143,26,17607
12/23/2020,13,9528,354,4013,3632,137,27,17691
12/23/2020,14,9634,418,4127,3478,164,27,17848
12/23/2020,15,9651,482,4428,3820,91,30,18502
12/23/2020,16,9631,485,4594,3801,29,31,18571
12/23/2020,17,9635,485,4789,4015,3,31,18958
12/23/2020,18,9639,484,4995,4495,0,31,19644
12/23/2020,19,9639,484,4850,4434,0,30,19437
12/23/2020,20,9646,482,4466,4536,0,30,19160
12/23/2020,21,9652,346,4130,4601,0,31,18760
12/23/2020,22,9646,260,3631,4510,0,31,18078
12/23/2020,23,9646,260,3384,3984,0,30,17304
12/23/2020,24,9644,258,3084,3147,0,21,16154
12/24/2020,1,9646,259,3115,2574,0,17,15611
12/24/2020,2,9686,256,3046,2166,0,16,15170
12/24/2020,3,9759,257,2956,1960,0,15,14947
12/24/2020,4,9824,258,2940,1727,0,16,14765
12/24/2020,5,9825,260,2974,1507,0,15,14581
12/24/2020,6,9824,258,3051,1713,0,19,14865
12/24/2020,7,9829,258,3287,2022,0,23,15419
12/24/2020,8,9840,260,3563,2526,0,31,16220
12/24/2020,9,9891,260,3821,2825,1,32,16830
12/24/2020,10,9923,273,3905,3471,4,32,17608
12/24/2020,11,9921,297,4101,3455,12,31,17817
12/24/2020,12,9912,301,4352,3494,15,31,18105
12/24/2020,13,9911,419,4553,3035,19,31,17968
12/24/2020,14,9905,612,4627,2762,13,31,17950
12/24/2020,15,9916,700,5062,2061,16,31,17786
12/24/2020,16,9920,746,5502,1545,11,31,17755
12/24/2020,17,9955,927,6149,1129,1,31,18192
12/24/2020,18,10025,1007,6216,839,0,31,18118
12/24/2020,19,10026,887,5816,728,0,31,17488
12/24/2020,20,10031,782,5359,757,0,30,16959
12/24/2020,21,10026,554,5003,947,0,30,16560
12/24/2020,22,10027,466,4607,937,0,30,16067
12/24/2020,23,10023,435,4153,858,0,30,15499
12/24/2020,24,10025,216,3939,885,0,17,15082
12/25/2020,1,10022,209,3787,1035,0,4,15057
12/25/2020,2,10007,210,3243,1302,0,0,14762
12/25/2020,3,10020,213,3045,1458,0,0,14736
12/25/2020,4,10016,211,3043,1439,0,0,14709
12/25/2020,5,10019,188,3055,1452,0,0,14714
12/25/2020,6,10020,186,3090,1648,0,0,14944
12/25/2020,7,10039,186,3369,1788,0,0,15382
12/25/2020,8,10039,186,3520,2216,1,0,15962
12/25/2020,9,10044,179,3650,2551,2,0,16426
12/25/2020,10,10038,163,3959,2650,10,0,16820
12/25/2020,11,10040,160,4461,2695,18,0,17374
12/25/2020,12,10042,160,4293,2661,27,0,17183
12/25/2020,13,10048,160,4354,2776,28,0,17366
12/25/2020,14,10045,160,4228,2946,27,2,17408
12/25/2020,15,10042,161,4162,3022,25,1,17413
12/25/2020,16,10046,160,4524,3215,14,0,17959
12/25/2020,17,10045,160,4977,3401,2,0,18585
12/25/2020,18,10043,159,5757,3412,0,0,19371
12/25/2020,19,10045,159,4952,3565,0,0,18721
12/25/2020,20,10041,157,4604,3660,0,0,18462
12/25/2020,21,10042,158,4197,3617,0,0,18014
12/25/2020,22,10039,159,4047,3692,0,0,17937
12/25/2020,23,10037,159,3701,3573,0,0,17470
12/25/2020,24,10033,159,3431,2929,0,0,16552
12/26/2020,1,10031,159,3291,2465,0,0,15946
12/26/2020,2,10025,159,3222,2227,0,0,15633
12/26/2020,3,10092,159,3224,1927,0,0,15402
12/26/2020,4,10138,157,3147,1770,0,0,15212
12/26/2020,5,10137,161,3175,1614,0,0,15087
12/26/2020,6,10154,167,3172,1904,0,0,15397
12/26/2020,7,10171,213,3329,2177,0,0,15890
12/26/2020,8,10172,248,3633,2334,0,0,16387
12/26/2020,9,10172,275,3682,2985,3,0,17117
12/26/2020,10,10172,339,3745,3136,12,0,17404
12/26/2020,11,10191,393,3814,3382,19,0,17799
12/26/2020,12,10193,502,4027,3281,24,0,18027
12/26/2020,13,10189,715,4244,3274,23,0,18445
12/26/2020,14,10179,908,3926,3116,22,0,18151
12/26/2020,15,10145,995,4017,2960,15,0,18132
12/26/2020,16,10194,1153,4364,2758,6,0,18475
12/26/2020,17,10196,1188,5090,2408,0,0,18882
12/26/2020,18,10204,1215,6043,2137,0,0,19599
12/26/2020,19,10211,1219,5715,1920,0,0,19065
12/26/2020,20,10205,1197,5272,1698,0,0,18372
12/26/2020,21,10205,1171,4976,1595,0,0,17947
12/26/2020,22,10200,617,5077,1374,0,0,17268
12/26/2020,23,10200,201,4642,1165,0,0,16208
12/26/2020,24,10200,152,4020,1064,0,0,15436
12/27/2020,1,10210,152,3821,936,0,0,15119
12/27/2020,2,10208,154,3656,818,0,1,14837
12/27/2020,3,10219,154,3567,582,0,1,14523
12/27/2020,4,10216,154,3413,426,0,12,14221
12/27/2020,5,10219,153,3426,376,0,12,14186
12/27/2020,6,10216,152,3212,274,0,10,13864
12/27/2020,7,10217,151,3667,213,0,0,14248
12/27/2020,8,10215,150,4152,321,0,0,14838
12/27/2020,9,10216,181,4257,579,4,0,15237
12/27/2020,10,10228,271,4257,719,11,0,15486
12/27/2020,11,10225,472,4472,1255,25,0,16449
12/27/2020,12,10228,542,4692,1363,34,0,16859
12/27/2020,13,10229,541,4468,1643,46,0,16927
12/27/2020,14,10235,614,4091,1783,51,3,16777
12/27/2020,15,10186,672,4144,1758,28,4,16792
12/27/2020,16,10227,747,4296,1631,17,11,16929
12/27/2020,17,10214,748,4443,2171,3,44,17623
12/27/2020,18,10220,747,4771,3143,0,53,18934
12/27/2020,19,10223,438,4512,3271,0,55,18499
12/27/2020,20,10213,355,4384,3138,0,54,18144
12/27/2020,21,10204,357,4256,3288,0,54,18159
12/27/2020,22,10202,199,3792,3430,0,10,17633
12/27/2020,23,10187,150,3429,3240,0,0,17006
12/27/2020,24,10198,148,3178,2858,0,0,16382
12/28/2020,1,10194,149,3073,2290,0,0,15706
12/28/2020,2,10186,151,3057,1597,0,0,14991
12/28/2020,3,10198,148,3021,1865,0,0,15232
12/28/2020,4,10213,148,3034,1825,0,0,15220
12/28/2020,5,10228,148,2978,1978,0,0,15332
12/28/2020,6,10238,149,3155,2020,0,0,15562
12/28/2020,7,10237,153,3376,2264,0,0,16030
12/28/2020,8,10241,152,3690,2554,0,0,16637
12/28/2020,9,10236,191,3771,2626,1,0,16825
12/28/2020,10,10233,234,3786,3159,7,1,17420
12/28/2020,11,10229,343,3791,3328,18,1,17710
12/28/2020,12,10221,522,3960,3107,24,0,17834
12/28/2020,13,10222,639,3983,3154,34,0,18032
12/28/2020,14,10224,771,4048,2894,40,0,17977
12/28/2020,15,10229,1047,4291,2639,23,0,18229
12/28/2020,16,10217,1101,4494,2235,18,0,18065
12/28/2020,17,10220,1177,4807,1924,4,0,18132
12/28/2020,18,10221,1176,4990,2428,0,0,18815
12/28/2020,19,10222,1183,4879,2483,0,0,18767
12/28/2020,20,10222,1183,4950,2577,0,0,18932
12/28/2020,21,10226,532,4964,2865,0,0,18587
12/28/2020,22,10238,354,4608,3061,0,0,18261
12/28/2020,23,10233,192,3868,2904,0,0,17197
12/28/2020,24,10229,151,3683,2577,0,0,16640
12/29/2020,1,10233,150,3274,2333,0,0,15990
12/29/2020,2,10256,150,3117,2335,0,4,15862
12/29/2020,3,10260,162,3178,2142,0,10,15752
12/29/2020,4,10263,175,3050,2109,0,10,15607
12/29/2020,5,10260,347,3065,2318,0,12,16002
12/29/2020,6,10270,666,3179,1850,0,16,15981
12/29/2020,7,10275,791,3369,1533,0,23,15991
12/29/2020,8,10278,896,3968,1515,1,22,16680
12/29/2020,9,10273,916,4361,1278,14,13,16855
12/29/2020,10,10277,965,5081,1063,61,15,17462
12/29/2020,11,10278,939,4605,981,139,21,16963
12/29/2020,12,10278,948,4415,549,267,35,16492
12/29/2020,13,10273,1104,4322,383,282,43,16407
12/29/2020,14,10277,1300,4653,268,306,33,16837
12/29/2020,15,10274,1407,4607,252,229,33,16802
12/29/2020,16,10273,1507,4630,325,68,38,16841
12/29/2020,17,10275,1515,5377,421,9,61,17658
12/29/2020,18,10274,1978,6345,525,0,92,19214
12/29/2020,19,10276,1934,6180,682,0,98,19170
12/29/2020,20,10276,1405,5803,881,0,82,18447
12/29/2020,21,10277,1140,5330,1160,0,81,17988
12/29/2020,22,9894,704,4874,1395,0,81,16948
12/29/2020,23,8945,484,4656,1804,0,69,15958
12/29/2020,24,8928,209,4052,2046,0,14,15249
12/30/2020,1,8928,209,3317,2378,0,10,14842
12/30/2020,2,8932,208,3226,2146,0,10,14522
12/30/2020,3,8913,211,3049,2488,0,11,14672
12/30/2020,4,8925,215,3165,2520,0,11,14836
12/30/2020,5,8928,225,3094,2951,0,12,15210
12/30/2020,6,8933,244,3218,3077,0,13,15485
12/30/2020,7,8933,366,3279,2866,0,17,15461
12/30/2020,8,8937,407,3872,3183,1,26,16426
12/30/2020,9,8926,497,4244,3478,6,34,17185
12/30/2020,10,8919,560,4351,4163,21,33,18047
12/30/2020,11,8912,656,4265,4327,29,37,18226
12/30/2020,12,8911,746,4596,4331,36,37,18657
12/30/2020,13,8908,773,4668,4329,32,36,18746
12/30/2020,14,8894,632,4411,4320,16,31,18304
12/30/2020,15,8918,649,4722,4289,9,31,18618
12/30/2020,16,8929,780,4582,4335,0,27,18653
12/30/2020,17,8930,648,5015,4010,0,27,18630
12/30/2020,18,8931,617,5312,4267,0,27,19154
12/30/2020,19,8936,616,4985,4077,0,28,18642
12/30/2020,20,8930,620,4843,4272,0,28,18693
12/30/2020,21,8934,482,4374,4235,0,27,18052
12/30/2020,22,8931,223,3982,4015,0,27,17178
12/30/2020,23,8917,203,3762,4054,0,28,16964
12/30/2020,24,8920,203,3466,3996,0,15,16600
12/31/2020,1,8916,203,3281,3471,0,11,15882
12/31/2020,2,8904,203,3175,3502,0,10,15794
12/31/2020,3,8921,204,3028,3170,0,10,15333
12/31/2020,4,8923,212,3028,2903,0,10,15076
12/31/2020,5,8924,213,3004,2648,0,10,14799
12/31/2020,6,8923,245,3120,2152,0,15,14455
12/31/2020,7,8920,290,3316,1852,0,21,14399
12/31/2020,8,8925,400,4103,1829,2,27,15286
12/31/2020,9,8925,560,4456,1507,5,27,15480
12/31/2020,10,8925,628,4824,1155,20,27,15579
12/31/2020,11,8924,724,5134,1043,47,27,15899
12/31/2020,12,8919,865,4968,1095,133,27,16007
12/31/2020,13,8928,937,4869,959,219,27,15939
12/31/2020,14,8933,1101,5005,730,234,27,16030
12/31/2020,15,8937,1351,5132,609,179,43,16251
12/31/2020,16,8932,1264,5406,533,100,74,16309
12/31/2020,17,8923,1297,5728,336,18,82,16384
12/31/2020,18,8924,1905,6016,233,0,109,17187
12/31/2020,19,8942,1752,5844,335,1,115,16989
12/31/2020,20,8941,1384,5812,392,1,82,16612
12/31/2020,21,8934,1266,5350,461,0,82,16093
12/31/2020,22,8937,457,5433,419,0,81,15327
12/31/2020,23,8940,266,5259,313,0,83,14861
12/31/2020,24,9022,299,5156,256,0,26,14759
